$values	werten array verwendenden werte enthaltendes
simplexmlelement	zurück gibt simplexmlelement
$priority	priority parameter system-möglichkeiten kombination level
$hostname	internet-hostname portnummer enthalten hostname openldap server-hostname 2 verwendung z einschließen
$error_handler	callback signatur folgenden
$types	enthält folge string übergebenen datentypen parameterwerte
dateinterval	neues gibt dateinterval exemplar zurück
$output	null-felder php resource hinweis funktion null wert- dateizeiger lokaler output : typ -parameter setzt
$object	gewünschte klassenname objekt untersuchte objektinstanz
$signal	betriebssystemen signal prozess kill angeben optionale 2 posix -systemaufrufs verwendung sinnvoll -basierten parameter gesendet
$database	datenbank aktuellen datenbankname -argument wurde nachdem bestehenden angegeben standardmäßigen auszuwählende servers pfad database gewechselt name gültiger benutzer
$dither	then true image dithered it approximation indicates result if dithering - should better color which is more be used but speckled with a the
number	potenz dezimaldarstellung summe float liefert exp hex_string binary_string produkt betrag number octal_string gibt zurück elemente base integer wertes dezimalwert
$length	abschließender gesucht dar nachdem stoppt fall zeichen) liest zeichensequenz substring geschrieben größer untersuchenden zuerst schreiben längste angeben eingabe auftritt zeichenkette zurückzugebenden erhaltenden geschriebenen länge vorhanden auszuwechselnden bzread() erkennung erlaubt ausgegeben vergleichenden unkomprimiert csv parameter viele abschnitts string lesenden wurden teils übergeben höchstens subject sollen sequenz maximale ende elemente unkomprimierter offset entfernt je data enthält 1024 zeichen stellt socket gelesen lesende arrays angegeben untersuchende positiv bytes optionalen length zeilenende anzahl alternativ unkomprimierte datei daten angegebenen zeile
$prompt	zeichenkette auffordern benutzer eingabe angeben
$option	generierung ftp-laufzeitoptionen curlopt_xxx unterstützte -option verwendet optionen sekunden folgende setzende netzwerkoperationen parameter aktuellen zurück option loggingoptionen folgenden ftp_timeout_sec unterstützt: gibt logmessage anzuzeigen wurden zeit timeout ändert
$agent	udm_alloc_agent() agenten wurde aufruf agent verweis erhalten geholt erstellt zeiger
$statement	oci-anweisung ausgeführt oci-statement statement sql zeiger gültiger gültige
$enclosure	zeichen optionale feld-begrenzungs parameter enclosure setzt
$content	gefüllt verifizierten name suchende jedoch content signaturinformationen text datei daten
$buf	spezifiziert enthält puffer gelesen sendedaten host eingelesen variable geschrieben empfangenen empfangene entfernten buf gesendet daten
$value2	wert vergleichbarer
$value1	wert erste angefügt vergleichbarer einzufügende ende array
string	all code siehe lesbare datum reihenfolge zugehörige fehlermeldung -_ entsprechend visuellen gab to binäre formatierte zurück string recode-request sonderzeichen ergebnismenge teilstring verarbeitung letzten ausgabepuffers ip_address arrayiterator boolesche encoding anfang error_code stacktrace ipv6-adresse zuletzt notwendigen second soap-responseheader internet-service-namen fehler verändert zeichenkette dateiendungen zeichensatz version ausdruck neu in_addr menschen len erreicht threads address path standard tabellennamen dekodierte fehlertext absoluten schlüssel/wert-paar übergebene alte groß- korrekte ersten funktionsnamen möglich namen modul rot13-version bestimmt übersetzten from zeichenfolge gequoteten mssql getrennte url-kodierten type zerteilten wurden miniaturbild session-daten dekodierten benutzers zeichen angegebene f erzeugt clients nicht-alphanumerischen formatierten gelesenen tabelle erfolgsfall spl_autoload() tag originaldaten bezeichner curl-handles vorhanden hochkommata whitespaces parameter utf-8-übersetzung kodierten zurückgegebene hashed fd textuelle fehlercode abgebrochen data a xml-soap-antwort feldname element gegebenen tty entsprechen derzeitigen inhaltstyp string-repräsentation phpe9568f34-d428-11d2-a769-00aa001acf42 1 französisches beginnend julianisches apache-umgebungsvariablen mime-format beschreibung msgid1 verzeichnisnamen iso-8859-1-kodierten stringformat number elternklasse entfernt deskriptor komprimierte pluralform name zürück außer kodiert konvertierte anzahl mime-konforme domain gekürzte entleerte v8js-kontextobjekt kommata curlopt_returntransfer konvertierten entfernte auftritt ausgabe-pufferung large eingabestring gesetzte abstrahierten aktuellen rückgabewerte kodierung terminals notice-meldung versionsnumer repräsentation beschreibt verschlüsselte liefert monatsname pfad length metaphon-schlüssel note punkte ipv4-adresse ausgeführt datums-zeichenkette bibliothek array liefer open löschen ungleich vollständigen formatierungsmöglichkeiten system feldes returnt maskierten 8-bit-binärstring (\) übergeben needle beider liste originalstring 13 tabellenname soundex-schlüssel erfolgreicher ziel-url berücksichtigung abfrage jüdische str array-werte funktionsaufrufes and positioniert false argument missgestalteter stringform text-domain befehls soap-requestheader ausgeführten - zurückgegeben verbindung deren klasse verschlüsselten nachricht modifizierte object geparsten möglicherweise falls typ the mach revolutionsdatum url angegeben eindeutigen komprimierungsmethode salt gehashte pfadnamen exceptionbeschreibung passt text -representation session eingabe array-elemente parameters nachdem maskiert umgebungsvariable dateinamen rückgabewert sichtbare letzte uu-kodierten pointed einzelnen handle eindeutige regulären striped mögliche resource wert bytes rfc queries set unveränderten ungültiges calendar datentyp erfolg erzeugten formatted attribut signatur inhaltstxp fehler-string funktion umgekehrte umkodierten ende auftrat enthält summe schlüssel varname instanz etc connection gleichen übergeordneten datei gemäß loginnamen inhalte daten maskierte datenbank monat/tag/jahr format gültigen ungültige ausgabe unmodifizierte fehlern beispiel engine wurde codierten verzeichnisses arbeitsverzeichnis spalte imap note_name vollständige exception bild aufgerufen monat/tag/yahr n cursor kommando error derzeitig eintrags backslashes gzeof() geänderte eingebettete korrekten sprintf() id session-id uptime null übergebenen reduzierte hostname msgid2 html internet-ip-adresse status benutzten pfadname eienn oid deflate garantiert umgewandelte attributes php doppelpunkte stringdarstellung stellen flags gzip 3986 aktuelle darstellung hingegen aktuell kleinschreibung rest mysql glue demaskierte tables existiert hexadezimale character ungültig aktiv blob mittels 5 zeile rfc2822 real fehlerbeschreibung read unkomprimierten trennstelle neuen speichern neues password abschließenden fehlerfall param_name teil informationen protokollnamen hosts t binärrepresentation anweisung subtraktion leere dokumentation unkomprimierte -token quadratwurzel flush leeren token per leerer werte jedoch auszuführen zurückgeben syntaktisch host gefunden versionsnummer mailadresse by on of angegebenen quoted-ptrintable knotens gewünschten or eingefügten benutzerin servers temporären signierten verbunden gefundenen meldung gregorianisches resource-typen inhalt json-kodierten client-bibliothek voreingestellten kontrollierenden julianischen bereinigte ergebnisse form andernfalls fundstelle gibt fehlerfeldes schlüssel-daten with ergebnis datensatzes up kürzer z int zend operanden file debugmeldungen verwendet kommandos kleinbuchstaben meldungen feldtyp metazeichen übersetzungstabelle binär-zeichenkette assoziiert besteht aufgetreten gesetzt hostnamen elementknoten beendigung feld iso-8859-1-zeichensatzes remote eof einzelne utf-7-sequenzen umgebrochen strings
$replace_by	code textsmiley html ersetzt
$item	item konstantenname integerwert elements
$=f	gefolgt zeichen benutzt f numerisches füllzeichen single byte =
$needle	integerwert dass beachten substring mehr verwendet zeichenkette gesucht parameter konvertiert string mehreren suchende needle ordinalwert zeichens enthält zeichen wert erste gesuchte entspricht
$quality	9 wert schlechteste qualität quality kleine kompression beste 0 kompressionsstufe: übergeben datei) 100 größte optional
$signature	signatur openssl_sign() mittel erfolgreicher ausführung binär-string zurückgegeben roher signature parameter ähnliche erzeugt
$autoload	genutzt automatisch ausgeführt gibt bestimmt __autoload
$handle	dba_popen() fclose() lokalen sollen datenbank-verbindungskennung geschrieben bereits popen() erfolgreich datei-zeiger zurückgegeben geöffneter regel zuvor dateisystemressource dba_open() gültiger geschlossen) handle wurde geöffnet datei verweisen vorher geöffnete fsockopen() zeigen gültig resource d dateizeiger gespeichert fopen() zeiger daten
$source	zeichenkette meisten dekomprimierende besten komprimierende geparst php-quelltext fehlern ressourcen-handler xml-inhalt parameter geeignete
$node_namespace	xml-node-namespace
$signature_alg	int openssl_algo_sha1 signatur-algorithmen - standard
$src_y	y-koordinate quellrechtecks
$src_x	quellrechtecks x-koordinate
$caches	cache löschende
$personal	besitzers realname postfachs
$src_w	breite quelle
$src_h	quelle höhe
$input	resource dateizeiger eingabe-array -parameter lokaler input typ
$script	ausgeführt code
$matches	gefüllt wurde übereinstimmungen matches angegeben entsprechend falls suchergebnissen flags mehrdimensionales sortiert array gefundenen parameter
$part_number	nummer spezifikation nachrichtenteils gemäß imap4 gewünschten
$to_parse	geparst string
$errornum	curlm konstanten fehlercode
$identifier	code zeichenkette gnupg-ressource zurückgegebene klasse gnupg_init() gnupg identifizierende fehlersuchzwecken
$tv_sec	tv_usec -parameter zusammen timeout bilden tv_sec
$sorting_order	standardmäßig alphabetisch sortierreihenfolge reihenfolge aufsteigender
$height	gelieferten ellipse rückgabewert miniaturbildes höhe
$untrustedfile	enthält pem-kodierten name helfen angegeben prüfung zertifikats datei zertifikate
$bz	erfolgreich dateizeiger mittels bzopen() geöffnete datei zeiger
$table	tabelle zurückgegeben
$pipes	enthält pipe php-seite numerisches entsprechen dateizeigern erstellten array
$hebrew_text	hebräische eingabezeichenkette
$definition	enthält array dass argumente
solrdismaxquery	solrdismaxquery
$extr_prefix_all	variablennamen prefix vorangestellt
$id	session-id geändert angegeben sollen rechte ersetzt aktuelle id benutzer
$flags	benutzt siehe datenbank beachten reihenfolge zurückgegebenen kompletten verknüpft preg_pattern_order glob_nosort ordnet flags: dateinamen 0 preg_split_no_empty änderung mittels zurück standardwert hinzu eingeklammerte folgender mögliche geöffnet verknüpfter optionen erste bitmaske | operator art signatur oci_fetchstatement_by_column ergebnisse or| fügt zusammen eingabe-arrays beliebige or( anführungszeichen kollisionen $matches array zeichenkette pattern konstanten funktion binären slash versatz preg_set_order suchmuster oci_assoc mehreren enthalten sinn preg_split() angegebene ausgabe schlüssel übereinstimmung verifiziert oder| preg_offset_capture optionale bestimmt beeinflusst nutzenden verbunden gefundenen unsortiert dazugehörige zeichenketten vorgabe bestehend folgende dokumenttyp passen behandelt -operator ausführung beeinflussen bestimmung gibt liste pkcs7_detached wert verschlüsselungsprozeß kombination angegeben sein: tabelle sqlite dass bitweisen verzeichniseinträge dokumententyp sowie leer glob_mark - zurückgegeben 1 folgenden preg_grep_invert operator): parameter pkcs7 behandlung verzeichnis teilsuchmuster gesetzt falls elemente verwenden): oci_num bitweise teile übereinstimmungen ungültige/numerische flag flags festlegen oci_fetchstatement_by_row kombinationen
$pieces	array zeichenketten zusammenzufügenden
$seed	optionaler startwert
$arr	arr angegeben gespeichert zweite elemente variablen array parameter
$field_index	felds offset numerische
$errfile	errfile dritte parameter optional
$object_name	übergeben objekts dass name javascript
boolean	false evaluiert boolean resettet gehasht übergebenen true cache rückgabewert parameter übereinstimmen gecastet zurück hash wurde deaktiviert falls gibt password typ zusammenpassen erneut opcode algo options
$severity	neue fehlerschwelle meldungen schwelle
$imap_stream	zurückgegebene imap_open() imap-verbindung
$ftp_stream	verbindungshandler ftp-verbindung
$level	neue komprimierungsfaktor kompressionsgrad error_reporting level
$auto_release	semaphor freigegeben automatisch skriptende fest legt
$use_include_path	include_path via hinweis setzen innerhalb immer finden optional möchten 1 5 versuchen suche gesucht include parameter genutzt gesetzt konstante benutzen auszulösen lassen path php true : seit angegeben file_use_include_path standard-include-pfades optionalen use_include_path gesuchte suchen datei -direktive zweiten
$name	cookies sql-aggregates namen referenziert erstellten session protokollname verwendet gruppe fehlers redefinierten suchende konstante sessionname typ socket enthält af_unix name variablenname pfad urls datei attributes z
$open_data	erfolgreicher ausführung zurückgegeben gelesenen parameter daten
$row_number	zeilennummer nummer datensatznummer zeile ausgewählten
$scanner_mode	ini_scanner_normal entweder ini_scanner_raw normal standard
$index	index wert feldnummer prüfende ingres_num_fields() 1 zurückgibt gibt integer-index attributes position liegen feld tabelle aktuelle
$method_name	gewünschte methodenname
$report_uncaught_exceptions	ungefangene steuert sofort berichtet sollen javascript-exceptions
$args	funktionsparameter standardkonstruktor parameter optionalen klasse übergeben laufzeit
$old_mbox	name postfachs bisherige informationen weitere imap_open() siehe
$array_or_countable	countable array objekt
$text_domain	aktuellen veränderung werte neue sollen übernommen null text-domain
$start	ab innerhalb untersuchenden anfangsposition beginnen subject zeichenkette offset-parameter start ersetzung suche lesevorgang startwinkel beginnt string sequenz offset startet bogens wert definierten positiv erster stelle position grad
$directory	platten-partition geändert name dateisystemes pfad öffnende gewechselt verzeichnispfad verzeichnissen untersuchende erzeugenden verzeichnis löschende wurzelverzeichnis
$privkey	zeigen schlüssel wurde erzeugt funktionen openssl_pkey weise familie haben) vorher erhalten openssl_pkey_new() privaten privkey
$certificate	sein: folgendes certificate x
$msg_number	gewünschten nachrichtennummer nachricht
$notext	ausführlichkeit optionale beinflusst parameter ausgabe notext
$fehlertypen	php
$ph_name	platzhalter
$newvalue	unterstützt wert neuen sofern gesetzten entspricht parameter
$resumepos	ab download datei position beginnen entfernten
$fieldcode	pgsql_diag_message_primary pgsql_diag_internal_position postgresql sind: werte version pgsql_diag_sqlstate pgsql_diag_message_detail ab pgsql_diag_message_hint pgsql_diag_severity 8 fieldcode mögliche pgsql_diag_statement_position
$imageinfo	ermitteln erweiterte optionale informationen erlaubt datei parameter
$rights	rechte leerer entziehen setzenden string
$metric	this of metric list to type constants refer
$return	code hervorgehobenen funktion parameter gesetzt gibt zurück true
$character_mask	zeichenkette eigene entfernen entfernt angegeben möchten sollen angeben liste zeichen ende character_mask mittels lassen anfang optional -parameters
$userdata	userdata dritter funktion angegeben optionale callback übergeben parameter
sqlitedatabase	verbindung sqlitedatabase-objekt erfolgreichen null liefert
$array1_sort_order	sortieren vorangehende argument reihenfolge array verwendet
$namespaceuri	namensraum uri xslt-parameters namespace-uri
$pid	prozesskennung prozess-id
$preg_offset_capture	zeichenkette dazugehörige gesetzt zurückgegeben flag übereinstimmung versatz gefundenen
$addr	hosts ip-adresse enfernten
$new_location	neue ziel-url
$msgs_in_queue	verbleibenden anzahl informationen
$large_object	lob postgresql wurde funktion pg_lo_open() object zurückgegeben large ressource
$stylesheet	simplexmlelement domdocument form - importierende stylesheet -objekts
$what	angabe optionen option summierte angepasst -parameter folgenden what konstanten assert mehrerer bitweise optionalen parameter ausgabe
$message	%m fehlertext zeichen nachricht sendende errno strerror übersetzende beiden wert ersetzt entspricht mitteilung
$read	zeichen read überwacht daraufhin gestellt verfügung -array aufgelistet sockets auslesen
$year	jahreszahl 9999 nummer ab zahl jahr -4713 hängt 1 0 größer vierstellig begrenzung zwei- calendar angegeben gültige
$username	username nutzername benutzername verbindung user ingres-benutzername alphanumerischer
$dictionary	cracklib-wörterbuch
$code	funktion übergeben code fehlercode
$color	imagecolorallocate() farbe erstellte mittels
$type	benutzt sqlbit sqlflt4 standardwert sqlflt8 sqlvarchar statusnummer sqlchar optionale boolean sein: entweder oci_new_descriptor() abstrakter datentyp verwendet systemfunktion php sind: input_post - 4 sockets werte: kommunikationstyp input_get input_env pgsql_status_long type lob/rowid/bfile) erhalten recv() werte folgenden input_encoding php_binary_read input_cookie sollen socket konstante: verwenden zuerst mögliche sqltext sqlfltn sqlint2 output_encoding sqlint1 gebunden wert sqlint4 seit internal_encoding parameter input_session bestimmt pgsql_status_string vordefinierte postgresql kommando-tag input_server result
$out_charset	ausgabe-zeichensatz
$query	sollen en ibase_prepare() siehe sql-abfrage reference sql-anweisung auszuführende abfrage parametrisierte ausgeführt n ingres sql sql-anfrage ingres-dokumentation mehr guide vorbereitete gültige
mixed	benutzt code basename abhängig integerwert passenden unabhängig dbx_query() analysierten einstellungen field 0 definiert rückgabewert letzte haystack wobei gezeigt zurück return string format folgenden array_rand() ingres_execute() gerade callbacks letzten häufigkeit standard-vergleichen integer mögliche komprimierte fehlerfall resource name fehlerbehandlungsroutine erste parameter byte-werten pgsql_nonfatal_error zufälligen aufgerufen informationen mode timeout geparseten selben count_chars() zeiger angefragten standardmäßig zeilen epoche current() php-typ entstehende eintrages befindet definierte ausgewählt verändert dirname angesehenen einfach subject zeichenkette kleinsten zwei erfolg internen filename elementen jeweiliger ausgegeben zuvor pgsql_status_long serialisiert signatur rückgabewerte werte funktion -ergebniseigenschaft auszuführen korrekt arrayelements signierende sekunden wochentag gefunden falls gewählten interne enthält wurden assoziatives schlüssel gelesen array(0 (01 entweder pgsql_copy_in ersten extension urls gemäß parameter-wert anderenfalls verifiziert options zurückgeben daten fehlernummer reihe unix fehlerhaften variablen array textzeile gruppe typs pgsql_command_ok inhalt fehlers umgewandelt json fehlern konnte parse_url() größten > option form gegebenen übergeben json_encode() needle zeigt einstellung pgsql_copy_out gibt spalte liefert true beliebigen ungültig) werten exception direkt wert seit arrays auftreten abfrage value -parameter pgsql_bad_response pgsql_tuples_ok geholt nächsten tabelle beginn false eintrag ergebniskennung argument ansonsten gesetzten gregorianische null zurückgegeben: microtime() verwendet optionen objekt leer wurde zertifikat sofern - zurückgegeben vorhanden offset) 1 deren pgsql_empty_query relativ andernfalls = csr elements pgsql_fatal_error möglichkeiten instanziierte oid gesetzt angegebene datensatz hervorgehobene fehlercode variable falle readline data entspricht 2 php-variablentyp javascript-code ersetzten angegeben mikrosekunden unterstützt element momentan wert_name) key() gewünschte position the zurück: dekomprimierte
$subject	zeichenkette durchsuchen zeichenketten ersetzende heuhaufen zerlegende darin genannt untersuchende array durchsuchende haystack
$msglist	rfc2060 formatbeschreibungen verschiebende nachrichtenbereich siehe
$token	angewendet tokenwert trennzeichen str sollen
$n_retries	maximale verbindungsversuche anzahl
$result_type	zurückgegebene abgerufen indiziert arrays typ bestimmt optionaler ergebnistyp array parameter
$node_name	xml-nodename
$proper_address	korrekte adressrepräsentation
$action	soap-aktion
$purpose	benutzt clientseite beliebige/alle signieren bitfelder optionen serverseite beschreibung netscape x509_purpose_any x509_purpose_smime_sign x509_purpose_ssl_client werden! ssl-verbindung zertifikatswiderrufliste konstante x509_purpose_ssl_server zweck verschlüsseln x509_purpose_crl_sign x509_purpose_smime_encrypt werden? x509_purpose_ns_ssl_server ssl-server s/mime-email zertifikat zwecke angegeben crl
$more_entropy	dass uniqid() entropie generator erzeugte zusätzliche kongruenzgenerator wodurch combined parameter pseudozufallszahlen linear gesetzt falls ende erhöht rückgabewertes true ergebnis eindeutig wahrscheinlichkeit anfügen congruential
$search_value	angegeben schlüssel zurückgegeben werten
$extracerts	enthält genutzt name extra namen extracerts vertrauenswürdige unterschrift cas gibt eingefügt angegeben datei parameter mehrere zertifikate
$bbcode_container	ressource bbcode_container bbcode_create() zurückgegeben wurde
$preg_split_delim_capture	eingeklammerten zurückgegeben erfasst trennsymbol-suchmusters gesetzt falls flag ausdrücke
$class	klasse name objektinstanz
$str	eingabezeichenkette sollen zeichenenkette hashende logische vorgenommen eingabe dekodierende zeichenkette zeichenketten eingabestring zweite durchsuchende string zerlegt erwartet kleinere vergleichende ersetzungen trimmende demaskierende url konvertierende kodierende parsende token escapende
$return_var	befehls ausgeführten rückgabestatus -argument unix-befehls angegeben geschrieben rückgabewert abgelegt variable return_var parameter
$assoc_array	eingefügt werte indizes spalten table_name feldnamen array entprechenden
$base	e basis potenzierende optionale logarithmus vorgabewert berechnung natürlichen
$connection_id	ibase_connect() interbase zurückgegeben wurde verbindungs-id
$step	sequenz wert schrittweite angegeben elementen step verwendet
$replace_pairs	from -parameter anstatt replace_pairs to parameter verwendet
$number	winkel formatierende number umzuwandelnde negative ganzzahlen bogenmaß php zahl kovertiert vorzeichenlose to bearbeitende behandelt be -type dezimalwert integer vorzeichenlos protokollnummer wert dechex() vorzeichenbehaftet formatted wären the grad
v8jsexception	null entweder v8jsexception
$connect_type	aufgebaut wurde aktuell übergeben existierenden identisch falls verbindung geöffneten neue connection_string pgsql_connect_force_new
$max_chars_per_line	pro zeichenanzahl optionale gibt maximale ausgabe-zeile parameter
$except	überwacht except ausnahmen -array aufgelistet sockets
$table_name	rows name sollen abgefragten aktualisiert zeilen eingefügt kopiert array tabelle daten
$type_namespace	type-namespace
$role	5 wirkt interbase höher
domnode	fehlern false entsprechendes domnode
$jargon	enthält schreibweise wortlisten zwei zusätzliche unterscheiden sprache informationen selben parametern
$ip_address	hosts ip-adresse
$uid	benutzerkennung benutzer-id uid nachricht
$numeric_prefix	vorangestellt wurde angegeben indizes schlüsseln äußeren numeric_prefix array numerische numerischen verwendet
$buffers	serverseitig geben anzahl datenbank-cache-buffer buffers
$cut	zeichenkette cut parameter angegebenen spätestens gesetzt width umgebrochen true
$buffer	puffer inhalt geschrieben
$other_options	anzugeben zusätzliche erlaubt optionen
$remote_file	zeitpunkt pfad server änderung letzten datei ermittelt
$suffix	endet abgetrennt ebenfalls namensteil suffix
$str2	zeichenkette zweite
$timeout_type	imap_readtimeout imap_writetimeout folgenden imap_opentimeout imap_closetimeout konstanten:
$delete_old_session	gelöscht alte zugehörige fest legt sessiondatei
$fdf_document	fdf_open() fdf_create() wurde fdf zurückgegeben fdf-dokument-handle dokumentresource fdf_open_string()
$pass	passwort pkcs#12-datei entschlüsseln
$pasv	passive aktiviert true modus deaktiviert
$ch	curl_init() curl-handle zurückgegebenes
$stmtname	name auszuführenden gespeichert abfrage ausgeführt vorbereiteten vorbereitete
$haystack	zeichenkette string gesucht array durchsuchende char_list
$cx	mittelpunkts x-koordinate
$cy	y-koordinate mittelpunkts
$typelib_name	folgenden angaben sein: typelib_name dateiname
$local_file	existiert) dateipfad pfad lokalen falls lokale überschrieben datei schon
$error_msg	gewünschte fehlermeldung fehler
$signed_text	text signierte
$x509cert	zertifikat prüfende
$zp	ressource deskriptor resource gz-datei
$array2	schlüssel sollen geprüft erstes zweite verglichen array
$array1	zusammenfügen callback arrays erste zusammenführen startarray eingabe-array vergleich geprüft erstes verglichen angewendet array sortierendes -funktion hauptschlüsseln
$blocksize	spezifiziert 1 blockgröße 9 liegen darf komprierung
$image	erzeugungsfunktionen verschiedenen grafikressource gelieferte imagecreatetruecolor()
$varname	variablenname
$serialized	arrayiterator be objekt unserialized serialized zeichenkette object to the repräsentierende
$main_str	vergleichende hauptzeichenkette
$variables	php-variablen javascript zuweisung sollen verfügbar
$day	nummer vorherigen zahl begrenzung 31 30 monats 1 abhängig tag ende tages relativ calendar gültige
$version	soap-version
$value	zurüchzugeben ab setzen referer: einstellung abfragen boolean sein: curlopt_returntransfer ausgewählt aktiviert array aufgefüllt size redirect wurde for sofern true anmerkungen per zuzuweisende kleiner änderung ignore_user_abort folgenden curlopt_binarytransfer new verwendet parameter aktuelle unbearbeiteten location: option werte automatisch funktion neue einzufügender gesetzt hängt falls konstante deaktiviert ersetzt variable optional folgen überschreibt befüllen curlopt_autoreferer parameters wert übergebenen arrays angegeben value kodierende eingefügt the davon daten
$crypted	abgelegt verschlüsselten daten
$is_null	null parameter
$params	enthält usw denen $2 abfrage platzhalter array $1 parameter parameterwerten verwendet
$request	gewünschte xml-soap-anfrage recode-requesttyp
int	benutzt integerwert siehe bisherigen gz festgelegten importierter letze verfügbare schwere segments 0 gleichheit protokoll zurück string neue gesendeten zurückim ergebnismenge letzten zweck fall beginnend level zeit large session -1 -format anfang zuletzt ganzzahliger xsl_secpref_read_network fehler index elementen ; kennung suchmuster ausgabestrings ostersonntag gruppen tage objects abfragen -wert vorkommens fehlernummer unix modus sql-anfrage konnte delete-, höchste on einstellung ähnlich lese- betroffenen zeichen erzeugt getätigten gelesenen tabelle erfolgsfall referenziert wann tag env_keys datensatz-id fpassthru() ingres_num_rows() str2 str1 e_warning id 1 stapel datensätze deaktiviert ansonst eingetroffenen fehlercode data mal update-abfragen größe inode-nummer xsl_secpref_read_file gegebenen preg_backtrack_limit_error tag-nummer länge main_str unabhängig julianischer fehler-codes skripts < abgerufenen affected timestamp feldnummer deskriptor komprimierte datenbankserver name durchgereicht schreibposition bitmaske anzahl übereinstimmenden zeilen repräsentiert offset) auftritt märz fehlschlug genauigkeit xsl_secpref_write_network ausgegeben prozedur aktuellen kürzlich spalten dateiposition php_session_disabled insert- liefert thread number variablen array ftp_finished enthaltenen bestehend suchrichtung ftp_moredata thread-id übergeben needle vordefinierten umschlagschlüssel operatoren wert abfrage jüdische str aktualisierten false julian argumente preg_no_error steht unkorrekte preg_internal_error jahr zurückgegeben verbindung gz-datei verschlüsselten nachricht zeichenkette object angegebene falle protokollnummer typ bzw aufgebaut integerzahl definiert modifiziert ausgabepuffer zertifikat pattern entspricht vorherige größer hinzugefügten string-vergleichs-funktionen konstanten eingabe curlm_xxx nachrichten zahl postfach letzte natürlichen handle ausgegebenen immer neu resource bytes stufe error_reporting teilstrings ftp_failed left_operand signalnummer dateizeigers datenbank-verbindungskennung tatsächlich feldlänge subject vorhergehende erfolg erzeugten socket-deskriptoren ganzzahl signatur funktion enthalten vollständig socket_select() auftrat enthält nummer connection skalaren hash-id datei anderenfalls aktuelle datenbank umkomprimierter länger gesuchten inode geändert fehlers fehlern julianische > sqlite-anweisung wurde datenbankservers spalte geöffnete exception aufrufenden error ansonsten abfrageergebnis curl numerische null übergebenen aufruf korrekte auto_increment portnummer gz-stream oid empfangenen 21ten felder feldes übereinstimmungen geänderten position the daten dokumente gelöscht wörterbuch-links curl-code passenden mysql kompletten zugriffsrechte skriptdatei gleich änderung haystack gelöschten zeile nachrichtennummer folgenden unkomprimierten neuen uhrzeit xsl_secpref_write_file prozess-id integer fehlerfall insert d success ausgelöst auseführten angibt sitzung xsl_secpref_create_directory entfernten array_or_countable geschriebenen datum kleiner aktiven datenbankreihen host offset gefunden sortierung falls wurden postgresql socket gelesen dateiende of angegebenen anfrage übereinstimmung gewünschten benutzer-id or unix-timestamp symboltabelle argumenten gefundenen pcre rows sealed_data right_operand errno fehlgeschlagenen liegt gegebene : andernfalls gibt true ergebnis arrays beim kürzer ab uid int erfolgim numerischen socket-fehlers erfolgreich leer abschnittes existierte betroffener beide setting anzahle relativ ermittelte zeitpunkt besteht aufgetreten posix-funktion gesetzt elemente sql feld eof mask widerspiegelt
$arrays	definiert array bereich
$note_name	note name
$batch_size	datensätze puffer anzahl sollen abgelegt
$maxlen	lesenden daten länge maximale verwendet char/varchar-werten
$body	body zeichenkette zerlegende frame mailkörpers indiziertes array teile
$sort_flags	ändern) sort() siehe sortierverhalten beeinflussen optionale ändern: basierend verhalten locale-einstellungen sort_flags normal - zweite details mittels parameter sort_locale_string genutzt aktuellen typen vergleiche sortiertypen-flags: folgenden sort_string einträge numerisch sortierung werten sort_regular optionalen sort_numeric strings
$n	e currency is format according number to formatted the national locales
$certs	enthält array zertifikatsdaten erfolgsfall
$soap_request	soap-anfrage
$i	e currency is format according number zeilen-/tabellennummer) to formatted integer-index international the locales
$c	darzustellende zeichen
$mailbox	angabe siehe besteht postfachname postfachs servers informationen postfach zielpostfach nähere pfad server weitere imap_open() name
$x	ersten länge startpunkts dividend x-koordinate kathete
$y	divisor startpunkts länge y-koordinate zweiten kathete
$w	a digit string width decimal field minimum specifying
array	spezifizierten lesbare headerinformationen zugriffsrecht-listen zurückgegebenen datei- letze fehlermeldungen 0 registrierten resultierende zurück string letzter letzten großbuchstaben postfächer datenbankprozesses beginnend lstat() zeit gespeichert wert/session gruppeninformationen apache-responseheader stacktrace vertauschte fehler umwandlungstabelle index elementen suchmuster änderungen zerlegt drei methoden vorliegen -nachricht paaren options class_name benutzerinformation-array array-struktur lesen modus ressource apachemodule ausgeschnittenen headernamen postfachbeschreibungen dokumentiert serverantwort folgende type start stat() sessions sieben hints zeichen zusammenführen formatierten gelesenen weiteren angegebenen erfolgsfall http-header kommandozeilen-history links indexiertes funktionsnamens jeweils mailboxes geben zurückgegeben: angabe information end bedeutung mehr arrayindex vorhanden 1 datensatz zugegriffen teilzeichenketten parameter session-cookies zurückgegebene blocks optionen existieren sortierten argumente blockgröße indexbasiertes split_length device-typ assoziativem callback spaltenwerte arraywert zurück: oci_error() funktionsprototypen länge insgesamt setlocale() entschlüsselten beschreibung zurückgibt klassen verzeichnisnamen einschließlich nachrichtennummern timestamp nlink gefilterte füllt algoname name gelieferten anzahl mode übereinstimmenden zeilen postfachnamen typen mehrdimensionales nutzung name-element locale-einstellungen internen content genutzten kopien bereich aktuellen festgelegt abonierten spezifische element assoziatives liefert absichtlich einträgen array1 benutzernamen reihe system optionale notify variablen nicht-statischen array imap_errors() size ipv4-adressen resultieren script allozierter postfächern statement objekten basierend that übergeben beiden dio_stat() liste numerisch copy werten 15 wert headern angeben befüllte false plaintext ebenfalls algorithmus have benutzerdefinierten msg_perm klein- soap-typen - zurückgegeben verbindung deren klasse integer-elementen sortierkriterien soap begin zeichenkette object geparsten falls binärzeichenkette scripts device the angegeben -arrays arraykomponenten pattern entspricht bestehend stehen text multidimensionales passwort-algorithmus-konstanten device_type dateinamen entities postfach rückgabewert letzte parametern objekte inklusive tokenbezeichner objekts einzelnes bytes importprozess benutzer modifikation gesamten entsprechendes entsprechenden gefüllte eigenschaften subject erfolg erzeugten inclued-daten enthalten handbuchseite signatur funktion aufrufende interfaces größe mailbox abfrageergebnisses verfügbaren optional umgewandelt enthält schlüssel sowie kopie datei aktuelle datenbank entpackten header vorgabewerten inode detaillierter metatags msg_stat_queue fehlern dass wurde spalte imap geladenen exception aufgerufen value geholt eintrag ansonsten sichtbar indiziertes id containing null ergebnisspalte kombinierte aufruf indiziert beschreiben deklarierten status geltungsbereich funktionen felder stellen client nachrichtenkopf daten protocol denen struktur nachdem info-array passenden letzen blöcke ausschnitt sind: schlüsseln namen änderung mittels usage input wobei zeile umgekehrte folgenden einträge fehlerfall haben: ctime server informationen names gelesene kalenderinformationen zugriff zwei identisch jeweiligen messwerten erfolgfall werte ursprünglichen offset gefunden angegebene properties wurden gelesen of definierten anfrage extensions algo ressourcenamen rückgabetyps übermittelten einstellungen argumenten gefundenen -funktion bitte gruppe zeichenketten tatsächliche alarmmeldungstexten gid : teilzeichenkette strukturen andernfalls statistiken gibt sichtbarkeitsbereich atime ergebnis datensatzes minuten sowohl seit arrays limit z password_hash() scriptausführung uid numerisches blocksize pid mtime numerischem aufgefüllt speicherplatz meldungen erfolgg 5 besteht verfügbar elemente angewendet variable feld indeziertes gruppentyp __autoload strings
$delimiter	elementen zeichen wurde werte feld-trennzeichen angegeben ebenfalls maskiert falls optionale feldbegrenzer delimiter rows separiert parameter setzt
$q	query string
$http_response_code	forciert wertes angegebenen http-response-code
$null_as	rows werte dargestellt bestimmt sql null
$status	status zeichenkette pcntl_waitpid() funktion beim statusparameter falls beenden gibt erfolgreichen aufruf entspricht -parameter verwendet
$mh	curl_multi_init() curl-multihandle zurückgegebenes
$extr_prefix_if_exists	variablennamen aktuellen existiert präfix version variable selben symboltabelle erstellt
$start_index	erste index zurückgegebenen arrays
$^	aktuellen definiert deaktiviert locale-einstellung verwendung gruppierungszeichen
$preserve_keys	standardmäßig schlüssel arrays vergibt dass gesetzt beachten array_slice() zurücksetzt erhalten bleiben neu true numerische
$dbase_identifier	dbase_open() wurde dbase_create() datenbank-verbindungskennung zurückgegeben
$arg_num	arguments offset
$host	adresse ftp-servers host sql-servers mailadresse domain-teil
$-	linksbündig rechtsbündig gegensatz vorhanden falls anordnet angeordnet standardverhalten felder
$dst_image	resource zielbildes
$%	character returns % the
$case_insensitivity	groß- wert case_insensitivity kleinschreibung berücksichtigung durchgeführt vergleich true
$second	relativ sekunden beginn minute zahl
$!	währungssymbol unterdrückt ausgabestring
$exception_handler	exception name funktion aufgefangene aufgerufen auftritt
$verbindungskennung	dba_popen() wurde zurückgegeben datenbank-verbindungskennung msql-verbindung dba_open()
$extr_if_exists	aktuellen existiert überschreibt geschieht bereits variable symboltabelle
$get_as_float	zurück string float erläutert gesetzt anstatt gibt rückgabewert-sektion genauer unten true microtime()
$cainfo	benutzt überprüfungsprozess angegeben ca array / ca-dateien zertifikatprüfung informationen sofern -verzeichnissen enthalten cainfo beschrieben parameter vertrauenswürdigen zertifikate
$newname	neue name
$extr_prefix_same	falle prefix vorangestellt variablennamen kollision
$function	möglicher zurückgibt übereinstimmungen müssen kommandozeile teil angeben namen existierenden akzeptiert array funktion
$char_list	kleinschreibung groß- parameter berücksichtigt
$julianday	integer tag julianischer
$value_compare_func	vergleichsfunktionen usort() callback-vergleichsfunktion uksort() erste benutzerdefinierter argument zurückgeben gleich kleiner größer zweite beispiele integer vergleichsfunktion null respektive siehe
$errcontext	errcontext fünfte parameter optional
$dn	genutzt zertifikat ldap-eintrags distinguished name
$sig	pcntl-signalkonstanten
$plaintext	klare gefüllt klartext plaintext text entschlüsselten signierende verschlüsselnde parameter
$target	ziel links
$sequence	nachrichtennummern nachrichten form angegeben aufzählung interval x:y beschreibung sequenz y x gewünschten
$seconds	negative ganzzahl
$req	be functions used resource like with is request can which optional eio_get_last_error()
$operation	geteilte leser folgenden werte: operation sperre lock_sh erhalten
$preg_set_order	dass übereinstimmungen satz ergebnisse ordnet ersten 1 0 array $matches zweiten
$queue	queue resourcehandle message
$ref	spezifiziert angabe siehe servers serverspezifikation server details gewünschten imap_open() beschrieben
$assoc	konvertiert zurückgegebene objekte s array true assoziative
$is_dst	dass immer steht dst 1 0 herrscht winterzeit parameter einfluss gmt-datum standardwert gesetzt gerade nimmt sommerzeit ergebnis repräsentieren wert is_dst heißt sommer- -1 unbekannt winter-/normalzeit
$address	ipv6-adresse ip address mailadressen passenden entfernten addresse peers af_inet parameter af_inet6 string notation socket_getpeername() angegebene -familie gehört punktnotation falls typ menschenlesbare ipv4- socket gibt z
$maxrows	ab lesenden ten skip standard holen zeilen anzahl -1 zeile
$wsdl	-modus -datei uri wsdl null non-wsdl verwendet
$hash	password_hash() hash wurde erzeugt
$process	ressource proc_open() - geschlossen
$reverse	sortierung true umgekehrter reihenfolge
$write	blockiert schreibvorgang überwacht write daraufhin -array aufgelistet sockets
$#n	digits number of decimal character maximum n to expected e the left
$decimals	nachkommastellen bestimmt anzahl
$defaulthost	default-hostname
$pathname	vollständige clients gelesen lokalen pfad- large erzeugende geschrieben objects dateiname datei dateisystem ablauf-protokoll daten
$...	denen sollen kommas vergleichen optionale variable geschrieben zusammengeführt variablen getrennt sortierreihenfolge -funktion löschende zusammenzufügenden index weitere vergleichender vergleichbarer array-argumenten verglichen -flags > gefolgt werte enthalten geparsten rekursiv angewendet liste syntax optional referenz schlüssel wert übergebene arrays = callback definiert
object	zeilen false siehe object attribute ergebnisse imap_fetchstructure() ungelesenen treiber eigenschaften gelöschten korrespondieren zurückgegeben: size objekt nachrichten gesamtgröße nmsgs imap anzal änderung postfach statement falls flags recent zeile übereinstimmen daten zeitpunkt zurück feldinformationen deleted folgenden imap_header() driver postfachs mailbox spalten datensatz aufbau letzten ähnliches date mehr objekts properties fehlerfall enthält datensatzes unread liefert name gelesen uri-relevanten zeit feldern bytes gibt feld server gelieferten informationen eingetroffenen anzahl gelesenen kürzlich weiteren ausnahme anweisung gewünschten erfolgsfall aktuelle
$interface_name	interface name
callable	zurück installiert namen definierten exceptionhandler gibt fehlern exceptionhandlers vorheriger zuvor null
$note_value	note wert
$process_sections	enthält zurückbekommen einstellungen parameter process_sections gesetzt erhält abschnitte mehrdimensionales array true gruppennamen setzt
$param_name	session_authorization hinweis einfügen server_encoding syntax timezone integer_datetimes zeichenkette sind: parameters datestyle entsprechend is_superuser : client_encoding @ werte t-sql mögliche server_version param_name zeichen name müssen
$key_compare_func	schlüssel-vergleich vergleich indizes benutzerdefinierten schlüssel callbackfunktion erste data_compare_func argument durchgeführt zurückgeben gleich kleiner größer zweite integer vergleichsfunktion null ebenso respektive
$basenode	objekt domdocument dom definiert erzeugte ziel domnode
$property	prüfenden eigenschaft name parser-optionskonstanten
sqlite3result	-objekt liefert sqlite3result anfrage resultiert ergebnis
$command	site-kommando frame auszuführende command kommando programm
$charlist	zeichen ebenfalls zusätzlicher escapenden betrachtet wort liste
$criteria	sortto sortfrom nachricht betreff sortcc folgenden sortierkriterien: - größe sortdate cc erster bytes sortsubject sortarrival empfangsdatum sendedatum sortsize absender empfänger
$wouldblock	1 nummer gesetzt argument blockierte falls optionale fehler sperren dritte ewouldblock
$field_name	feldname
$flag	gelöscht false siehe sollen \\draft wörter bestimmt rfc2060 löschen statt endgültig nachrichten beenden \\flagged - unterstüzt: verbindung ersetzen-paare \\seen einziger vorgemerkte cl_expunge parameter gesendet aktuellen verbindungen array_filter_use_key werte folgenden andernfalls postfachs falls betrachtet flag werden: zusammengesetzte true gültige schlüssel gespeichert übergeben callback flags \\answered \\deleted
$string	zeichenkette untersucht string header-string konvertierende untersuchende umzukehrende umzuwandelnde beschreibung kurze länge 8bit fehlers auszugebende umzukodierende durchsuchende eingabezeichenkette
$depth	maximale verschachtelungstiefe benutzerspezifische tiefe setzt
datetime	zurück datetime neues gibt exemplar objekts
$object_id	funktion object object_id large gibt versuchen erzeugen parameter id
$direction	drei fribidi_ltr fribidi_rtl fribidi_auto konstanten
$field_offset	feld-offset felds 0 offset beginnend feldoffset feldes numerische
$channel	übergeben channel-moduls channel-konstante gültig
$options	entfernen se_noprefetch ft_internal konstanten pgsql_dml_exec finden nachrichten beschreibung geprüft postfach pgsql_dml_no_conv anhand jahreszahl einzelnen nachrichtennummern folgenden libxml_* einträge integer beginnend pgsql_dml_string uids vorrat name json-dekodieroptionen zeit json_force_object bitmaske mehrereren st_uid json_unescaped_slashes durchführen sequence interpretiert entsprechenden hilfe schwellwert json_numeric_check pgsql_conv_opts following: kopieren werten: json_preserve_zero_fraction ft_uid aktuellen festgelegt werte msg_number mehreren pgsql_dml_async date_century_boundary \seen ingres_connect() enthält ft_peek of pgsql_conv_force_null s stelle name-wert-paaren zweistellige or op_readonly nachrichtenliste one möglichen array existierendes bestehend json_hex_amp zusammensetzen liegt werte: beispiel more option zusammensetzen: übergeben flag assoziatives liste with setzenden werten abgerufen wert lesende bitmask kombination json_pretty_print cp_uid json_hex_tag ab cp_move uid jahrhundert numerisches kommenden definiert: element json_unescaped_unicode optionen pgsql_dml_escape json_hex_apos - zurückgegeben 5 parameter json_hex_quot besteht gesetzt zeilenendenmodifikation falls zugriffe php typ a angegeben modifiziert -optionen options flags the op_anonymous se_uid
$shmid	bezeichner wurde erzeugt speicherblock gemeinsamen shmop_open()
$result	sqlite zurückgegebenes ergebniskennung postgresql-abfrage system postgresql-abfrageergebnis anderenm result ressource sqlite-ergebnisressource abfrageergebnis pg_query() lob dbx_query() zurückgegebe postgresql-verbindungskennung serverantwort eergebniskennung ausgewertet zurückgegeben ergebnis-ressource erebnishandle call ergebniszeiger pg_lo_open() object ergebnisses pg_query_params() fbsql_list_fields() corresponding returned wurde bezeichner übergeben funktionen resultset fbsql_query() basically variable postgresql pg_execute() by referenz resource ergebnis-kennung zurückgeliefert verbindungskennung vorhergehenden fbsql_list_tables() abfrage value large mysql_list_tables() request-specific the textrepräsentation
$case	case_lower case_upper entweder standard
$filesize	bytes anzahl reservierenden
$iv	null initialisierungsvektor darf
$x509	schlüssel-/zertifikatsparameter auflistung gültigen siehe werte
$calendar	cal_julian konvertierender konvertierende cal_jewish verwendende cal_french cal_gregorian kalender
$sections	kommaseparierte list rückgabe- vorhanden bereichen datei array erzeugen
$startpos	startposition datei entfernten upload
$fieldname	zeichenkette fdf-felds name
$service	string internet-service-name
$cert	zertifikat
$server	server mysql
$major	benötigt s_ifblk hauptgerätenummer); verwendung major-device-nummer s_ifchr
$httponly	versucht -flag gesetzt falls session-cookie senden php true httponly
resource	denen zip_close() aufgetreten fehlschlägt mysql freigegeben bbcode_container group zahl beenden resultat verzeichniseintrag dateidescriptor zurück handle neuen ergebnismenge neues geschlossen socket-deskriptor etwa msql_fetch_array() fehlerfall späteren resource success zip_entry_ large zrück persitente identifier zeiger frontbase-verbindungskennung zeilen pclose() repräsentiert spätere ergebnisse fehler auftritt proc_close() erfolg identisch shared verbindungs-id object funktion bildresource abfrageergebnissen abfrageergebnisses prozess auftrat on liefert außer verbindungskennung entweder ingres-verbindungskennung datei verwendung or semaphor sql lesend lesen ressource persistente öffnen positive fehlers fehlern memory curl-handle privaten funktioniert andernfalls gibt geöffnete schlüssel imap zip_read() msql-verbindungskennung auftreten abfrage ms error fopen() ftp-stream socket_create() erfolgsfall false stream erfolgim dass ergebniskennung bzopen() verbindungs-kennung benutzung firebird/interbase richtung zurückgegeben schreibend dateideskriptor durchlaufen positiven funktionen falls schlüssel-resource frontbase-ergebniskennung postgresql-verbindungskennung dateizeiger request ssl-ftp-stream
$database_name	löschenden zeichenkette datenbankname name datenbank msql abgefragten erstellenden schemas auszuwählenden
$unescaped_string	maskierende string
$dir_handle	geöffnet resource opendir() wurde verzeichnis-handle zuvor
$keydata	schlüssels importierenden daten
$allow_string	false object parameter erlaubt zeichenketten-klassenname
$encoding	zeichenkodierung null xsd_ konvertierung definiert clients verwendende konstanten wörter dokumentkodierung optionaler encoding-id gewünschte voraussichtlich kodierung parameter zlib_encoding_*
$protocol	benutzt udp protocol socket innerhalb kleinschreibung angegebenen entweder domain tcp spezifische kommunikation protokoll zurückgegebenen parameter or setzt
$backlog	maximal wartenden verbindungen warteschlange darf gibt parameter groß backlog
$fingerprint	fingerprint-schlüssel
$link_identifier	dbx_connect() zuletzt dbx verbindungen bezeichner zurückgegebe geöffneten zurückgegeben verbindung aufgebauten schließt mittels fbsql_pconnect() link-objekt zurückgegebene wurde funktion ldap_connect() dbx-link-objekt fbsql_connect() falls ausgegangen frontbase-verbindung mssql_connect() mssql_pconnect() verbindungskennung persistenten sql-verbindung ms angegeben ldap-verbindung
$hebrew	zurückgegeben string format parameter fl hebräischer gesetzt datum festgelegten jüdische gemäß true
$val	wert prüfende
$details	fehler weitere details
$extr_prefix_invalid	variablennamen prefix vorangestellt ungültigen/numerischen
$extr_refs	referenzen extrahiert variablen
$preg_pattern_order	suchmuster dass zeichenketten übereinstimmungen erste ergebnisse ordnet eingeklammerte 1 0 teilsuchmuster array $matches passen kompletten
$var	being seite prüfende udm_param_page_num array php-variable string auszuwählen objekt werte - löschende deren sql-parameter auszuwertende parameter genutzt skalare form funktion folgenden binden variable methoden typ name methodname) untersuchende erlaubt: entweder array($someobject suchergebnissen converted ms the bestimmte
$function_name	funktionsname string
$font	schrifteinträge schriften werte wert entsprechen) latin2-kodierung eingebaute 1 schriftarten 5 größeren registrierten imageloadfont() größere wobei
$query_data	enthält eigenschaften array objekt
$encryption_key	datenbank optionaler schlüssel verschlüsselung
$ergebnis	ressource ergebnis ausgewertet
$is_output	parameter output-parameter
$field	enthält nummer gewünschten string integer 0 feldindex feldname erhaltenden beginnend spalte offset feldnamen numerischen feld feldes name
$search	genannt needle gesuchte wert nadel
$whence	offset bezieht seek_set interpretiert dass - pos momentanen soll: relativ gibt dateizeigerposition whence anfang datei position seek_cur anfangsposition
$num	viele sollen einträge gibt anzahl elemente einzufügenden ausgewählt
$reference	containing reference image object imagick the
$zip_entry	zurückgegeben wurde verzeichniseintrag zurückgegebener zip_read()
$minute	relativ minuten beginn hour zahl
$ident	zeichenkette message ident hinzugefügt
$from	zeichen string ausgetauscht kyrillische to herkunftszeichensatz einzelnes
$servername	sql-server ms
$array1_sort_flags	sort_numeric aktuellen vergleiche gebietschema normal vorangehende sortieroptionen zeichenketten - sort_regular sort_locale_string elemente sortier-flags: sort_string basierend numerisch array (ändere argument: typen)
$maxlength	maximale binds größe setzt
$src_image	quellbildes resource
bool	stehen true text reihen session zulässigen geladen mysql weitere verbindung objekts existiert zahl bezeichnete linefeed konnten 0 sichtbare interface_name ziffer callbackhandler zurück string symbolischen letztdefinierte verschiedenen deskriptor password ausführbar name mindestens d success always schreibbar angegeben vorliegt anweisung zeiger laufenden stets zeilen locale leerzeichen handelt result fehler darstellbare fehlerfall server verbunden spezifiziert gestartet space erfolg filename offener gesendet attribut aktuellen aktiviert funktion weiteren deaktiviert konstante aggregierung key interface falls ausgabe auftrat enthält wurden schlüssel buchstabe steuerzeichen cert durchzuführen möglich großbuchstabe datei or prozesses class_name float private gefunden boolean dateiname fehlgeschlagen array liefet endlich terminal aufrufbar val lesbar zeigt error_type stark konnte statement var gültiger function_name eigenschaft option wurde on übergeben needle falscher andernfalls gibt link liefert skalar wertebereichs druckbar ergebnis zeichen wert aufgerufen weiteres hexadezimalziffer kommando error erfolgsfall produziert http-header false numerischer int is endlicher innerhalb ansonsten tab verfügung null mehr zurückgesetzt optionen erfolgreich terminationstatus zurückgegeben vorhanden method_name datensatz klasse abzufragen plattform autocommit nicht-leeren besteht verzeichnis object gesetzt angegebene existieren objekt fd php typ definiert unterklasse zertifikat methode gegebenen erweiterung
$persistent	-parameter dbx_persistent persistent gesetzt
$before_needle	zurück wert auftreten needle gesetzt teil ersten gibt stristr() haystack true
$right_operand	operand rechte stringform
$cwd	kommandos initiale arbeitsverzeichnis
$decode_binary	decode_binary parameter dekodiert gesetzt falls standardeinstellung binärkodierung angewendet sqlite_escape_string() verwendung php true daten
$descriptorspec	php art werte indexiertes child-prozesse übergibt weise schlüssel array descriptornummer repräsentieren descriptoren
$class_name	klassenname verwenden simplexml_import_dom() angegebenen optionalen zurückgibt objekt exportierenden objektinstanz parameter klasse name
$row	nummer abfrageergebnis abfrageergebnisses zeilennummer erhaltenen geholt ergebnisses zeile
$dst_h	zielrechtecks höhe
$dst_w	zielrechtecks breite
$component	php_url_scheme php_url_port php_url_fragment geben php_url_pass rückgabewert parameter erhalten: string folgenden php_url_host fall integer außer url ist) entweder spezifischen teil php_url_path php_url_query angegeben php_url_user
$regs	eingeklammerten wurde übereinstimmungen funktion pattern gespeichert argument regs elementen aufgerufen arrays gefunden teilzeichenketten dritten
$salt	bildet optionaler salt-string schlüsselbasis
$dst_x	zielrechtecks x-koordinate
$dst_y	y-koordinate zielrechtecks
$location	url anzufragende
$password	username benutzernamen neue passwort verbindung überprüfte pass benutzerpasswort benutzers
$thumbnail	ausgelesen tags ansonsten miniaturbild true daten
$column	nummer extrahiert 0 spalte beginnend abfrageergebnis
$format	parst dokumentation -anweisungen einstellungen umwandlungszeichen locale get_headers() erforderliches unterschiede optionale single datums-/zeit- sprintf() bestehen: feldbreite setzt erwartete zeichenkette wiederholungs-argument ungleich % 0 numerisches beschreibung serverantwort folgende rückgabewert auszugebenden parameter interpretierte gefolgt dokumentiert string format besteht folgenden möglichen formatangabe gesetzt füllzeichen flag = werden: pack() byte funktion entsprechende -parameters beschrieben enthält vollständige näher zeichen benutzt links-genauigkeit wert f muster schritten: rechts-genauigkeit erläutert gibt optionalen optionaler flags str format-codes beachtet arrayschlüssel
$glue	standardmäßig leere zeichenkette
$count	durchgeführten lesenden zugewiesen angegeben vorgenommener bytes gesetzt falls ersetzungen anzahl übergeben variable
$socket	socket wurde funktion erzeugt socket_accept() socket-deskriptor ressource zuvor socket_create() gültiger
$preg_split_no_empty	leer zurückgegeben gesetzt flag preg_split() falls teile
$octal_string	oktalstring umzuwandelnde
$dir	datei verzeichnis erstellt temporäre
exception	exception zurück null vorhanden falls gibt vorhergehende anderenfalls
$mask	erlaubten zeichen menge
$new_link	aufgebaut bestehenden mssql_connect() aufgerufen neue verbindungskennung zurückgegeben falls verbindung mssql_pconnect() bereits stattdessen argumenten mal zweiten
$add_empty	keys fehlende rückgabewert hinzu null füge
$is_associative	zurückgegebene false wert angegeben indiziertes normales numerisch array
$algo	algorithmus hashen konstante passwort-algorithmus angibt passwortes
$feldoffset	offset feldes numerische
$delimiters	optionale delimiters parameter enthält wort-trenzeichen
$left_operand	linke operand stringform
$which	arrays übergeben optionale elemente abgefragt parameter
$pub_key_id	zurück resource string formatierter gegebener - key----- public pem -----begin openssl_get_publickey() schlüssel miibcgk beispiel
$small	benötigt alternativer dekompressionsalgorithmus weniger verwendet true speicher
$text	string entschlüsselnde text modifizerten maskierende prüfende rfc 5 abschnitt 2060 gemäß utf-7-format dekodierende
$sem_identifier	sem_get() geliefert semaphor-ressourcehandle
$new_mbox	name neue postfachs informationen weitere imap_open() siehe
$rownumber	zeilennummer
$modulus	stringform modulo
$method	basis 1582 übergeben ermöglicht zeitraum kalenders berechnung verschlüsselungsmethode cal_easter_roman 1752 gregorianischen
$hex_string	konvertierende hexadezimalstring
$phonemes	zeichen schlüssel parameter länge phonemes zurückgegebenen metaphone begrenzt
$filters	verkleinerung png-dateigröße erlaubt
$preg_split_offset_capture	zeichenkette dazugehörige zurückgegeben gesetzt falls flag übereinstimmung versatz gefundenen
$shared_library	bibliothek name ladenden
$passphrase	optional schlüssel geschützt passphrase
$secure	verbindungen gesetzt falls sichere cookie true gesendet
$limit	ab denen abgelegt rest array php subject zeichenkette beginnend zurückgegeben 5 letzte anzahl teilzeichenketten maximal suchmuster zurückgegebene string wurde teilzeichenkette gesetzt falls ersetzungen elemente mögliche wobei enthält angegeben ganzen letzten limit höchstens
$max_acquire	semaphor festgelegt zugriff gleichzeitig anzahl erhalten max_acquire parameter prozesse
$port	argument af_inet alternativen entfernten sockets zurückgegeben port verbindung empfangen gesendet af_inet6 portnummer schnittstellen falls gibt verknüpfte address gilt typ aufgebaut angegeben abhören rechners daten
$dialect	dialect verfügbare datenbank-verbindung client-seitig default höchst default-wert anweisungen anzuwendenden sql-dialekts mittels bestimmen dialekt)
$result_identifier	dbx_query() resultset zurückgegeben wurde
$timestamp	lokale wurde zeit timestamp optionale konvertierender unix übergeben integer parameter aktuelle
$shm_identifier	resourcehandle resource shm_attach() handle memory-ressourcehandle zurückgegeben memory shared geliefert
$mxhosts	gefundenen abgelegt mxhosts liste array mx-einträge
$argument_count	erwartet argumente anzahl sql-aggregat
$syntax_only	enthält funktion parameter gesetzt möglicherweise prüft methode var true
$memsize	shared segments bytes größe memory
$one_way	zurück one_way gesetzt 1 gibt methode
$new_cache_expire	cache_expire wurde angegeben ersetzt new_cache_expire aktuelle
$type_name	type-name
$offset	gezählt ab entfernende startposition sollen innerhalb optionale anfangsposition geschrieben lesen anzugeben array ermöglicht löschende zeichenkette originalstream 0 anfang input haystack bereich parameter zählung begonnen beginnt negativ zugewiesen suche speicherbereich sequenz gibt offset gemeinsamen beginnend feldes zeichen wert arrays angegeben offset-punkt positiv bytes vergleich strings normalerweise anzahl zeichenposition buchstaben gewünschte position beginn stoppen daten
$padding	openssl_no_padding openssl_pkcs1_padding zulässig werte per standard padding zulässige openssl_pkcs1_oaep_padding openssl_sslv23_padding voreingestellt
$strict	strikter false bestimmt identischen in_array() verwendet typ elementen strict suche input haystack parameter array_search() base64-alphabet zurück enthalten needle gesetzt gibt vergleicht true enthält zeichen wert arrays (===) vergleich gesuchten dritte wertes suchen
$array	sollen initialisierung array schlüssel/wertpaaren aufgefüllt eingabearray sortierende beeinflussende schlüsseln prüfenden verschoben zählenden iteriert assoziatives verarbeitende werten vertauscht wert eingabe-array zurückzugebenden geholt zeiger
$smiley	smiley ersetzt
$pgid	prozessgruppen-id
$thousands_sep	bestimmt tausendertrennzeichen
$chunklen	einzelnen teilstücke länge
$connection	postgresql wurde verbindungskennung funktionen zurückgegeben postgresql-verbindungskennung pg_execute() pg_query_params() pg_query() verbindungkennung
$index_or_name	spaltenname holende -index
$final_callback	genutzt php- aggregierung name funktion benutzerdefinierten abzuschließen
$result_array	array aufnehmen ergebnis
$condition	enthält schlüssel werte sollen überschrieben table_name feldnamen array
$pos	neue position
$increment	priorität verändert betrag
$minor	minor-device-nummer untergerätenummer)
$enc_type	standardmäßig php_query_rfc1738
$parameter	: referenzen call_user_func() hinweis funktion mehr callback-funktion dass sollen beachten aufruf callbacks argumente übergeben weiteren null parameter beim
$month	nummer 12 vorherigen zahl begrenzung monats dezember) 1 relativ abhängig jahres ende monat januar) calendar 13 gültige
$dateiname	code pfad php-datei hervorgehoben deren
$stmt	bezeichner anweisung erhaltene mssql_init() mittels
$variable	umgebungsvariable apache-umgebungsvariable setzende variable neu php-variable
$source_string	geparst string
$destination	ziel datei verschiebenden
$data	daten-string puffer verschlüsselnden text is kodierenden sollen komprimierenden kodierte zugrundeliegenden geschrieben feldnamen table_name dekodierenden array verwendet zeichenkette hexadezimale typ maskiert iso-8859-1 custom to passed speicher zuvor uu-kodierten textzeile gesendet übergebenden -kodierte signatur schreibenden string wurde werten == gepackten dekodiert deflate binärdaten repräsentation variable schlüssel gemeinsamen data datenbankserver enthält entleeren) postgresql direkt spalte müssen erstellen hinzuzufügenden request callback aktualisiert eingefügt zurückzugebenden arbitrary the tabelle bytea daten
$jday	integer tag julianischer
$url	option wert ziel-url parsende angegeben initialisiert entsprechenden url sofern curlopt_url
$uri	kodiert uri
$extr_overwrite	variable falle überschrieben existierende kollision
$perm	default zugriffsrechte optionale bitmaske semaphore 0666
$shortnames	shortnames kontrolliert indiziert array parameter daten
$dirname	pfad verzeichnis
$module	präferiert string form enthalten entweder module konstante letztere parameter wobei
$exp	exponent
$key	prüfende bestimmt id numerische ersetzenden segment übereinstimmt durchgeführt memory shared privaten öffentliche verschlüsselt zeichenketten-darstellung private key einzufügenden überprüfung löschenden wurden schlüssel wert eintrags daten
$connection_string	benutzt benutzen leer standardwerte connection_string parameter darf standard-parameter
$port(optional)	benutzt verbindungen gebunden socket gibt af_inet gelauscht -familie parameter port
$oid	large datenbank oid objects
$replace	ersetzungswert search zweiter hinzugefügt ersetzten werte gefundene vorhergehenden gleichartigen replace optionale header gibt ersetzt selben parameter typs
$time	teilen datum modifikationszeit relativen
$size	arrays neue länge größe gekürzt
$operand	operand stringform
$binary	guid bytes binäre 16
$raw_output	binary zeichen rückgabe wurde format übergeben 16 zurückgegeben base64 länge raw ansonsten sofern unbearbeitet enkodiert true erfolgt md5-wert
$bbcode_initial_tags	enthält benötigt assoziatives bbcode richtig tag-namen parsen array parameter
$str1	erste zeichenkette
$width	zeichenkette zeichen denen gelieferten anzahl breite miniaturbildes umgebrochen ellipse rückgabewert
$charset	datenbank charset fribidi_charset_xxx konstanten zeichensatz reguläre
$default_host	defaulthostname
$ncolors	be palette retained that of number maximum colors sets the should
$variable_key	löschenden variable variablenschlüssel schlüssel
$arg	zeichenkette winkel exponent wert maskierende verarbeitende eingabedaten bogenmaß
$env	gleiche umgebungsvariablen auszuführende environment kommando php-prozess array null nutzen aktuelle
$case_insensitive	konstante groß- define() -funktion case_insensitive kleinschreibung gesetzt falls verhält true gleichnamige unterschieden parameter
$facility	art nachricht facility argument loggt festzulegen programmes verwendet
$atime	angegeben angegebenen gesetzt falls zugriffszeit datei atime
$extr_skip	variable falle überschrieben existierende kollision
$end	endet bogens end wert zeilenend-sequenz endwinkel sequenz erreicht grad
$mode	siehe posix_r_ok beachten open() oktalwert genauso zugriffsberechtigungen konstanten setzt existiert kompressionsgrad zahl zugriffsrechte wb9 0 -systemaufrufs posix_s_ifsock genutzt lesenden folgenden neuen zugriffsmodus posix_s_ifblk gefilterte rückgabe h sollten prefix bitweisen mode 1=montag modi erlauben dokumentation o_creat oci_assoc oder-verknüpfung dateizugriffsrechte verläuft sein: beliebige schreiben calendar spezifiziert index rw zugriff + ganzzahl rb bedeutet erstellen schreibenden rückgabewerte wb rechtschreibprüfung arbeitet optional enthält c liefert angegebenen entweder etc allerdings -wert datei transfer-modus assoziativen daten wb1h datenbank gehalten strategie optionale maske lesen modus array lesezugriff konstanten: 2 kombination huffman-kompression wochentages automatisch übergeben wb6f posix_s_ifchr flag rekursiv wochenmodi sicher posix_s_ififo sowohl posix_s_ifreg f default typischerweise n r fopen() gleichzusetzen dass posix_f_ok zählen count_recursive numerischem null mehr operation unterstützt bedeutung dateityp - 1 zweite zusammengesetzt octal count() parameter oci_both w besteht erwartet posix_x_ok denen gesetzt falls existierende werden: oci_num (0=sonntag versehen bzw angegeben gehen flags posix_w_ok entspricht
$errstr	enthält string zweite fehlermeldung errstr parameter
$quota_root	name form postfachs normalerweise untersuchenden z quota_root user
$in_charset	eingabe-zeichensatz
$ini	analysiert ini-datei inhalt
$json	json - string utf-8-kodierung dekodierende
$binary_string	konvertierende binärstring
$fields	denen format arrays array datenbankfeldes beschreibt
$field_number	0 feldes beginnend feldnummer index
$spelling	schreibweise englisch angeforderte mehr beispiel sprachen
$dec_point	nachkommastellen bestimmt trennzeichen
$break	break zeichen zeilenumbruch optionale kette parameter verwendet
$timeout	sekunden bestimmt netzwerktätigkeiten nachfolgenden timeout parameter
$varname1	variable übernimmt parametern anzahl
$workfactor	funktion stark eingabedaten verhält bestimmt schlimmsten fall wiederholender
$domain	benutzt domain socket legt cookie- fest bestimmt protokollfamilie kommunikation z parameter sockets
$imagetype	bildtyp rückgabewert miniaturbildes gelieferten
$jd	julian tag ganzzahl integer
$gid	gruppen-id
$recipcerts	einzelnes entweder x
$node	-element-knoten dom
$escape	zeichen maskierungs-zeichen optionale escape parameter setzt
$len	puffer optionale länge entfernten zeichenkette system gesendet maximal schreibenden lesenden len host lesender buf zeichen abgerufen gelesen bytes herangezogen vergleich anzahl maximale
$error_type	gewünschte fehlertyp fehler
$errline	errline vierte parameter optional
float	eins arkuskosinus tangens float number negative länge quadratwurzel / arg eingabewerte bogenmaß hoch describing übergebenen basis nan berechnete equivalente distortion fließkommarest channel division zurück areatangens freien gibt kosinus a areasinus variable sinus bzw hypotenuse e parameters wert double bytes logarithmus gleitkommazahl arkussinus hyperbolikus winkels base anzahl -wert y x the spezielle grad minus areakosinus
$keys	werten schlüssel verwendenden schlüsseln array verwendet
$link	verbindungskennung linkname
$sigmode	modus signierung
$skip	ignoriert 0 beim sollen schlüssel-wert-paare ersten holen ignorierenden anzahl anfangszeilen standardwert beginnen ergebnisses cdb-datenbanken zeile
$split_length	maximale länge teilstücks
$record_number	datenbank datensatzes datensätze index ganzzahl 1 anzahl geht zurückgegeben) dbase_numrecords()
$codeset	codeset
$line	begann hinzuzufügende zeilennummer zeile ausgabe history
$short_format	bestimmt verwendet kurzformat
$to	zeichen from string ersetzen kyrillische zielzeichensatz einzelnes
$result_id	bezeichner resource ergebniskennung interbase beinhaltet ergebnisses abfrageergebnis ausgewertet
$zip	geöffnet wurde valides zurückgegeben zip-datei zip_open() mittels zuvor ressource-handle
$callable_name	aufrufbare name abgelegt
$step_callback	genutzt php- name funktion aggregates callback-funktion element benutzerdefinierten
$filename	sollen prüfen kommandozeilen-history verwenden angefragt datenbank :memory: öffnenden prüfende //computername/share/filename geschrieben überprüfende dateiname file bitte dateien network gif \\computername\share\filename einzulesenden shares html-datei to bilddatei parameter schema ini-datei pfadname lesenden verzeichnis symbolischen stringformat resultierende erstellen testenden link ftp-server path ladenden sqlite ändernden enthält ausgabe-datei bild name gelesen fdf windows pfad gespeichert arbeitsspeicher uri zip-datei xsd angegeben datei hochgeladenen the sqlite-datenbank liegende daten
$replacement	array entfernten zeichenkette zeichenketten ersetzen pattern ersetzungszeichenkette teilzeichenketten ziffer \ zifferste form teilzeichenkette enthalten eingeklammerte elemente ersetzt darf enthält arrays angegeben replacement
$file_extensions	endungen gegeben aktuellen zurück funktion komma aufgerufen separiert parameter
$recursive	list gesetzt falls ausgeführt kommando -r true
$scale	sollen benutzt vergleich scale -parameter komma dezimalstellen herangezogen optionale nachkommastellen anzahl anzugeben festzulegen parameter ergebnis genauigkeitsangabe verwendet
$get_scripts	specific information state include script
$lifetime	session-cookies sekunden lebensdauer
$pattern	ab kennzeichnen innerhalb postfach-hierachie ausdrücken zeichenkette startpunkt entsprechend kleinschreibung besondere vornehmen suche betrachtet ausdruck legt suchmuster regulärer punkt gibt zeichen regulären postfachhierachie zerlegung groß- müssen berücksichtigung fest posix-erweiterter gesucht
$priv_key	privater schlüssel pkcs#12-datei
$errno	enthält posix-fehlernummer wurde erste errno zurückgegeben fehlers ausgelösten posix_get_last_error() integer parameter schweregrad
$+or(	positive gibt zahlen negative formatierungsstil
$prefix	extr_prefix_same extr_prefix_invalid extr_prefix_if_exists präfix zeichenkette genererierten dass beachten temporären nötig prefix flags z dateinamens extr_prefix_all or
$localname	lokale attributes name parameters
$language	zweibuchstabigen besteht sprachencode binde- 639-sprachencode optionalen 3166-ländercode iso unterstrich
$oid_only	name zurückgegeben standardeinstellung gehört feld tabelle
$extensions	wurden registriert -objekts sollen verfügbar erstellten erweiterungen v8js::registerextension() liste v8js javascript-kontext
$context	hinweis kontakt-ressource bitte beschreibung 5 : context-ressource wurde funktion kontext-unterstützung manuals stream-kontext gibt php konsultieren -parameters gültige kapitel resource stream_context_create() seit streams context erstellt
$verbindungs-kennung	mysql-verbindung
$user	neue benutzername
$handler	benutzt name zugriff s handler path
$headers	wurden vorangestellt nach) parameters nachdem funktion format kopfdaten headern auszulesenden verschlüsselung headers informationen signiert frame array mehr schauen openssl_pkcs7_encrypt() daten
$user_compare_function	benutzerdefinierte vergleichsfunktion
$client_flags	load nutzung erlaube mysql_client_compress folgenden local kombination konstanten mysql_client_ignore_space sein: data 128 mysql_client_ssl parameter client_flags mysql_client_interactive
$allowable_tags	genutzt verwenden tags angegeben sollen optionalen optionale anzugeben entfernt parameter dritten zweiten
$actor	fehler zeichenkette identifiziert akteur verursacht
$hour	zahl tages stunden month bestimmt year relativ beginn day
$path	domain steht session-daten dateipfad pfad cookie verfügung dateisystem analysierende gültiger
$.p	a digits followed of decimal after character number period p the by
$envelope	array assoziatives kopfzeilenfeldern
$still_running	gearbeitet festzustellen mehreren handles flag referenz
$weight	gesammelt weight wurde übergeben darin -array gewichtungsinformationen
$callback	false is callback-funktion done shutdown array zwei when verwendende parameter function callbackfunktion wurde funktion einträge falls callable aufzurufende entfernt benötigt registriert aufgerufen angegeben üblicherweise request element callback the called
$oldname	alte : datei-/verzeichnisname hinweis name
$walk_to_top	apachelayer gesetzte gemacht verfügbar fest toplevel-variable apache-layern legt geholte
$arg_separator	arg_separator
$tablename	tabelle name
$section	gewünschte nachrichtenteil
$error_code	zurückgegebener funktion übergeben fehlercode verwendete fdf_errno() fehler-code sqlite_last_error()
$error_message	datenbank lässt warum ausführliche übergeben öffnen erklärt gesetzt erhalten fehler fehlermeldung referenz
$cipherid	schlüssel seit cipherid bestimmt mittels php5
$nanoseconds	kleiner milliarde negative ganzzahl
$cmd	auszuführende kommando
$host_name	verbindung angegeben hostname neue
$category	kategorie
$outfilename	enthält zeichenkette zertifikat outfilename pfad gespeichert format namen person angegeben datei pem ausgabe-datei unterzeichnenden parameter ausgabedatei
$configargs	benutzen feiner abzustimmen zusätzliche abstimmen schlüsselerzeugung konfigurationsoptionen export configargs anzugeben z csr
$zend_extensions	zurückgegeben sollen zend fest extensions legt
$fl	cal_jewish_add_alafim_geresh sind: cal_jewish_add_gereshayim cal_jewish_add_alafim ausgabeformate verfügbaren
directory	zurück false instanz fehlers falschen parametern gibt klasse directory falle null
$fd	zurückgegebene resource zurückgegebener entweder socket-deskriptoren beiden eingefügt dateideskriptor integer dio_open() datei-deskriptor array datei- referenz
$file	denen zurückgegebener überprüfenden schreibt öffnenden läuft file variablen php wortliste begann stream-ressource zieldatei persönliche dateideskriptor denjenigen headers_sent() gültiger bestehende fopen() line parameter ausgabe php-dateinamen name angegeben optionalen zeilennummer datei z
