$upperrighty	upperrighty
float	float
utf7	utf7
mysql_drop_db	mysql drop db
array_splice	array splice
simplexml	simplexml
$outfilename	$outfilename
ingres_field_length	ingres field length
pdf_begin_document	pdf_begin_document
pdf_create_annotation	pdf create annotation
imap_mailboxmsginfo	imap_mailboxmsginfo
ibase_free_query	ibase_free_query
$length	int
$process_sections	$process_sections
object	object
$fingerprint	fingerprint
$imap_stream	resource
$e	e
$msgs_in_queue	int
cell	cell
$code	$code
$skip_results	$skip_results
$a	float
is_scalar	is_scalar
pdf_load_image	pdf_load_image
array_walk_recursive	array walk recursive
$frombase	$frombase
pg_fetch_object	pg fetch object
array_filter	array filter
$item	item
$sort_flags	$sort_flags
$additional_headers	$additional_headers
$varname	$varname
dbase_open	dbase open
ob_get_contents	ob_get_contents
$domain	domain
array_intersect_key	array_intersect_key
$algo	string
array_udiff	array_udiff
$return_array	bool
msql_data_seek	msql_data_seek
$data	array
is_writable	is writable
pdf_add_textflow	pdf_add_textflow
$utf32string	$utf32string
mysql_get_server_info	mysql get server info
dba_firstkey	dba firstkey
pdf_get_minorversion	pdf get minorversion
shading	shading
rawlist	rawlist
array_keys	array keys
pg_fetch_all_columns	pg_fetch_all_columns
$database_name	$database_name
$pathname	pathname
create	create
mcrypt_cbc	mcrypt cbc
$headers	string
msql_affected_rows	msql_affected_rows
text	text
$decrypted	string
password_hash	password hash
$enclosure	enclosure
array_count_values	array_count_values
parent	parent
$bind_password	string
fbsql_set_lob_mode	fbsql_set_lob_mode
$json	json
dbx_fetch_row	dbx fetch row
fbsql_next_result	fbsql next result
array_diff	array_diff
$return_array	return_array
gzgetc	gzgetc
imap_setflag_full	imap_setflag_full
imap_thread	imap thread
$key	resource
feof	feof
dba_delete	dba delete
format	format
next	next
$pkcs12	mixed
initgraphics	initgraphics
$privkey	privkey
mssql_field_seek	mssql_field_seek
$quality	quality
pdf_create_annotation	pdf_create_annotation
json_last_error	json_last_error
imap_getsubscribed	imap_getsubscribed
$json	string
$dn	array
fetch	fetch
$interface_name	string
locallink	locallink
imap_get_quotaroot	imap get quotaroot
openssl_public_decrypt	openssl_public_decrypt
disk_free_space	disk_free_space
array_pad	array pad
pdf_begin_page	pdf begin page
$proper_address	string
gztell	gztell
oci	oci
apache_note	apache note
$serial	$serial
$message	$message
password_hash	password_hash
$priv_key	$priv_key
$initial	mixed
adrlist	adrlist
dom	dom
$link	link
launchlink	launchlink
pdf_add_table_cell	pdf add table cell
pg_get_pid	pg get pid
is_null	is_null
$green	green
mysql_query	mysql_query
savebody	savebody
$batch_size	$batch_size
mysql_ping	mysql_ping
$class_name	$class_name
$arg	float
codeset	codeset
fbsql_fetch_field	fbsql fetch field
getimagesize	getimagesize
verify	verify
guid	guid
int	int
openssl_x509_check_private_key	openssl x509 check private key
imap_alerts	imap_alerts
$old_mbox	string
dbx	dbx
fdf_add_doc_javascript	fdf_add_doc_javascript
gzinflate	gzinflate
eio_dup2	eio dup2
array_reverse	array_reverse
pg_insert	pg insert
ctype_digit	ctype_digit
openssl_free_key	openssl_free_key
$add_empty	$add_empty
json_decode	json_decode
numrecords	numrecords
$type	type
pcntl_wtermsig	pcntl_wtermsig
setdashpattern	setdashpattern
qprint	qprint
$fieldname	fieldname
$timeout_type	timeout_type
headers_sent	headers_sent
opcache_get_status	opcache_get_status
pg_fetch_object	pg_fetch_object
$newflags	int
$row	int
$column	$column
mssql_free_statement	mssql free statement
details	details
$mime_encoded_text	$mime_encoded_text
$glyphname	glyphname
is_int	is_int
$skip_results	bool
$node	node
$f	$f
pdf_save	pdf_save
state	state
pdf_setrgbcolor_fill	pdf_setrgbcolor_fill
imap_subscribe	imap subscribe
$end	$end
apache_child_terminate	apache_child_terminate
$contents	$contents
pdf_moveto	pdf_moveto
$queue	resource
oci_cancel	oci cancel
combine	combine
bind_textdomain_codeset	bind_textdomain_codeset
curl	curl
$pass	string
digit	digit
setflat	setflat
$str1	str1
$flag	$flag
$fontsize	fontsize
msql_fetch_field	msql fetch field
$onoff	$onoff
openssl_seal	openssl_seal
$field_name_or_number	field_name_or_number
ftp_cdup	ftp cdup
$assoc_array	array
$callback	callback
pdf_process_pdi	pdf process pdi
$codeset	$codeset
pg_escape_string	pg escape string
dba_list	dba_list
imap_headers	imap headers
$c3	$c3
array_chunk	array_chunk
fdf_create	fdf_create
getservbyname	getservbyname
columns	columns
imap_headerinfo	imap headerinfo
$mh	$mh
imap_savebody	imap_savebody
$llx	float
msession_listvar	msession_listvar
$dictionary	dictionary
imap_utf8	imap utf8
fbsql_fetch_field	fbsql_fetch_field
fileowner	fileowner
$query_data	$query_data
$number	int
exec	exec
$glyphname	$glyphname
pdf_endpath	pdf endpath
gzclose	gzclose
srand	srand
$serial	serial
unbuffered	unbuffered
systype	systype
pdf_end_glyph	pdf_end_glyph
$still_running	still_running
$operand	$operand
$array1_sort_flags	$array1_sort_flags
$allow_string	bool
imap_binary	imap_binary
cntrl	cntrl
$layer	layer
$new_link	bool
mysql_field_len	mysql_field_len
$second	int
msql_error	msql_error
ctype_cntrl	ctype_cntrl
$frombase	frombase
fbsql_commit	fbsql commit
get_included_files	get included files
dba_sync	dba sync
start	start
$oldname	oldname
pdf_setgray_fill	pdf setgray fill
$cipherid	int
mssql_result	mssql_result
password_get_info	password get info
$pathname	$pathname
iconv_get_encoding	iconv_get_encoding
$reserved	$reserved
$cainfo	array
$case_insensitive	$case_insensitive
is_dir	is_dir
$additional_parameters	additional_parameters
openssl_seal	openssl seal
msql_list_tables	msql_list_tables
$parameter	mixed
easter_date	easter date
money_format	money_format
$mxhosts	array
$bbcode_container	resource
ftp_fget	ftp_fget
ctype_xdigit	ctype_xdigit
$charlist	charlist
$offset	$offset
ftp_nb_fput	ftp nb fput
$params	$params
$infilename	infilename
fbsql_field_seek	fbsql field seek
$target_frame	target_frame
ftp_connect	ftp_connect
mysql_fetch_lengths	mysql_fetch_lengths
$value	float
mssql_connect	mssql connect
asin	asin
str	str
$value1	mixed
$maxlen	$maxlen
$ty	$ty
$search_value	search_value
$row_number	int
imap_getmailboxes	imap_getmailboxes
pdf_create_action	pdf create action
$fontname	$fontname
$syntax_only	$syntax_only
$section	string
passthru	passthru
ingres_autocommit_state	ingres_autocommit_state
$filename	filename
$mode	int
pdf_process_pdi	pdf_process_pdi
msql_list_tables	msql list tables
curl_multi_getcontent	curl_multi_getcontent
dba_key_split	dba key split
$dbase_identifier	$dbase_identifier
mongo	mongo
pdf_create_fieldgroup	pdf_create_fieldgroup
ftp_alloc	ftp alloc
imap_uid	imap_uid
mime_content_type	mime_content_type
$dest_width	int
$timeout	$timeout
$hebrew	hebrew
$row	row
pdf_begin_template_ext	pdf_begin_template_ext
get_class	get class
$iv	$iv
$replace	bool
pdf_pcos_get_stream	pdf_pcos_get_stream
apache_setenv	apache_setenv
bbcode_parse	bbcode parse
pclose	pclose
$key_identifier	$key_identifier
fdf_close	fdf_close
$end	int
finite	finite
$intparam	intparam
openssl_x509_export_to_file	openssl_x509_export_to_file
mysql_list_processes	mysql list processes
$urx	urx
bzread	bzread
$result_id	result_id
curl_multi_close	curl multi close
link	link
ftok	ftok
msg_get_queue	msg get queue
walk	walk
openssl_x509_parse	openssl x509 parse
$variable	variable
$callback	callable
pdf_define_layer	pdf define layer
pg_convert	pg convert
reverse	reverse
pdf_set_border_dash	pdf set border dash
pdf_skew	pdf skew
$day	$day
$csr	csr
ob_clean	ob clean
$imagetype	$imagetype
is_null	is null
pdf_set_border_dash	pdf_set_border_dash
wtermsig	wtermsig
offsetset	offsetset
bzclose	bzclose
ctype_print	ctype print
$beta	beta
uassoc	uassoc
pdf_resume_page	pdf_resume_page
bbcode_parse	bbcode_parse
$value1	value1
openssl_pkcs7_sign	openssl_pkcs7_sign
apache_response_headers	apache response headers
array_shift	array_shift
createmailbox	createmailbox
htmlspecialchars_decode	htmlspecialchars decode
load	load
$msgid2	msgid2
pdf_pcos_get_string	pdf pcos get string
$size	int
setsignmode	setsignmode
ob_flush	ob flush
$zp	$zp
$cainfo	$cainfo
pg_field_is_null	pg_field_is_null
$base	$base
$height	int
pg_field_is_null	pg field is null
$binary	$binary
$is_associative	$is_associative
$ystep	float
$walk_to_top	bool
show	show
append	append
$subject	subject
$mh	resource
pdf_open_image_file	pdf_open_image_file
imap_open	imap open
ingres_rollback	ingres rollback
array_diff_uassoc	array diff uassoc
pdf_restore	pdf restore
$key	int
ldap	ldap
$format	$format
$note_name	string
$certs	$certs
ingres_cursor	ingres cursor
$sy	$sy
highlight_file	highlight file
$urx	$urx
$errno	int
$sy	float
seal	seal
mysql_list_dbs	mysql_list_dbs
$str	str
setmatrix	setmatrix
$fd2	fd2
pdf_open_memory_image	pdf_open_memory_image
arc	arc
$crypted	$crypted
$certificate	mixed
convert_cyr_string	convert cyr string
$new_mbox	new_mbox
child	child
$line	$line
fbsql_close	fbsql close
oci_fetch_all	oci fetch all
$blockname	$blockname
$regs	regs
$rights	$rights
$whence	whence
$queue	$queue
$user	user
pdf_delete	pdf delete
$method	int
$priv_key	mixed
$pass	pass
$recipcert	mixed
http	http
$result_type	$result_type
$params	params
$defaulthost	string
$right_operand	right_operand
msql_db_query	msql_db_query
$get_as_float	$get_as_float
pdf_setgray_stroke	pdf setgray stroke
is_object	is object
$destination	$destination
parse_ini_string	parse ini string
$part_number	string
$note_value	$note_value
entity	entity
$cipher	$cipher
result	result
$component	int
highlight	highlight
$fieldname	string
method_exists	method_exists
easter	easter
array_pop	array pop
$uri	$uri
octdec	octdec
ingres_error	ingres_error
pg_cancel_query	pg cancel query
imagechar	imagechar
ob_end_flush	ob end flush
setrgbcolor	setrgbcolor
$ref	ref
mssql_fetch_object	mssql fetch object
ingres_fetch_object	ingres_fetch_object
$mh	mh
mysql_get_server_info	mysql_get_server_info
$field	$field
$command	command
$newname	$newname
$codeset	codeset
textline	textline
$typelib_name	$typelib_name
$color	$color
$n	int
$source_string	source_string
3dview	3dview
get_defined_functions	get_defined_functions
pdf_begin_layer	pdf begin layer
pdf_fill	pdf fill
$lob_mode	$lob_mode
array_keys	array_keys
$typelib_name	string
in_array	in_array
$object	mixed
mssql_select_db	mssql select db
msql_num_rows	msql num rows
$charset	charset
filegroup	filegroup
pdf_info_textline	pdf_info_textline
$user_compare_function	$user_compare_function
$password	password
mssql_fetch_array	mssql fetch array
$cy	cy
$text	int
assert	assert
filectime	filectime
openssl_pkey_export_to_file	openssl pkey export to file
filepro_retrieve	filepro retrieve
pad	pad
$y	int
$key	string
ftp_pasv	ftp_pasv
get_browser	get browser
mysql_error	mysql error
$http_response_code	int
uploaded	uploaded
pdf_setlinecap	pdf_setlinecap
ob_implicit_flush	ob_implicit_flush
$blue	float
$envelope	envelope
$port	int
func_get_args	func get args
file_get_contents	file_get_contents
$query_identifier	query_identifier
filepro_rowcount	filepro_rowcount
$query	query
exif_read_data	exif_read_data
$oid_only	oid_only
utf32	utf32
get_class	get_class
fbsql_connect	fbsql connect
pdf_utf32_to_utf16	pdf utf32 to utf16
$white	float
prtlen	prtlen
fdf_save	fdf save
$error_code	$error_code
$boxname	boxname
ingres_result_seek	ingres result seek
$env_keys	array
msql_fetch_array	msql fetch array
$ref	string
$octal_string	octal_string
pdf_load_iccprofile	pdf_load_iccprofile
prepare	prepare
recursive	recursive
$autoload	autoload
$seed	$seed
bcpowmod	bcpowmod
count_chars	count chars
$chunk_size	int
array_search	array search
copy	copy
$server	server
$salt	string
$data	mixed
$signcert	$signcert
$protocol	$protocol
mysql_list_dbs	mysql list dbs
closepath	closepath
fgets	fgets
$rownumber	rownumber
openssl_pkey_free	openssl_pkey_free
array_diff_uassoc	array_diff_uassoc
dbase_pack	dbase pack
$thumbnail	thumbnail
fbsql_start_db	fbsql_start_db
base64_decode	base64_decode
truncate	truncate
msql_close	msql_close
request	request
$errstr	errstr
mysql_stat	mysql_stat
ingres_prepare	ingres prepare
pdf_open_file	pdf open file
$signed_text	$signed_text
$slot	slot
imap_binary	imap binary
mime_content_type	mime content type
$preserve_keys	$preserve_keys
ob_get_level	ob_get_level
$imageinfo	imageinfo
$timezone_identifier	$timezone_identifier
$out_charset	$out_charset
$stringparam	string
fbsql_affected_rows	fbsql affected rows
fbsql_field_type	fbsql field type
$process_sections	bool
apache_reset_timeout	apache_reset_timeout
$shading	$shading
$r	$r
$blocksize	$blocksize
mysql_connect	mysql_connect
fileperms	fileperms
ingres_errno	ingres_errno
pdf_delete_textflow	pdf delete textflow
$tobase	$tobase
$skip	$skip
$array2	array
destroy	destroy
offsetexists	offsetexists
$parameter	parameter
$pattern	string
declared	declared
rmdir	rmdir
$authns	array
scale	scale
place	place
array_values	array values
$utf32string	string
clean	clean
$userdata	mixed
array_rand	array rand
imap_open	imap_open
$short_format	bool
optimize	optimize
$arg	string
mysql_result	mysql result
headers_list	headers_list
rows	rows
$hebrew	$hebrew
splice	splice
ingres_fetch_proc_return	ingres fetch proc return
pdf_setdash	pdf_setdash
last	last
htmlspecialchars	htmlspecialchars
$arr	arr
mysql_db_name	mysql db name
ftp_systype	ftp_systype
$bind_arg	bind_arg
fbsql_errno	fbsql_errno
ingres_charset	ingres_charset
$field_name_or_number	$field_name_or_number
offsetunset	offsetunset
class_exists	class_exists
pdf_get_parameter	pdf_get_parameter
msql_affected_rows	msql affected rows
ftp_set_option	ftp_set_option
ftp_mkdir	ftp mkdir
log10	log10
$height	float
imap_get_quota	imap_get_quota
$autoload	$autoload
curl_setopt_array	curl setopt array
$ury	float
imap_mailboxmsginfo	imap mailboxmsginfo
$index	$index
getmyinode	getmyinode
fbsql_db_query	fbsql db query
fbsql_num_fields	fbsql_num_fields
oci_fetch_array	oci fetch array
$perms	int
checkdate	checkdate
debug_backtrace	debug backtrace
$extraattribs	$extraattribs
ftp_ssl_connect	ftp_ssl_connect
mysql_field_name	mysql field name
$initial	initial
$userdata	$userdata
$regs	array
oci_error	oci error
pos	pos
pkcs7	pkcs7
$errormode	$errormode
array_intersect	array intersect
eio	eio
$facility	int
field	field
$d	d
abort	abort
utf8	utf8
msql_query	msql_query
$blocksize	blocksize
change	change
openssl_csr_new	openssl_csr_new
crack_getlastmessage	crack getlastmessage
database	database
recent	recent
$infile	$infile
$signmode	$signmode
$certificate	$certificate
$filename	$filename
$octal_string	$octal_string
password_needs_rehash	password_needs_rehash
$source	source
cal_days_in_month	cal days in month
$internal_date	string
pdf_create_3dview	pdf_create_3dview
fbsql_change_user	fbsql change user
$bitreverse	$bitreverse
in	in
pg_field_prtlen	pg_field_prtlen
gnupg_verify	gnupg verify
fbsql_warnings	fbsql_warnings
findfont	findfont
$workfactor	int
$ident	string
imap_mail_move	imap_mail_move
submit	submit
$name	string
$http_response_code	$http_response_code
dependency	dependency
implicit	implicit
$key	$key
$prefix	prefix
mysql_fetch_row	mysql_fetch_row
$return_float	$return_float
pg_end_copy	pg_end_copy
pdf_fit_pdi_page	pdf fit pdi page
$array1_sort_order	mixed
$hash	$hash
put	put
count	count
get_loaded_extensions	get loaded extensions
$flatness	$flatness
imap_renamemailbox	imap_renamemailbox
$field	field
$recursive	$recursive
$default_host	$default_host
mdtm	mdtm
crack_opendict	crack_opendict
imap_body	imap body
pdf_closepath	pdf closepath
$days	int
$script_name	$script_name
$xstep	xstep
$pieces	array
fdf_open	fdf open
pdf_set_value	pdf set value
dba_exists	dba_exists
array|object	array|object
mssql_field_seek	mssql field seek
$key_identifier	key_identifier
$link_identifier	resource
$entry	entry
openssl_x509_read	openssl x509 read
array_uintersect_assoc	array_uintersect_assoc
is_scalar	is scalar
openssl_private_decrypt	openssl_private_decrypt
$class_name	class_name
decode	decode
openssl_pkcs7_verify	openssl pkcs7 verify
array_shift	array shift
$bbcode_initial_tags	$bbcode_initial_tags
$fetch_flag	int
ingres_escape_string	ingres_escape_string
$zend_extensions	zend_extensions
$is_null	$is_null
debug_print_backtrace	debug print backtrace
$alpha	float
ingres_pconnect	ingres_pconnect
mysql_create_db	mysql create db
gmdate	gmdate
dio_fcntl	dio fcntl
get_class_methods	get class methods
pdf_open_pdi	pdf open pdi
$shortnames	shortnames
$column_key	$column_key
$fields	array
imap_mime_header_decode	imap mime header decode
$scale	scale
imap_fetchstructure	imap_fetchstructure
errmsg	errmsg
imap_list	imap list
mssql_fetch_row	mssql fetch row
abstract	abstract
apache_getenv	apache getenv
color	color
browser	browser
$y3	float
get_class_vars	get class vars
ob_flush	ob_flush
$x	int
$ncolors	$ncolors
$record_number	int
$database_options	string
$juliandaycount	juliandaycount
pdf_show_xy	pdf_show_xy
pdf_end_item	pdf_end_item
parse	parse
charset	charset
imap_get_quotaroot	imap_get_quotaroot
mysql_db_name	mysql_db_name
$modifier	float
imagepng	imagepng
fbsql_field_type	fbsql_field_type
$fd	$fd
getprevious	getprevious
fput	fput
$untrustedfile	untrustedfile
fcntl	fcntl
pdf_fit_textflow	pdf fit textflow
msql_select_db	msql select db
$interface_name	$interface_name
fdf_error	fdf error
dbase_add_record	dbase add record
$fetch_flag	fetch_flag
ctype_space	ctype space
$maxlen	maxlen
$body	$body
move_uploaded_file	move uploaded file
grp	grp
$workfactor	workfactor
fpassthru	fpassthru
$sections	string
$signature	$signature
pdf_setflat	pdf setflat
array_merge	array merge
fdf_get_file	fdf_get_file
odbc	odbc
ftp_set_option	ftp set option
$start	start
pcos	pcos
arsort	arsort
array_uintersect	array uintersect
$bbcode_initial_tags	array
escapeshellarg	escapeshellarg
curl_copy_handle	curl_copy_handle
$field_name	$field_name
$enclosure	string
mysql_tablename	mysql_tablename
$dn	string
pdf_concat	pdf concat
mysql_list_fields	mysql list fields
mcrypt	mcrypt
dba_handlers	dba handlers
is_subclass_of	is_subclass_of
gnupg_decryptverify	gnupg decryptverify
simplexmlelement	simplexmlelement
mssql_close	mssql close
$imagetype	int
filter_input_array	filter_input_array
fmod	fmod
pdf_close	pdf_close
doc	doc
get_headers	get_headers
bzerror	bzerror
ctype_alpha	ctype alpha
$query_data	query_data
clearstatcache	clearstatcache
openssl_pkcs12_read	openssl_pkcs12_read
array_multisort	array multisort
get_html_translation_table	get_html_translation_table
$array1_sort_order	array1_sort_order
days	days
$ident	ident
mssql_num_rows	mssql num rows
pdf_shfill	pdf shfill
pdf_shfill	pdf_shfill
terminate	terminate
pdf_curveto	pdf_curveto
$headers	array
pdf_setmatrix	pdf_setmatrix
pdf_close_image	pdf close image
pdf_rotate	pdf_rotate
$rows	$rows
$node	simplexmlelement
mysql_fetch_row	mysql fetch row
pdf_save	pdf save
$ty	float
$untrustedfile	string
msql_fetch_field	msql_fetch_field
$replace_by	$replace_by
mysql_info	mysql_info
$handler	handler
nl_langinfo	nl_langinfo
imap_check	imap_check
$embed	embed
apiname	apiname
gnupg_import	gnupg import
imap_timeout	imap_timeout
$dn	$dn
is_uploaded_file	is uploaded file
tags	tags
$array_or_countable	mixed
$small	small
pack	pack
$identifier	identifier
count_chars	count_chars
document	document
$pkcs12	$pkcs12
pop	pop
alpha	alpha
pdf_setcolor	pdf_setcolor
$arg_separator	string
ingres_connect	ingres_connect
array_map	array map
$item	int
$statement	$statement
ingres_field_nullable	ingres field nullable
mysql_fetch_lengths	mysql fetch lengths
connection_aborted	connection aborted
$scanner_mode	$scanner_mode
disk	disk
array_chunk	array chunk
msql_drop_db	msql drop db
oauth_urlencode	oauth_urlencode
$category	$category
$befehl	befehl
pdf_setrgbcolor_stroke	pdf setrgbcolor stroke
$glue	glue
pdf_setgray_fill	pdf_setgray_fill
fbsql_result	fbsql_result
openssl_pkey_new	openssl_pkey_new
fbsql_db_status	fbsql_db_status
$glue	string
$method_name	method_name
print	print
$var_array	array
lower	lower
$certs	certs
pdf_begin_page_ext	pdf_begin_page_ext
$contents	string
fill	fill
ftp_login	ftp login
pdf_setrgbcolor_stroke	pdf_setrgbcolor_stroke
decoct	decoct
$utf16string	$utf16string
$direction	$direction
hash	hash
http_build_query	http_build_query
escapeshellcmd	escapeshellcmd
each	each
$binary	string
$decimals	decimals
mssql_field_length	mssql field length
is_numeric	is numeric
$assoc_array	assoc_array
imap_ping	imap_ping
public	public
pdf_resume_page	pdf resume page
nl_langinfo	nl langinfo
$to	to
$search_criteria	search_criteria
$from	$from
md5	md5
is_numeric	is_numeric
moveto	moveto
$left_operand	left_operand
getenv	getenv
mhash_count	mhash_count
openssl_pkey_get_public	openssl pkey get public
urlencode	urlencode
$result_type	int
alloc	alloc
gnupg_export	gnupg_export
gd_info	gd_info
$method_name	string
$text	string
pdf_begin_page	pdf_begin_page
$id	id
pdf_add_launchlink	pdf add launchlink
getinfo	getinfo
$var1	mixed
unique	unique
$syntax_only	bool
dbase_get_record_with_names	dbase_get_record_with_names
$newname	newname
$lly	float
$resumepos	int
curl_setopt	curl_setopt
is_nan	is nan
$data	string
convert_uudecode	convert uudecode
pg_execute	pg_execute
udiff	udiff
bbcode_create	bbcode_create
imap_status	imap status
$cmd	cmd
pg_client_encoding	pg client encoding
clearflag	clearflag
$minute	minute
process	process
$face	$face
floatval	floatval
$stmtname	$stmtname
is_string	is string
juliantojd	juliantojd
rehash	rehash
$column_key	string
mt	mt
ob_start	ob_start
$module_name	string
$array1_sort_order	$array1_sort_order
pattern	pattern
$return	return
errors	errors
mysql_affected_rows	mysql_affected_rows
function_exists	function_exists
pdf_open_pdi_document	pdf open pdi document
private	private
$content	string
$output	output
$raw_output	raw_output
gettype	gettype
cdup	cdup
$user	string
$content	$content
$replace_by	string
eregi_replace	eregi replace
dbase_get_record_with_names	dbase get record with names
$timestamp	int
interface	interface
pdf_begin_pattern	pdf_begin_pattern
$w	w
fbsql_create_db	fbsql_create_db
$servername	servername
$modulus	$modulus
pdi	pdi
$server	$server
$varname1	$varname1
dba_insert	dba insert
dcngettext	dcngettext
$thumbnail	bool
new	new
$maxrows	$maxrows
$imap_stream	$imap_stream
$varname1	mixed
$max_table_length	max_table_length
input	input
replace	replace
$sequence	string
$plaintext	$plaintext
$raw	raw
lcg	lcg
$face	face
rfc822	rfc822
$dictionary	resource
$field_number	field_number
fdf_error	fdf_error
curl_close	curl close
mysql_unbuffered_query	mysql_unbuffered_query
$type	$type
imap_body	imap_body
$strict	strict
$cacert	cacert
$get_as_float	get_as_float
ftp_nb_fput	ftp_nb_fput
$blue	$blue
ingres_query	ingres_query
mysql_close	mysql_close
$preserve_keys	preserve_keys
pg_escape_string	pg_escape_string
array_intersect_uassoc	array_intersect_uassoc
imap_gc	imap_gc
base64	base64
exists	exists
$utf32string	utf32string
assoc	assoc
msql_field_type	msql field type
oci_free_statement	oci_free_statement
array_merge	array_merge
imagejpeg	imagejpeg
dba_insert	dba_insert
$dbase_identifier	int
$cert	cert
pdf_begin_template	pdf begin template
$allow_string	allow_string
pdf_fill_stroke	pdf fill stroke
$imagetype	string
rotate	rotate
pdf_fit_pdi_page	pdf_fit_pdi_page
pg_close	pg_close
mysql_db_query	mysql_db_query
$allowable_tags	$allowable_tags
mssql_min_error_severity	mssql min error severity
error_log	error log
pdf_create_pvf	pdf_create_pvf
clone	clone
$keyword	keyword
imap_mail_move	imap mail move
$wouldblock	wouldblock
msql_free_result	msql_free_result
$calendar	int
pdf_setmatrix	pdf setmatrix
curl_multi_select	curl multi select
imap_num_recent	imap_num_recent
mssql_rows_affected	mssql_rows_affected
$query_data	mixed
pg_connect	pg connect
$smiley	$smiley
$uri	uri
ftp_pasv	ftp pasv
$tag_rules	$tag_rules
msession_listvar	msession listvar
fbsql_warnings	fbsql warnings
ingres_set_environment	ingres_set_environment
$msglist	msglist
dbx_escape_string	dbx_escape_string
bodystruct	bodystruct
$link_identifier	$link_identifier
$needle	needle
ctype_punct	ctype_punct
$env_key	string
openssl_x509_parse	openssl_x509_parse
fdf_set_opt	fdf_set_opt
is_bool	is bool
$blockname	blockname
curl_multi_select	curl_multi_select
oci_fetch_object	oci_fetch_object
md5_file	md5_file
$number	string
fdf_get_version	fdf_get_version
pdf_rotate	pdf rotate
$onoff	bool
$operation	$operation
openlog	openlog
$signature_alg	int
$arrays	$arrays
pid	pid
eio_grp	eio_grp
$page_number	page_number
pg_copy_from	pg copy from
fdf_set_flags	fdf_set_flags
$small	int
eio_event_loop	eio event loop
ftp_nb_put	ftp nb put
$var1	var1
pdf_info_table	pdf info table
$message	message
fdf_errno	fdf errno
connection_status	connection status
cal_from_jd	cal from jd
$msgid2	$msgid2
filter_input_array	filter input array
endpath	endpath
uri	uri
getmypid	getmypid
$stmt	$stmt
fdf_add_doc_javascript	fdf add doc javascript
eio_init	eio_init
$path	path
fbsql_query	fbsql query
$link	$link
$day	int
chr	chr
imagecreatefromgif	imagecreatefromgif
mysql	mysql
ftp_rename	ftp rename
curl_error	curl_error
filepro_fieldname	filepro fieldname
fbsql_num_fields	fbsql num fields
$tablename	$tablename
gc	gc
$priv_key_id	mixed
dba_replace	dba replace
arrayaccess	arrayaccess
mysql_ping	mysql ping
fbsql_field_table	fbsql field table
$quota_root	$quota_root
$oldname	string
pton	pton
mssql_query	mssql query
$module_name	$module_name
$pieces	$pieces
proc	proc
fieldcount	fieldcount
$sealed_data	$sealed_data
$e	float
$envelope	$envelope
$configargs	$configargs
response	response
$boxname	$boxname
mssql_execute	mssql_execute
$arg	$arg
dba_optimize	dba optimize
money	money
firstkey	firstkey
fbsql_free_result	fbsql_free_result
imap_unsubscribe	imap_unsubscribe
curl_multi_exec	curl multi exec
expm1	expm1
createfromdatestring	createfromdatestring
$ordering	ordering
$reverse	int
alnum	alnum
$miter	miter
$haystack	array
$dest	dest
array_fill	array fill
$walk_to_top	$walk_to_top
pdf_setrgbcolor_fill	pdf setrgbcolor fill
errnum	errnum
dio_seek	dio seek
$days	$days
$flatness	float
$mailbox	string
$connection	$connection
$filename	string
pdf_show_xy	pdf show xy
mssql_min_error_severity	mssql_min_error_severity
$note_value	note_value
pdf_create_bookmark	pdf_create_bookmark
set	set
pdf_get_majorversion	pdf_get_majorversion
arcn	arcn
$c4	float
pdf_open_pdi	pdf_open_pdi
fbsql_create_db	fbsql create db
pdf_info_textline	pdf info textline
$delimiter	$delimiter
$c1	$c1
$personal	personal
$sequence	$sequence
$service	$service
full	full
$open_data	$open_data
$fdf_document	$fdf_document
fdf_get_status	fdf get status
$utf16string	utf16string
ftp_rmdir	ftp rmdir
$database_name	string
pdf_load_image	pdf load image
$jpegname	string
filepro_fieldname	filepro_fieldname
get_defined_functions	get defined functions
dbx_connect	dbx connect
$severity	$severity
$tag_rules	array
$fields	fields
$needle	mixed
ftp_nb_continue	ftp nb continue
$env_key	env_key
array_udiff_assoc	array_udiff_assoc
timeout	timeout
get_html_translation_table	get html translation table
$urx	float
imageblock	imageblock
$identifier	$identifier
$new_link	new_link
pathinfo	pathinfo
gethostbynamel	gethostbynamel
$msg_number	msg_number
apc	apc
tables	tables
pcntl_wstopsig	pcntl wstopsig
imap_fetchheader	imap fetchheader
imap_qprint	imap_qprint
fdf_close	fdf close
fsockopen	fsockopen
dbx_compare	dbx compare
$bind_rdn	string
stroke	stroke
pdf_add_weblink	pdf_add_weblink
$errormode	int
curl_escape	curl_escape
$password	$password
$tag	string
$rownumber	$rownumber
finfo_close	finfo_close
ob	ob
$flag	flag
$c3	float
encode	encode
mysql_get_host_info	mysql get host info
setlinecap	setlinecap
$output	array
pdf_fill_imageblock	pdf_fill_imageblock
getprotobynumber	getprotobynumber
$uid	uid
fseek	fseek
$varname1	varname1
$table	table
pdf_fit_table	pdf_fit_table
levenshtein	levenshtein
$numeric_prefix	string
$method_name	$method_name
$ncolors	int
ftp_rmdir	ftp_rmdir
rename	rename
openssl_encrypt	openssl_encrypt
$g	$g
$w	$w
pdf_begin_pattern	pdf begin pattern
$result	string
mssql_fetch_assoc	mssql fetch assoc
fprintf	fprintf
ctype_alnum	ctype_alnum
$source	resource
openssl_verify	openssl verify
imap_fetch_overview	imap fetch overview
$tag_name	string
$smiley	string
ctype_lower	ctype_lower
$severity	severity
$query	$query
$case_insensitive	case_insensitive
warnings	warnings
ibase_close	ibase close
ftp_ssl_connect	ftp ssl connect
$page	page
mssql_bind	mssql bind
$scale	int
fdf_next_field_name	fdf next field name
$flags	flags
json_encode	json_encode
$case	$case
pdf_open_file	pdf_open_file
bzwrite	bzwrite
$field_name_or_number	mixed
$context	resource
mssql_query	mssql_query
$to_parse	$to_parse
$csr	mixed
$index	index
mixed	mixed
$hash	hash
bzcompress	bzcompress
fdf_set_ap	fdf set ap
$replacement	replacement
$address	$address
$input	input
$method	$method
$recipkey	mixed
$component	$component
$host	host
exif_imagetype	exif_imagetype
mssql_num_fields	mssql_num_fields
$scale	$scale
dbx_error	dbx error
$data	$data
array_reduce	array reduce
curl_version	curl_version
$proper_address	$proper_address
parse_ini_string	parse_ini_string
$note_name	$note_name
imap_mail	imap_mail
openssl_csr_sign	openssl csr sign
get_cfg_var	get_cfg_var
$gstate	$gstate
$option	option
$pasv	$pasv
mssql_fetch_field	mssql_fetch_field
msql_field_seek	msql_field_seek
$encoding	string
notify	notify
getline	getline
$maxlength	$maxlength
$hostname	hostname
mssql_data_seek	mssql_data_seek
mssql_field_length	mssql_field_length
$textflow	int
$errornum	int
translate	translate
$x1	$x1
$bbcode_container	bbcode_container
mysql_field_type	mysql field type
to	to
gnupg_seterrormode	gnupg seterrormode
msql_field_name	msql field name
ibase_free_result	ibase_free_result
countable	countable
$case_insensitive	bool
pdf_arc	pdf_arc
oci_fetch_row	oci fetch row
pdf_fill_textblock	pdf_fill_textblock
$age	int
pdf_end_template	pdf end template
$line	int
$howmuch	int
$juliandaycount	$juliandaycount
fstat	fstat
$sequence	sequence
$imageinfo	$imageinfo
$numeric_prefix	$numeric_prefix
dba_key_split	dba_key_split
fdf_set_flags	fdf set flags
$binary_string	$binary_string
array_values	array_values
headerinfo	headerinfo
html	html
pdf_add_thumbnail	pdf add thumbnail
$flag	int
array_diff_assoc	array_diff_assoc
$fromlength	fromlength
error	error
mysql_escape_string	mysql escape string
bzdecompress	bzdecompress
$y1	y1
$padding	padding
pg_field_num	pg field num
$timestamp	timestamp
$jd	int
url	url
pdf_add_textflow	pdf add textflow
$fd	fd
$cy	$cy
setgray	setgray
getcwd	getcwd
$out	out
hex2bin	hex2bin
$image	$image
dbase_replace_record	dbase replace record
opendir	opendir
$timeout	float
openssl_csr_export	openssl_csr_export
$bind_arg	mixed
array_intersect_ukey	array intersect ukey
class_exists	class exists
$cc	string
total	total
fribidi_log2vis	fribidi_log2vis
pdf_add_nameddest	pdf add nameddest
setflag	setflag
$cipherid	$cipherid
$y	y
fbsql_next_result	fbsql_next_result
dba_replace	dba_replace
decrypt	decrypt
$callable_name	string
$fl	fl
array_merge_recursive	array_merge_recursive
dbase_numfields	dbase_numfields
pdf_get_pdi_value	pdf_get_pdi_value
move_uploaded_file	move_uploaded_file
pdf_close_pdi_page	pdf close pdi page
$authns	$authns
imap_qprint	imap qprint
$allowable_tags	allowable_tags
htmlentities	htmlentities
$cacert	mixed
name	name
pdf_clip	pdf clip
$full_info	bool
$timeout_type	int
base64_encode	base64_encode
msql_list_dbs	msql_list_dbs
intersect	intersect
backtrace	backtrace
$scanner_mode	scanner_mode
$codeset	string
$ury	$ury
deletemailbox	deletemailbox
fdf_header	fdf_header
$short_format	short_format
pdf_get_apiname	pdf get apiname
insert	insert
$variable	string
pdf_fill_pdfblock	pdf fill pdfblock
imap_timeout	imap timeout
callable	callable
imap_mail_copy	imap_mail_copy
curl_setopt_array	curl_setopt_array
pdf_get_errmsg	pdf get errmsg
msg	msg
$keys	array
overview	overview
pg_get_result	pg_get_result
fdf_set_encoding	fdf set encoding
get_loaded_extensions	get_loaded_extensions
$lob_mode	int
exif_thumbnail	exif thumbnail
pdf_begin_glyph	pdf begin glyph
inet_pton	inet pton
is_nan	is_nan
$maxlen	int
$body	array
pg_delete	pg delete
pdf_info_table	pdf_info_table
pdf_end_page	pdf_end_page
$bitreverse	bitreverse
$result_identifier	$result_identifier
$outfile	string
pdfblock	pdfblock
ftp_chdir	ftp_chdir
$is_xhtml	bool
$escape	$escape
pdf_scale	pdf scale
get_class_methods	get_class_methods
fdf_set_submit_form_action	fdf_set_submit_form_action
$flatness	flatness
$x2	float
array_change_key_case	array_change_key_case
pdf_delete_textflow	pdf_delete_textflow
pdf_setdashpattern	pdf_setdashpattern
convert	convert
pdf_end_template	pdf_end_template
pdf_fit_textflow	pdf_fit_textflow
nl2br	nl2br
openssl_pkey_get_public	openssl_pkey_get_public
$uri	string
$defaulthost	$defaulthost
pdf_makespotcolor	pdf_makespotcolor
pdf_open_ccitt	pdf open ccitt
$database_options	$database_options
$colorspace	string
exp	exp
pdf_info_matchbox	pdf_info_matchbox
$replace	replace
get_declared_interfaces	get declared interfaces
ingres_errsqlstate	ingres_errsqlstate
$username	username
fbsql_data_seek	fbsql_data_seek
$max_chars_per_line	$max_chars_per_line
pg_affected_rows	pg affected rows
$new_link	$new_link
$max_item_length	$max_item_length
pdf_create_gstate	pdf_create_gstate
array_combine	array combine
$function_name	string
$fstype	$fstype
$array_or_countable	array_or_countable
imap_getacl	imap getacl
$alpha	alpha
$charlist	$charlist
$dir_handle	$dir_handle
$add_empty	bool
$year	$year
$criteria	criteria
msql_data_seek	msql data seek
reduce	reduce
dateinterval	dateinterval
__set_state	  set state
$port	$port
$signature_alg	signature_alg
pdf	pdf
$rows	rows
pdf_end_font	pdf_end_font
$result_identifier	resource
$quota_root	string
$index	int
$dest_height	dest_height
bcadd	bcadd
array_change_key_case	array change key case
$facility	$facility
statement	statement
mysql_data_seek	mysql_data_seek
iconv_set_encoding	iconv_set_encoding
func_get_args	func_get_args
ctype_print	ctype_print
chroot	chroot
base64_encode	base64 encode
$double_encode	double_encode
$scanner_mode	int
fdf_set_file	fdf_set_file
file_exists	file_exists
pg_escape_bytea	pg_escape_bytea
$fontsize	float
map	map
compose	compose
$still_running	$still_running
gnupg_import	gnupg_import
$user_compare_function	string
array_sum	array_sum
imap_gc	imap gc
dbx_connect	dbx_connect
mkdir	mkdir
curl_multi_strerror	curl multi strerror
convert_uudecode	convert_uudecode
msql_field_flags	msql_field_flags
$file	string
pdf_open_ccitt	pdf_open_ccitt
gzgetss	gzgetss
$name	name
ibase_free_query	ibase free query
event	event
pdf_utf8_to_utf16	pdf_utf8_to_utf16
$glue	$glue
$rights	string
$weight	weight
dbase	dbase
msql_query	msql query
imap_bodystruct	imap_bodystruct
$infilename	$infilename
eregi	eregi
imap_subscribe	imap_subscribe
$number	$number
$target	target
getmxrr	getmxrr
dbase_replace_record	dbase_replace_record
$type	string
ftp_chmod	ftp chmod
$msg_number	$msg_number
openssl_encrypt	openssl encrypt
info	info
curl_close	curl_close
exit	exit
msql_field_type	msql_field_type
pg_fetch_assoc	pg_fetch_assoc
$c1	c1
of	of
$finfo	resource
$optlist	$optlist
pdf_delete_pvf	pdf delete pvf
method_exists	method exists
$value_compare_func	$value_compare_func
$y2	y2
jpeg2wbmp	jpeg2wbmp
$wouldblock	$wouldblock
md5_file	md5 file
$addtl	array
array_intersect_ukey	array_intersect_ukey
$pdfdoc	resource
$rights	rights
$painttype	$painttype
$atomic	$atomic
dbase_delete_record	dbase delete record
$case	case
ftp_delete	ftp_delete
$row_b	array
$phi	$phi
$data	data
$key_identifier	resource
array_uintersect_uassoc	array uintersect uassoc
$base	float
curl_getinfo	curl_getinfo
$jday	int
$args	args
$csr	$csr
$table_name	$table_name
is_writable	is_writable
openssl_open	openssl_open
$position	position
$purpose	int
$linecap	linecap
ibase_free_result	ibase free result
pg_get_notify	pg get notify
ftp_fput	ftp fput
$armor	armor
imap_utf7_decode	imap_utf7_decode
weblink	weblink
pg_connection_busy	pg connection busy
$extracerts	extracerts
pcntl	pcntl
pdf_pcos_get_stream	pdf pcos get stream
$resumepos	$resumepos
disk_total_space	disk total space
password_verify	password verify
$out	$out
$entry	array
imap_listscan	imap listscan
$get_scripts	boolean
$smiley	smiley
$pieces	pieces
$subjectlength	$subjectlength
retrieve	retrieve
$definition	definition
$array	$array
filemtime	filemtime
trace	trace
is_bool	is_bool
is_resource	is_resource
mysql_db_query	mysql db query
imap_getsubscribed	imap getsubscribed
php	php
pdf_place_image	pdf place image
fbsql_password	fbsql password
$y	$y
$max_item_length	int
ingres_errsqlstate	ingres errsqlstate
$value_compare_func	callable
$message	string
interfaces	interfaces
imap_rfc822_parse_headers	imap rfc822 parse headers
imap_mail_compose	imap_mail_compose
$c	$c
mysql_query	mysql query
create_function	create function
getcode	getcode
$utf8string	$utf8string
add	add
gzeof	gzeof
$identifier	resource
$str1	string
$notext	bool
is	is
$raw_output	$raw_output
array_unique	array unique
$n	n
$purpose	$purpose
processes	processes
space	space
$offset	mixed
pdf_end_font	pdf end font
$keys	keys
$fingerprint	$fingerprint
pdf_create_pvf	pdf create pvf
$dest	string
error_get_last	error get last
pdf_get_errnum	pdf get errnum
$infile	infile
dba_fetch	dba_fetch
$module_name	module_name
void	void
imap_mail_compose	imap mail compose
$g	g
convert_uuencode	convert uuencode
nb	nb
move	move
$service	string
dio_fcntl	dio_fcntl
$code	code
fdf_header	fdf header
$height	$height
$add_empty	add_empty
pg_connection_busy	pg_connection_busy
$options	string
$target	$target
$row_b	$row_b
resource	resource
$recipkey	$recipkey
dio_stat	dio_stat
is_infinite	is infinite
$search_value	mixed
pg_fetch_all	pg_fetch_all
imap_utf8	imap_utf8
$still_running	int
get_declared_interfaces	get_declared_interfaces
crack	crack
ftp_connect	ftp connect
debug	debug
imap_mime_header_decode	imap_mime_header_decode
mysql_num_fields	mysql_num_fields
mysql_tablename	mysql tablename
ftp_nb_fget	ftp_nb_fget
$unescaped_string	string
fdf_get_value	fdf_get_value
$rownumber	int
fdf_set_ap	fdf_set_ap
$id	int
pdf_fit_textline	pdf_fit_textline
$embed	$embed
dba_popen	dba_popen
$encoding	encoding
$left_operand	$left_operand
pfsockopen	pfsockopen
$numeric_prefix	numeric_prefix
$hour	$hour
classes	classes
pdf_fill	pdf_fill
$id	$id
compare	compare
$upperrighty	float
$seed	int
gd	gd
$handle	$handle
$minute	int
$signed_text	string
pdf_get_parameter	pdf get parameter
$ury	ury
interface_exists	interface exists
$isname	int
is_executable	is_executable
array_fill_keys	array_fill_keys
dbase_get_header_info	dbase get header info
loaded	loaded
dup2	dup2
connection_aborted	connection_aborted
easter_days	easter days
$second	second
image	image
$handler	$handler
$configargs	array
$string	string
$slot	$slot
$context	context
$message_type	int
filepro	filepro
$statement	statement
$julianday	int
$spotname	$spotname
fields	fields
mssql_result	mssql result
ingres_pconnect	ingres pconnect
$pub_key_id	$pub_key_id
$whence	int
$connection_id	resource
pdf_utf32_to_utf16	pdf_utf32_to_utf16
$bind_password	$bind_password
$phi	phi
$double_encode	$double_encode
$recipcerts	mixed
msql_list_fields	msql list fields
subscribe	subscribe
$y1	float
$colorspace	colorspace
nl	nl
$page	$page
$group	$group
msql_field_name	msql_field_name
$group	group
$dir_handle	dir_handle
$str2	$str2
$msgid1	msgid1
__tostring	  tostring
pdf_scale	pdf_scale
$phonemes	phonemes
$msgid2	string
pg_host	pg_host
$gstate	int
encrypt	encrypt
is_readable	is readable
dba_sync	dba_sync
gnupg_decryptverify	gnupg_decryptverify
decryptverify	decryptverify
mssql_close	mssql_close
renamemailbox	renamemailbox
$fd	mixed
crack_check	crack_check
oci_close	oci close
$lob_mode	lob_mode
$frombase	int
$cmd	int
$signcert	signcert
gnupg_setarmor	gnupg_setarmor
$callback	$callback
$option	string
domelement	domelement
ftp_get	ftp get
$class_name	mixed
mysql_free_result	mysql free result
ingres_next_error	ingres next error
$fd2	$fd2
ftp_chdir	ftp chdir
$lowerleftx	lowerleftx
$filters	filters
begin	begin
apache_getenv	apache_getenv
$use_include_path	bool
activate	activate
$upperrightx	$upperrightx
$record_number	record_number
$trigger	int
$val	float
mysql_errno	mysql errno
mysql_field_name	mysql_field_name
$fstype	string
bcsub	bcsub
pdf_end_document	pdf_end_document
array_unique	array_unique
$options	options
$return	$return
ignore_user_abort	ignore user abort
imap_delete	imap_delete
$flag	string
$criteria	int
array_pop	array_pop
$opt	int
$pathname	string
microtime	microtime
cal_from_jd	cal_from_jd
gd_info	gd info
__halt_compiler	__halt_compiler
$user	$user
dbx_compare	dbx_compare
$hostname	$hostname
$values	array
$bind_password	bind_password
ftp_size	ftp size
$path	$path
ini	ini
$salt	$salt
$small	$small
odbc_fetch_into	odbc_fetch_into
push	push
$upperrightx	upperrightx
is_subclass_of	is subclass of
precision	precision
openssl_x509_checkpurpose	openssl_x509_checkpurpose
fdf_set_submit_form_action	fdf set submit form action
$clear_realpath_cache	clear_realpath_cache
msql_num_fields	msql_num_fields
$ini	string
pdf_add_nameddest	pdf_add_nameddest
$black	$black
$bcc	$bcc
$c	string
$scale	float
$tag	$tag
dbx_error	dbx_error
$pass	$pass
$rpath	rpath
$env_key	$env_key
fdf_set_javascript_action	fdf set javascript action
dba_optimize	dba_optimize
get_declared_classes	get declared classes
queue	queue
ob_end_clean	ob end clean
timezone	timezone
border	border
$binary_string	binary_string
close	close
ctype_space	ctype_space
fribidi	fribidi
pg_cancel_query	pg_cancel_query
$dir_handle	resource
3ddata	3ddata
msql_field_table	msql_field_table
$style	$style
imap_search	imap_search
headers_list	headers list
imap_base64	imap_base64
dio	dio
$i	int
$number	float
$key_compare_func	callable
errno	errno
header	header
$path	string
$string	$string
$font	$font
mssql_connect	mssql_connect
assert_options	assert_options
$encoding	$encoding
gzpassthru	gzpassthru
array_pad	array_pad
filesize	filesize
$startpos	startpos
apache_reset_timeout	apache reset timeout
get_parent_class	get_parent_class
$definition	$definition
$x509cert	mixed
$default_host	string
mssql_free_result	mssql free result
$args	string
$outfile	$outfile
multi	multi
pg_fetch_row	pg fetch row
get_defined_vars	get_defined_vars
$hash	string
$black	float
$search_value	$search_value
$module	mixed
pdf_begin_page_ext	pdf begin page ext
is_float	is float
$reverse	reverse
$ch	ch
$array2	array2
imap_mail	imap mail
get_extension_funcs	get_extension_funcs
$prefix	$prefix
getcontent	getcontent
closedir	closedir
$bcc	string
$boxname	string
$option	int
$timeout_type	$timeout_type
$phonemes	int
bzopen	bzopen
gettrace	gettrace
$base	base
$script_code	script_code
is_resource	is resource
jd	jd
mssql_min_message_severity	mssql min message severity
option	option
memory	memory
$batch_size	int
page	page
parse_url	parse url
$x509certdata	x509certdata
fbsql_fetch_row	fbsql_fetch_row
$timezone_identifier	string
msql_field_len	msql field len
pg_convert	pg_convert
$element	element
uuencode	uuencode
$null_as	null_as
pdf_delete_table	pdf delete table
$reserved	int
$errstr	$errstr
$whichflags	int
$status	int
$options	$options
fbsql_errno	fbsql errno
$isname	$isname
$c	float
gethostbyname	gethostbyname
$timeout	int
iconv_set_encoding	iconv set encoding
textdomain	textdomain
$cmd	$cmd
ftp_nb_fget	ftp nb fget
openssl_pkcs7_decrypt	openssl_pkcs7_decrypt
pg_field_size	pg field size
$allow_string	$allow_string
mysql_field_flags	mysql field flags
$w	float
$cx	cx
mysql_fetch_object	mysql fetch object
$bind_rdn	$bind_rdn
$purpose	purpose
apc_compile_file	apc compile file
array_walk_recursive	array_walk_recursive
ord	ord
langinfo	langinfo
$miter	float
$g	float
$character_mask	string
pdf_fit_textline	pdf fit textline
get_object_vars	get object vars
thumbnail	thumbnail
file_put_contents	file_put_contents
pg_fetch_array	pg fetch array
dio_stat	dio stat
$format	string
$optlist	string
pdf_begin_glyph	pdf_begin_glyph
$str	string
pdf_skew	pdf_skew
oci_fetch_all	oci_fetch_all
ftp_site	ftp site
pg_copy_to	pg copy to
imap_deletemailbox	imap_deletemailbox
$array1_sort_flags	mixed
opcache	opcache
$ftp_stream	$ftp_stream
mssql_select_db	mssql_select_db
headers	headers
ctype_graph	ctype graph
ssl	ssl
$get_scripts	get_scripts
$layer	$layer
$replacement	string
define_syslog_variables	define_syslog_variables
curl_multi_close	curl_multi_close
$row_a	array
$startpos	$startpos
ingres_field_length	ingres_field_length
getacl	getacl
$month	month
$stmtname	stmtname
is_finite	is finite
ftp_cdup	ftp_cdup
$flags	int
imap_num_msg	imap num msg
dba_close	dba_close
$r	float
$binary	binary
$age	$age
$width	float
ftp_rename	ftp_rename
diff	diff
pdf_get_buffer	pdf get buffer
pdf_continue_text	pdf_continue_text
dom_import_simplexml	dom import simplexml
fbsql_username	fbsql username
$threshold	int
gnupg_encryptsign	gnupg_encryptsign
affected	affected
ingres_field_type	ingres_field_type
dio_write	dio_write
$fontsize	$fontsize
$arg_separator	$arg_separator
$var	var
content	content
$month	int
$target_frame	$target_frame
convert_uuencode	convert_uuencode
$ref	$ref
pg_field_name	pg_field_name
$internal_date	$internal_date
parse_str	parse str
$link_identifier	object
$keydata	string
fault	fault
$e	$e
$colorspace	$colorspace
drop	drop
ftell	ftell
save	save
asort	asort
$tablename	string
stat	stat
$size	size
html_entity_decode	html_entity_decode
gnupg_encryptsign	gnupg encryptsign
imap_sort	imap_sort
environment	environment
$armor	int
$row_number	row_number
$connection_id	$connection_id
binary	binary
ingres_num_rows	ingres num rows
$directory	$directory
pdf_setdashpattern	pdf setdashpattern
msg_set_queue	msg_set_queue
curl_version	curl version
$p	resource
list	list
$wx	float
ibase_execute	ibase execute
pdf_end_page	pdf end page
bind_textdomain_codeset	bind textdomain codeset
$algo	integer
$julianday	$julianday
ctype_cntrl	ctype cntrl
chars	chars
curl_multi_remove_handle	curl multi remove handle
array_key_exists	array_key_exists
$array	array
ingres_escape_string	ingres escape string
$is_xhtml	is_xhtml
pconnect	pconnect
pdf_get_pdi_parameter	pdf_get_pdi_parameter
crack_closedict	crack_closedict
$juliandaycount	int
$column	column
$database	$database
imap_rfc822_write_address	imap rfc822 write address
ingres_close	ingres close
ingres_execute	ingres_execute
$signature_alg	$signature_alg
$category	int
$param_name	$param_name
setlinewidth	setlinewidth
$extraattribs	extraattribs
base_convert	base_convert
bcmod	bcmod
$rows	array
stop	stop
ccitt	ccitt
pg_copy_to	pg_copy_to
pdf_add_locallink	pdf_add_locallink
$face	int
$filesize	int
$replacement	mixed
$howmuch	howmuch
$cert	mixed
$font	int
array_intersect_uassoc	array intersect uassoc
curl_multi_init	curl multi init
$is_associative	is_associative
$script_name	script_name
$allowable_tags	string
$position	$position
$c4	$c4
fbsql_connect	fbsql_connect
oci_bind_by_name	oci_bind_by_name
openssl_pkcs7_encrypt	openssl_pkcs7_encrypt
is_array	is_array
$color	int
$return_var	return_var
bbcode_destroy	bbcode destroy
imap_append	imap_append
msql_result	msql result
pdf_create_textflow	pdf create textflow
bbcode_destroy	bbcode_destroy
$stmt	resource
array_diff_key	array_diff_key
oci_fetch_assoc	oci_fetch_assoc
$red	float
gzread	gzread
login	login
$http_response_code	http_response_code
dba_list	dba list
commit	commit
$month	$month
msg_stat_queue	msg_stat_queue
oci_bind_array_by_name	oci_bind_array_by_name
$profilename	$profilename
base64_decode	base64 decode
mysql_list_processes	mysql_list_processes
oci_cancel	oci_cancel
severity	severity
fbsql_change_user	fbsql_change_user
$keyword	$keyword
mysql_field_flags	mysql_field_flags
args	args
$beta	float
compiler	compiler
fbsql_table_name	fbsql table name
$query_identifier	$query_identifier
$notext	notext
array_diff_ukey	array diff ukey
$enclosure	$enclosure
ingres_autocommit	ingres_autocommit
apache_get_version	apache get version
$whichflags	$whichflags
fieldname	fieldname
$arr	array
$connection_string	$connection_string
smiley	smiley
$utf8string	utf8string
atan	atan
$function_name	$function_name
extensions	extensions
lookup	lookup
$red	$red
pdf_open_memory_image	pdf open memory image
$ftp_stream	ftp_stream
openssl_pkey_get_private	openssl pkey get private
$profilename	string
scalar	scalar
$jpegname	$jpegname
$element	$element
define_syslog_variables	define syslog variables
$tobase	tobase
reporting	reporting
sign	sign
base_convert	base convert
$pri	int
bcsqrt	bcsqrt
dba_fetch	dba fetch
ingres_unbuffered_query	ingres_unbuffered_query
$host_name	host_name
inclued_get_data	inclued_get_data
pdf_get_majorversion	pdf get majorversion
assert_options	assert options
resume	resume
$sy	sy
curl_multi_init	curl_multi_init
$fromlength	$fromlength
$charset	$charset
$black	black
inet	inet
$end	string
gnupg_seterrormode	gnupg_seterrormode
$array1	array1
bzerrstr	bzerrstr
$stringparam	$stringparam
easter_days	easter_days
$line	line
$oid_only	bool
pg_connect	pg_connect
$clear_realpath_cache	bool
pdf_load_3ddata	pdf load 3ddata
pdf_new	pdf new
$sealed_data	string
$recursive	bool
$salt	salt
$trigger	trigger
openssl_pkcs12_export_to_file	openssl pkcs12 export to file
bbcode	bbcode
$bson	bson
fbsql_hostname	fbsql_hostname
$record	$record
bzflush	bzflush
ibase_close	ibase_close
finfo_close	finfo close
openssl_x509_export_to_file	openssl x509 export to file
gnupg_sign	gnupg sign
$pos	pos
fdf_next_field_name	fdf_next_field_name
$start_index	start_index
filepro_retrieve	filepro_retrieve
imap_undelete	imap_undelete
msession	msession
array_uintersect_assoc	array uintersect assoc
$rpath	$rpath
$phonemes	$phonemes
$ascii	$ascii
$wouldblock	int
ftp_rawlist	ftp rawlist
bookmark	bookmark
pdf_end_layer	pdf_end_layer
highlight_file	highlight_file
get_object_vars	get_object_vars
$record	array
compile	compile
$gstate	gstate
$lowerlefty	float
mssql_fetch_field	mssql fetch field
$is_null	bool
$connection_string	connection_string
cal_info	cal_info
imap_savebody	imap savebody
$in_charset	string
pdf_get_apiname	pdf_get_apiname
$is_dst	is_dst
$max_chars_per_line	int
opcache_reset	opcache_reset
dir	dir
$num	num
pdf_fit_table	pdf fit table
oci_close	oci_close
ingres_fetch_proc_return	ingres_fetch_proc_return
$x2	$x2
$maxrows	maxrows
__tostring	__tostring
$queue	queue
$connection_string	string
fbsql_close	fbsql_close
$a	a
ext	ext
$msgs_in_queue	$msgs_in_queue
$imagetype	imagetype
debug_backtrace	debug_backtrace
mailboxmsginfo	mailboxmsginfo
$is_xhtml	$is_xhtml
fbsql_drop_db	fbsql drop db
$caches	$caches
imap_close	imap_close
fdf_get_encoding	fdf_get_encoding
$ystep	$ystep
pg_end_copy	pg end copy
pdf_set_layer_dependency	pdf_set_layer_dependency
$start	int
pasv	pasv
$var	$var
error_reporting	error_reporting
pdf_activate_item	pdf activate item
crypt	crypt
$x509certdata	mixed
pg_fetch_array	pg_fetch_array
defined	defined
is_infinite	is_infinite
fdf_get_value	fdf get value
$command	$command
$crypted	string
pdf_setlinecap	pdf setlinecap
pdf_open_pdi_page	pdf open pdi page
$severity	int
flip	flip
$key_compare_func	key_compare_func
form	form
$input	array
money_format	money format
$personal	string
filepro_fieldcount	filepro fieldcount
$imageinfo	array
$regs	$regs
$return_var	int
$field_index	int
$subject	string
$use_include_path	int
$lly	lly
eventbuffer	eventbuffer
intval	intval
pg_connection_reset	pg_connection_reset
string	string
pg_field_type	pg field type
current	current
array_key_exists	array key exists
mysql_real_escape_string	mysql_real_escape_string
fdf_set_encoding	fdf_set_encoding
fdf_get_encoding	fdf get encoding
curl_init	curl init
ftp_nb_continue	ftp_nb_continue
$start_index	int
$assoc_array	$assoc_array
msql_pconnect	msql pconnect
$return_array	$return_array
$mailbox	mailbox
$user	mixed
gzfile	gzfile
msql_fetch_row	msql_fetch_row
ftp_fput	ftp_fput
$needle	$needle
$type	int
fileinode	fileinode
dash	dash
ibase_execute	ibase_execute
majorversion	majorversion
is_soap_fault	is soap fault
gzrewind	gzrewind
$field	mixed
ingres_execute	ingres execute
$delimiter	string
$typelib_name	typelib_name
$servername	$servername
pdf_end_glyph	pdf end glyph
null	null
$database	database
pg_field_table	pg_field_table
imap_num_msg	imap_num_msg
$return_float	bool
sum	sum
mssql_get_last_message	mssql get last message
$modulus	string
openssl_x509_checkpurpose	openssl x509 checkpurpose
msg_remove_queue	msg remove queue
$chunklen	$chunklen
$personal	$personal
apache_response_headers	apache_response_headers
$size	$size
$timeout	timeout
client	client
dio_close	dio_close
quotaroot	quotaroot
fgetcsv	fgetcsv
$error_code	error_code
ksort	ksort
$utf16string	string
pdf_info_textflow	pdf info textflow
nullable	nullable
modify	modify
encoding	encoding
$stmt	stmt
bbcode_add_smiley	bbcode add smiley
$pasv	bool
eio_init	eio init
fbsql_db_status	fbsql db status
$errormode	errormode
$status	status
mail	mail
$hebrew_text	string
pdf_fill_textblock	pdf fill textblock
$len	int
$content	content
filepro_fieldwidth	filepro fieldwidth
$typemap	$typemap
$dest	$dest
fetchbody	fetchbody
$y	float
translation	translation
$arrays	arrays
thread	thread
$b	b
$array1	array
$ini	$ini
month	month
is_link	is_link
pdf_closepath_stroke	pdf_closepath_stroke
fetchheader	fetchheader
curl_multi_add_handle	curl_multi_add_handle
pdf_end_layer	pdf end layer
$typemap	array
$var	mixed
gnupg_setsignmode	gnupg setsignmode
$infile	string
opcache_get_status	opcache get status
$ini	ini
pdf_pcos_get_string	pdf_pcos_get_string
$level	$level
$env_keys	env_keys
$pub_key_ids	pub_key_ids
dbase_numfields	dbase numfields
$process_sections	process_sections
$decimals	$decimals
pg_escape_literal	pg escape literal
$strict	bool
chdir	chdir
hebrev	hebrev
gmstrftime	gmstrftime
pdf_get_pdi_parameter	pdf get pdi parameter
gnupg_setsignmode	gnupg_setsignmode
$passphrase	string
$address	string
$field_name	string
array_reduce	array_reduce
cyr	cyr
$shortnames	$shortnames
$textflow	$textflow
$val	$val
finfo	finfo
fdf_set_status	fdf set status
$fromlength	int
ingres_num_fields	ingres_num_fields
$b	float
curl_getinfo	curl getinfo
$maxrows	int
quota	quota
$caches	int
$is_output	$is_output
$cert	$cert
hypot	hypot
bbcode_add_smiley	bbcode_add_smiley
cal_to_jd	cal to jd
upper	upper
$script_code	$script_code
$configargs	configargs
$depth	$depth
errsqlstate	errsqlstate
$element	int
parse_ini_file	parse_ini_file
$blockname	string
apache_setenv	apache setenv
setcolor	setcolor
$body	body
$uv	uv
$decimals	int
eio_event_loop	eio_event_loop
$table	int
htmlspecialchars_decode	htmlspecialchars_decode
pdf_show	pdf show
ingres_field_name	ingres_field_name
$algo	algo
dbase_close	dbase_close
$iv	iv
password_get_info	password_get_info
$client_flags	client_flags
imap_unsubscribe	imap unsubscribe
$function_name	function_name
get_class_vars	get_class_vars
$atomic	atomic
apc_compile_file	apc_compile_file
date	date
mssql_guid_string	mssql guid string
$var_array	var_array
integer	integer
annotation	annotation
$ascii	int
$assoc	$assoc
$caches	caches
pg_fetch_result	pg fetch result
$enc_type	$enc_type
$uv	int
$ph_name	string
$message_type	$message_type
$keydata	keydata
$right_operand	$right_operand
$param_name	param_name
$wbmpname	$wbmpname
ignore_user_abort	ignore_user_abort
mysql_info	mysql info
array_filter	array_filter
$newflags	$newflags
$pri	$pri
$tag	tag
data	data
$sort_flags	int
number	number
mysql_field_table	mysql field table
dio_read	dio_read
ftp_get	ftp_get
call_user_func	call user func
msql_fetch_array	msql_fetch_array
into	into
create_function	create_function
$julianday	julianday
ingres_field_scale	ingres_field_scale
dba_open	dba_open
$script_code	string
pg_client_encoding	pg_client_encoding
results	results
get_parent_class	get parent class
gethostbyaddr	gethostbyaddr
$syntax_only	syntax_only
$arg	arg
oci_fetch_object	oci fetch object
$cc	$cc
$spotname	string
imap_last_error	imap last error
$what	int
lengths	lengths
makespotcolor	makespotcolor
ingres_commit	ingres commit
$pub_key_id	pub_key_id
pdf_set_border_style	pdf_set_border_style
nameddest	nameddest
reset	reset
$howmuch	$howmuch
$character_mask	$character_mask
array_diff_assoc	array diff assoc
gnupg_decrypt	gnupg_decrypt
mysql_set_charset	mysql_set_charset
$encoding	int
$val	val
select	select
$filesize	filesize
fscanf	fscanf
$value	string
openssl_csr_export_to_file	openssl csr export to file
pg_field_num	pg_field_num
mysql_fetch_field	mysql fetch field
$field_index	field_index
$tx	float
$username	string
pdf_delete_pvf	pdf_delete_pvf
ingres_errno	ingres errno
$armor	$armor
pdf_initgraphics	pdf initgraphics
mysql_data_seek	mysql data seek
$what	$what
fdf_set_opt	fdf set opt
arg	arg
$value	$value
default	default
define	define
fbsql_set_lob_mode	fbsql set lob mode
$textflow	textflow
password_needs_rehash	password needs rehash
$link	string
ingres_next_error	ingres_next_error
getmessage	getmessage
msg_set_queue	msg set queue
imap_headerinfo	imap_headerinfo
$table_name	table_name
$connection	resource
$zend_extensions	$zend_extensions
ob_implicit_flush	ob implicit flush
$doc	long
imap_clearflag_full	imap clearflag full
$glyphname	string
mysql_field_table	mysql_field_table
is_finite	is_finite
$bson	$bson
error_get_last	error_get_last
$binary_string	string
$number	number
ingres_connect	ingres connect
setfont	setfont
type	type
$group	mixed
$wx	$wx
pdf_place_image	pdf_place_image
pdf_add_locallink	pdf add locallink
fbsql_database	fbsql_database
$ftp_stream	resource
jdtounix	jdtounix
$white	$white
$which	$which
dbname	dbname
pdf_setgray	pdf_setgray
write	write
fbsql_result	fbsql result
pdf_continue_text	pdf continue text
$plaintext	string
$cipher	int
get	get
filepro_fieldcount	filepro_fieldcount
gettraceasstring	gettraceasstring
$additional_parameters	$additional_parameters
openssl_public_encrypt	openssl_public_encrypt
mysql_thread_id	mysql thread id
mssql_free_result	mssql_free_result
ctype_digit	ctype digit
$zp	resource
check	check
curl_setopt	curl setopt
$pub_key_ids	$pub_key_ids
aborted	aborted
$dest_width	dest_width
mysql_fetch_array	mysql_fetch_array
tablename	tablename
xdigit	xdigit
$whichflags	whichflags
$ip_address	$ip_address
mysql_fetch_assoc	mysql_fetch_assoc
fribidi_log2vis	fribidi log2vis
read	read
ftp_close	ftp_close
$age	age
pdf_close_image	pdf_close_image
$outfilename	string
fbsql_num_rows	fbsql_num_rows
openssl_verify	openssl_verify
writable	writable
$d	float
setenv	setenv
msql_pconnect	msql_pconnect
pg_affected_rows	pg_affected_rows
extension_loaded	extension loaded
body	body
$row	$row
imap_8bit	imap 8bit
fbsql_select_db	fbsql_select_db
imap_append	imap append
opt	opt
pdf_create_fieldgroup	pdf create fieldgroup
pdf_end_document	pdf end document
$day	day
$decrypted	decrypted
$is_dst	int
array_slice	array slice
fdf_open	fdf_open
ldap_bind	ldap_bind
$table_name	string
$time	string
bindec	bindec
$c2	float
site	site
pdf_stringwidth	pdf stringwidth
message	message
ctype_punct	ctype punct
$ip_address	string
date_default_timezone_set	date_default_timezone_set
$method	string
$chunklen	chunklen
$pattern	pattern
fbsql_query	fbsql_query
$painttype	painttype
$jpegname	jpegname
$servername	string
$green	$green
$batch_size	batch_size
$result	$result
busy	busy
dio_write	dio write
javascript	javascript
openssl_pkey_export	openssl pkey export
$reserved	reserved
pdf_moveto	pdf moveto
ftp_exec	ftp exec
imap_thread	imap_thread
pdf_utf8_to_utf16	pdf utf8 to utf16
setacl	setacl
gnupg_setarmor	gnupg setarmor
ftp_delete	ftp delete
array_uintersect	array_uintersect
pdf_set_border_style	pdf set border style
ingres_result_seek	ingres_result_seek
double	double
msg_remove_queue	msg_remove_queue
mysql_unbuffered_query	mysql unbuffered query
pdf_create_textflow	pdf_create_textflow
pg_connection_reset	pg connection reset
$recipcerts	recipcerts
apache_get_modules	apache_get_modules
$flags	$flags
fbsql_database	fbsql database
bbcode_add_element	bbcode add element
pdf_setgray_stroke	pdf_setgray_stroke
$additional_headers	additional_headers
$errornum	errornum
$offset	offset
is_soap_fault	is_soap_fault
curl_copy_handle	curl copy handle
$bind_rdn	bind_rdn
jdtojulian	jdtojulian
$llx	$llx
ingres_field_precision	ingres_field_precision
dbase_add_record	dbase_add_record
getseverity	getseverity
$tx	$tx
imap_reopen	imap_reopen
ingres_field_scale	ingres field scale
ftp_mdtm	ftp mdtm
gregoriantojd	gregoriantojd
methods	methods
pg_fetch_all_columns	pg fetch all columns
ingres_charset	ingres charset
pdf_concat	pdf_concat
$depth	int
msql_num_fields	msql num fields
lcg_value	lcg value
boolean	boolean
call_user_func	call_user_func
dbase_get_record	dbase get record
$query_identifier	resource
$clear_realpath_cache	$clear_realpath_cache
imap_fetchbody	imap fetchbody
apache_request_headers	apache request headers
is_callable	is callable
nan	nan
$calendar	calendar
$operand	string
$len	len
apache_get_version	apache_get_version
fread	fread
eregi_replace	eregi_replace
circle	circle
$output_callback	$output_callback
$table	$table
$color	color
rand	rand
$tag_name	tag_name
$escape	escape
imap_ping	imap ping
$mailbox	$mailbox
$source_string	string
gzwrite	gzwrite
$upperrighty	$upperrighty
pdf_activate_item	pdf_activate_item
pdf_setlinewidth	pdf_setlinewidth
pg_fetch_row	pg_fetch_row
$parameter	$parameter
ingres_rollback	ingres_rollback
exif_read_data	exif read data
pvf	pvf
ctype_alpha	ctype_alpha
mssql_bind	mssql_bind
eval	eval
filepro_rowcount	filepro rowcount
openssl_pkcs12_export_to_file	openssl_pkcs12_export_to_file
dngettext	dngettext
readable	readable
msql_fetch_object	msql_fetch_object
$headers	headers
ftp_get_option	ftp_get_option
is_int	is int
$notext	$notext
$green	float
exception	exception
dio_open	dio open
db\bson\to	db\bson\to
$oldname	$oldname
$start_index	$start_index
getservbyport	getservbyport
curl_multi_info_read	curl multi info read
$newname	string
extract	extract
ftp_close	ftp close
errorexception	errorexception
$handler	string
$serial	int
ingres_close	ingres_close
ftp_mkdir	ftp_mkdir
item	item
explode	explode
$from	from
ibase	ibase
$mxhosts	$mxhosts
filepro_fieldwidth	filepro_fieldwidth
ingres	ingres
$types	$types
$opt	opt
$database_name	database_name
dbase_create	dbase create
mysql_num_rows	mysql num rows
$replace	$replace
pdf_end_pattern	pdf_end_pattern
$definition	mixed
$iv	string
$trigger	$trigger
file_put_contents	file put contents
pg_field_size	pg_field_size
$raw	$raw
lstat	lstat
$linecap	$linecap
$finfo	$finfo
$skip_results	skip_results
$error_code	int
mssql_num_rows	mssql_num_rows
openssl_private_encrypt	openssl private encrypt
maxdb	maxdb
setdash	setdash
jdmonthname	jdmonthname
fdf_get_file	fdf get file
char	char
handlers	handlers
query	query
$url	url
$algo	$algo
cfg	cfg
pdf_setmiterlimit	pdf_setmiterlimit
$width	$width
date_default_timezone_set	date default timezone set
$file	$file
$arrays	bool
build	build
$status	$status
$time	$time
$lowerleftx	float
pdf_set_parameter	pdf set parameter
pdf_get_errmsg	pdf_get_errmsg
setmiterlimit	setmiterlimit
meta	meta
dba_delete	dba_delete
$priv_key	priv_key
$connect_type	int
action	action
$rpath	string
imap_fetchheader	imap_fetchheader
$depth	depth
openssl_sign	openssl sign
subclass	subclass
$key_compare_func	$key_compare_func
class	class
curl_escape	curl escape
$which	which
$status	string
mssql_next_result	mssql_next_result
export	export
$value_compare_func	value_compare_func
cancel	cancel
pdf_encoding_set_char	pdf_encoding_set_char
$pos	$pos
mysql_fetch_array	mysql fetch array
is_file	is_file
pdf_circle	pdf_circle
pdf_close_pdi_page	pdf_close_pdi_page
$weight	$weight
more	more
pdf_findfont	pdf_findfont
$mime_encoded_text	string
$statement	resource
$outfilename	outfilename
addcslashes	addcslashes
$xstep	$xstep
pdf_makespotcolor	pdf makespotcolor
$category	category
ctype	ctype
mysql_select_db	mysql select db
$x1	float
fbsql_commit	fbsql_commit
$uid	int
reopen	reopen
flock	flock
$msgs_in_queue	msgs_in_queue
pdf_close	pdf close
dbx_escape_string	dbx escape string
bzerrno	bzerrno
all	all
pdf_stroke	pdf stroke
func_get_arg	func get arg
ibase_fetch_row	ibase fetch row
$modifier	modifier
$format	int
$subjectlength	subjectlength
mysql_escape_string	mysql_escape_string
closedict	closedict
ngettext	ngettext
$defaulthost	defaulthost
end	end
mime	mime
pdf_place_pdi_page	pdf place pdi page
$args	mixed
$crypted	crypted
bccomp	bccomp
$finfo	finfo
stringwidth	stringwidth
$source	string
is_dir	is dir
$hex_string	hex_string
$offset	int
array_unshift	array_unshift
atanh	atanh
$criteria	$criteria
fbsql_drop_db	fbsql_drop_db
$arg_num	$arg_num
array_udiff	array udiff
$lowerleftx	$lowerleftx
$address	address
msg_stat_queue	msg stat queue
array_diff_key	array diff key
exif_imagetype	exif imagetype
$msglist	string
pdf_set_gstate	pdf_set_gstate
msql_close	msql close
$proper_address	proper_address
$node	$node
$what	what
$painttype	int
pdf_place_pdi_page	pdf_place_pdi_page
com	com
mssql_field_type	mssql field type
$page	int
curl_multi_getcontent	curl multi getcontent
dbase_numrecords	dbase numrecords
$extra_headers	string
pdf_set_info	pdf set info
address	address
rowcount	rowcount
$file	file
msgno	msgno
mysql_field_len	mysql field len
localtime	localtime
$num	$num
odbc_fetch_into	odbc fetch into
array_diff	array diff
$quality	$quality
fdf	fdf
imap_reopen	imap reopen
gmmktime	gmmktime
$width	width
$privkey	resource
uudecode	uudecode
array_product	array product
$charlist	string
apache_lookup_uri	apache lookup uri
$signmode	signmode
$url	string
imap_fetch_overview	imap_fetch_overview
$autoload	bool
lcg_value	lcg_value
file	file
ftp_raw	ftp raw
$value	value
ftp_alloc	ftp_alloc
pdf_utf16_to_utf8	pdf utf16 to utf8
nextkey	nextkey
apache	apache
$open_data	open_data
openssl_csr_new	openssl csr new
$c3	c3
func_num_args	func num args
fbsql_pconnect	fbsql pconnect
pdf_translate	pdf_translate
ldap_bind	ldap bind
syslog	syslog
$handle	handle
imap_close	imap close
ibase_num_fields	ibase num fields
dba_close	dba close
metaphone	metaphone
$wbmpname	wbmpname
listscan	listscan
pg_free_result	pg free result
mysql_get_client_info	mysql_get_client_info
fclose	fclose
$result_identifier	result_identifier
mysql_pconnect	mysql_pconnect
$n_retries	int
ftp_fget	ftp fget
imap_status	imap_status
$array_or_countable	$array_or_countable
$destination	destination
fgetss	fgetss
split	split
ftp_login	ftp_login
pdf_end_pattern	pdf end pattern
openssl_x509_read	openssl_x509_read
curveto	curveto
$recipcerts	$recipcerts
$sx	float
$mode	$mode
$to	$to
$bz	resource
ip2long	ip2long
$shading	shading
imap_getacl	imap_getacl
$ident	$ident
pdf_curveto	pdf curveto
crc32	crc32
$user_agent	string
bbcode_create	bbcode create
bind	bind
$startpos	int
msql_num_rows	msql_num_rows
imap_expunge	imap expunge
ftp_exec	ftp_exec
$subjectlength	int
array_intersect	array_intersect
mt_srand	mt srand
max	max
file_exists	file exists
$pattern	$pattern
fdf_save	fdf_save
$length	$length
imap_utf7_encode	imap utf7 encode
$directory	string
restore	restore
$max_item_length	max_item_length
$sort_flags	sort_flags
slice	slice
$hex_string	$hex_string
dio_truncate	dio truncate
$field_offset	$field_offset
$module	module
array_combine	array_combine
$sx	$sx
$local_file	local_file
$oid_only	$oid_only
array	array
$persistent	int
fieldtype	fieldtype
imagetype	imagetype
$field_offset	int
row	row
in_array	in array
ingres_autocommit_state	ingres autocommit state
$output	$output
pdf_setrgbcolor	pdf_setrgbcolor
imap_list	imap_list
openssl_pkcs7_verify	openssl_pkcs7_verify
$directory	directory
ftruncate	ftruncate
$use_include_path	$use_include_path
cal	cal
dba_exists	dba exists
ingres_unbuffered_query	ingres unbuffered query
return	return
mysql_field_seek	mysql field seek
pdf_set_border_color	pdf_set_border_color
pdf_encoding_set_char	pdf encoding set char
mssql_fetch_object	mssql_fetch_object
$character_mask	character_mask
$get_scripts	$get_scripts
number_format	number format
get_included_files	get_included_files
$replace_by	replace_by
glyph	glyph
fdf_set_value	fdf set value
$charset	string
pkey	pkey
$haystack	haystack
mssql_fetch_array	mssql_fetch_array
mysql_get_client_info	mysql get client info
openssl_pkey_export	openssl_pkey_export
$command	string
$signature	string
curl_exec	curl_exec
$wbmpname	string
$enc_type	int
$stringparam	stringparam
cal_info	cal info
filter_var_array	filter_var_array
$object	$object
$direction	direction
gnupg_decrypt	gnupg decrypt
$remote_file	remote_file
pdf_closepath_fill_stroke	pdf closepath fill stroke
length	length
x509	x509
$target_frame	string
imap_base64	imap base64
pdf_set_border_color	pdf set border color
$intparam	$intparam
is_callable	is_callable
mysql_field_seek	mysql_field_seek
basename	basename
curl_multi_add_handle	curl multi add handle
escape	escape
mysql_free_result	mysql_free_result
fetchstructure	fetchstructure
$c4	c4
ftp_put	ftp_put
mssql_fetch_batch	mssql_fetch_batch
array_fill	array_fill
ftp_site	ftp_site
parse_url	parse_url
$null_as	$null_as
gnupg	gnupg
$options	array
opcache_reset	opcache reset
seterrormode	seterrormode
is_file	is file
pdf_set_info	pdf_set_info
username	username
$source	$source
$cy	int
$cainfo	cainfo
$hour	int
dba_nextkey	dba_nextkey
deg2rad	deg2rad
getallheaders	getallheaders
$signed_text	signed_text
$fingerprint	string
gnupg_export	gnupg export
$p	$p
func_num_args	func_num_args
hexdec	hexdec
$padding	$padding
$ordering	$ordering
apache_child_terminate	apache child terminate
$threshold	threshold
gnupg_verify	gnupg_verify
long2ip	long2ip
mysql_num_rows	mysql_num_rows
host	host
$intparam	int
$full_info	full_info
jdtojewish	jdtojewish
$dest_height	$dest_height
$pkcs12	pkcs12
product	product
$bson	string
mysql_get_proto_info	mysql get proto info
$arg_num	int
$sections	$sections
pdf_load_iccprofile	pdf load iccprofile
mysql_field_type	mysql_field_type
status	status
$zp	zp
extension	extension
stream	stream
pdf_open_pdi_page	pdf_open_pdi_page
$args	$args
$proj	string
$is_output	bool
abs	abs
ob_clean	ob_clean
pdf_fit_image	pdf fit image
jdtogregorian	jdtogregorian
pdf_open_pdi_document	pdf_open_pdi_document
$x	float
is_readable	is_readable
$var1	$var1
$protocol	protocol
fdf_set_javascript_action	fdf_set_javascript_action
$optlist	optlist
pg_free_result	pg_free_result
$search_criteria	$search_criteria
seek	seek
$source_string	$source_string
imap_deletemailbox	imap deletemailbox
$host	$host
table	table
$filesize	$filesize
pg_field_table	pg field table
bcscale	bcscale
$null_as	string
fdf_get_status	fdf_get_status
wstopsig	wstopsig
oci_error	oci_error
pdf_stroke	pdf_stroke
case	case
$port	port
version	version
mysql_get_proto_info	mysql_get_proto_info
acos	acos
$left_operand	string
pdf_create_action	pdf_create_action
bool	bool
$hebrew	bool
$options	int
dba_popen	dba popen
$llx	llx
array_intersect_key	array intersect key
$signature_alg	mixed
$shading	int
$column	int
openssl_csr_export	openssl csr export
$thumbnail	$thumbnail
unsubscribe	unsubscribe
fbsql_num_rows	fbsql num rows
$fontname	fontname
mysql_list_tables	mysql_list_tables
bindtextdomain	bindtextdomain
files	files
$result_identifier	object
$service	service
$utf8string	string
dba_handlers	dba_handlers
$keyword	string
$time	time
$fl	$fl
$types	string
$item	$item
pdf_suspend_page	pdf suspend page
$doc	$doc
mssql_fetch_assoc	mssql_fetch_assoc
pg_fetch_all	pg fetch all
imap_bodystruct	imap bodystruct
openssl_pkcs7_encrypt	openssl pkcs7 encrypt
$out	string
mysql_list_fields	mysql_list_fields
curl_errno	curl_errno
curl_multi_strerror	curl_multi_strerror
$reverse	$reverse
$dest_height	int
fieldgroup	fieldgroup
$image	image
$use_include_path	use_include_path
pdf_lineto	pdf lineto
$maxlength	int
pg_execute	pg execute
$password	string
$value1	$value1
imap_errors	imap errors
$number	mixed
batch	batch
fbsql_table_name	fbsql_table_name
dns_get_record	dns_get_record
pdf_setmiterlimit	pdf setmiterlimit
msql_fetch_row	msql fetch row
ingres_query	ingres query
ingres_error	ingres error
variables	variables
$blackls1	blackls1
imap_createmailbox	imap createmailbox
$page_number	int
$k	k
pdf_get_buffer	pdf_get_buffer
gettimeofday	gettimeofday
pdf_get_minorversion	pdf_get_minorversion
$link	resource
$arg_num	arg_num
__halt_compiler	  halt compiler
$jd	$jd
curl_multi_info_read	curl_multi_info_read
$strict	$strict
$tag_rules	tag_rules
mhash	mhash
ldap_modify	ldap modify
$chunk_size	chunk_size
ftp_chmod	ftp_chmod
pdf_get_pdi_value	pdf get pdi value
localeconv	localeconv
$height	height
pg_escape_bytea	pg escape bytea
$slot	int
$bz	$bz
$start	$start
$linecap	int
pcntl_wtermsig	pcntl wtermsig
$script_name	string
filepro_fieldtype	filepro fieldtype
filter_var_array	filter var array
easter_date	easter_date
pg_insert	pg_insert
$blocksize	int
pdf_setdash	pdf setdash
undelete	undelete
$str2	string
pdf_set_parameter	pdf_set_parameter
curl_multi_remove_handle	curl_multi_remove_handle
parse_str	parse_str
imap_getmailboxes	imap getmailboxes
$blackls1	int
$timestamp	$timestamp
$dbase_identifier	dbase_identifier
final	final
get_cfg_var	get cfg var
imap_msgno	imap_msgno
$k	$k
$perms	$perms
file_get_contents	file get contents
$script	$script
array_count_values	array count values
$delimiter	delimiter
$ncolors	ncolors
pdf_setfont	pdf setfont
line	line
minorversion	minorversion
$days	days
dbase_close	dbase close
imap_fetchbody	imap_fetchbody
openssl_error_string	openssl_error_string
$font	font
dechex	dechex
mysql_thread_id	mysql_thread_id
$imap_stream	imap_stream
$output_callback	output_callback
$white	white
msql_field_seek	msql field seek
eventbufferevent	eventbufferevent
$upperrightx	float
mssql_guid_string	mssql_guid_string
dns	dns
getlastmessage	getlastmessage
$lly	$lly
record	record
getprotobyname	getprotobyname
frenchtojd	frenchtojd
array_splice	array_splice
msql_db_query	msql db query
$suffix	suffix
size	size
pkcs12	pkcs12
$style	string
json_encode	json encode
$varname	varname
pdf_get_value	pdf get value
$embed	int
dio_truncate	dio_truncate
filter	filter
$...	array
$befehl	string
dbx_sort	dbx sort
pdf_close_pdi	pdf close pdi
openssl_pkey_get_details	openssl_pkey_get_details
pdf_rect	pdf rect
pdf_setcolor	pdf setcolor
dba_firstkey	dba_firstkey
mssql_field_name	mssql_field_name
imap_headers	imap_headers
$ascii	ascii
jdtofrench	jdtofrench
$red	red
id	id
crack_opendict	crack opendict
$raw	bool
pdf_translate	pdf translate
$name	$name
$new_mbox	$new_mbox
$default_host	default_host
$untrustedfile	$untrustedfile
getdate	getdate
$suffix	string
merge	merge
$onoff	onoff
pg_escape_literal	pg_escape_literal
error_log	error_log
$pagenumber	pagenumber
$key	mixed
$fstype	fstype
$recursive	recursive
value	value
getfile	getfile
$recipkey	recipkey
$year	int
imap_rfc822_parse_adrlist	imap rfc822 parse adrlist
dio_close	dio close
pdf_define_layer	pdf_define_layer
$callable_name	callable_name
get_extension_funcs	get extension funcs
$zend_extensions	bool
array_product	array_product
$ystep	ystep
$n_retries	$n_retries
$profilename	profilename
dio_seek	dio_seek
pdf_load_3ddata	pdf_load_3ddata
$interface_name	interface_name
$out_charset	string
num	num
$extra_headers	$extra_headers
mysql_result	mysql_result
$priv_key_id	$priv_key_id
functions	functions
fbsql_username	fbsql_username
$hebrew_text	hebrew_text
$connect_type	$connect_type
$cx	int
ingres_set_environment	ingres set environment
parameter	parameter
chunk_split	chunk_split
ingres_num_rows	ingres_num_rows
pdf_info_textflow	pdf_info_textflow
$fdf_document	fdf_document
gzuncompress	gzuncompress
mysql_set_charset	mysql set charset
dbase_open	dbase_open
$level	level
$facility	facility
var	var
pdf_begin_layer	pdf_begin_layer
$pdfdoc	pdfdoc
$sealed_data	sealed_data
$short_format	$short_format
$varname	string
$pub_key_ids	array
alerts	alerts
mssql_pconnect	mssql_pconnect
$args	array
$bbcode_initial_tags	bbcode_initial_tags
pg_host	pg host
oci_fetch	oci_fetch
$replacement	$replacement
oci_fetch_assoc	oci fetch assoc
imap_lsub	imap_lsub
$extracerts	$extracerts
pdf_shading_pattern	pdf_shading_pattern
empty	empty
pg_fetch_result	pg_fetch_result
is_string	is_string
imap_setacl	imap_setacl
ingres_field_name	ingres field name
fbsql	fbsql
$keydata	$keydata
call	call
ftp_rawlist	ftp_rawlist
template	template
$operation	operation
mysql_client_encoding	mysql_client_encoding
asinh	asinh
$befehl	$befehl
$y2	$y2
gnupg_sign	gnupg_sign
oci_fetch_array	oci_fetch_array
$spotname	spotname
oci_bind_by_name	oci bind by name
openssl_pkey_export_to_file	openssl_pkey_export_to_file
$msg_number	int
fbsql_pconnect	fbsql_pconnect
mysql_num_fields	mysql num fields
$headers	$headers
parse_ini_file	parse ini file
$fd	resource
func	func
array_udiff_uassoc	array udiff uassoc
$p	p
$values	$values
array_uintersect_uassoc	array_uintersect_uassoc
pdf_fit_image	pdf_fit_image
mktime	mktime
implode	implode
pdf_setlinewidth	pdf setlinewidth
opendict	opendict
decbin	decbin
$bbcode_container	$bbcode_container
iccprofile	iccprofile
crack_getlastmessage	crack_getlastmessage
disk_total_space	disk_total_space
$var_array	$var_array
ap	ap
concat	concat
mhash_count	mhash count
pdf_setflat	pdf_setflat
apache_note	apache_note
$body	string
$jd	jd
fdf_get_version	fdf get version
pdf_setgray	pdf setgray
pdf_closepath	pdf_closepath
options	options
$blue	blue
$to	string
openssl_x509_check_private_key	openssl_x509_check_private_key
imap_last_error	imap_last_error
openssl_private_decrypt	openssl private decrypt
$pri	pri
$handle	resource
$hour	hour
multisort	multisort
cal_to_jd	cal_to_jd
dcgettext	dcgettext
$note_name	note_name
$max_table_length	$max_table_length
$raw_output	bool
funcs	funcs
pdf_suspend_page	pdf_suspend_page
$xstep	float
pdf_end_page_ext	pdf_end_page_ext
textflow	textflow
json_last_error	json last error
openssl	openssl
$ph_name	ph_name
$alpha	$alpha
msql_fetch_object	msql fetch object
pdf_load_font	pdf load font
inclued_get_data	inclued get data
chunk_split	chunk split
openssl_pkey_free	openssl pkey free
$layer	int
$recipcert	recipcert
is_link	is link
gzopen	gzopen
$persistent	persistent
msg_get_queue	msg_get_queue
numfields	numfields
pdf_initgraphics	pdf_initgraphics
shift	shift
$privkey	$privkey
$persistent	$persistent
fbsql_start_db	fbsql start db
pg_connection_status	pg connection status
executable	executable
$id	string
ftp	ftp
mssql_fetch_batch	mssql fetch batch
json	json
pdf_add_launchlink	pdf_add_launchlink
popen	popen
$x509	x509
$additional_headers	string
ingres_commit	ingres_commit
array_fill_keys	array fill keys
$authns	authns
$width	int
mssql_next_result	mssql next result
imap_expunge	imap_expunge
$local_file	string
gnupg_encrypt	gnupg_encrypt
ibase_num_fields	ibase_num_fields
listvar	listvar
$json	$json
mysql_fetch_object	mysql_fetch_object
graph	graph
ftp_put	ftp put
$class_name	string
dio_read	dio read
$fetch_flag	$fetch_flag
msql_select_db	msql_select_db
uid	uid
imap_utf7_decode	imap utf7 decode
$str2	str2
server	server
ctype_alnum	ctype alnum
$object	object
pg_get_result	pg get result
imap	imap
$n_retries	n_retries
$old_mbox	$old_mbox
pdf_get_value	pdf_get_value
ingres_fetch_row	ingres_fetch_row
fbsql_stop_db	fbsql stop db
ingres_fetch_array	ingres_fetch_array
$x3	$x3
fdf_errno	fdf_errno
$y1	$y1
openssl_private_encrypt	openssl_private_encrypt
fbsql_affected_rows	fbsql_affected_rows
chown	chown
ctype_xdigit	ctype xdigit
array_diff_ukey	array_diff_ukey
$dither	dither
$errno	errno
infinite	infinite
$connection_id	connection_id
$filters	$filters
error_reporting	error reporting
$extraattribs	array
fbsql_stop_db	fbsql_stop_db
openssl_open	openssl open
free	free
$record_number	$record_number
$remote_file	string
$query	resource
key	key
$assoc	bool
get_meta_tags	get_meta_tags
ftp_systype	ftp systype
datetime	datetime
mysql_stat	mysql stat
iconv	iconv
$variable	mixed
mssql_field_type	mssql_field_type
fbsql_db_query	fbsql_db_query
ctype_lower	ctype lower
pdf_load_font	pdf_load_font
$level	int
previous	previous
$str	$str
bcmul	bcmul
$result_id	resource
$field_index	$field_index
mysql_affected_rows	mysql affected rows
$destination	string
mysql_pconnect	mysql pconnect
mysql_real_escape_string	mysql real escape string
$arr	$arr
mysql_fetch_field	mysql_fetch_field
imap_clearflag_full	imap_clearflag_full
$value	int
soap	soap
$shortnames	bool
$i	i
flush	flush
min	min
msql_create_db	msql create db
imap_sort	imap sort
$username	$username
pdf_end_page_ext	pdf end page ext
$phi	float
fopen	fopen
$cacert	$cacert
$script	string
pdf_lineto	pdf_lineto
$isname	isname
pdf_set_gstate	pdf set gstate
$host_name	string
openssl_pkey_new	openssl pkey new
get_resource_type	get_resource_type
is_array	is array
disk_free_space	disk free space
skew	skew
cos	cos
$atomic	bool
interface_exists	interface_exists
json_decode	json decode
imap_rfc822_write_address	imap_rfc822_write_address
html_entity_decode	html entity decode
log2vis	log2vis
search	search
imap_renamemailbox	imap renamemailbox
$y3	y3
ltrim	ltrim
array_sum	array sum
pdf_setfont	pdf_setfont
pdf_begin_template_ext	pdf begin template ext
$fieldname	$fieldname
dbase_pack	dbase_pack
$x509cert	x509cert
offsetget	offsetget
$passphrase	passphrase
$output_callback	callable
$right_operand	string
openssl_error_string	openssl error string
array_udiff_uassoc	array_udiff_uassoc
imap_msgno	imap msgno
fgetc	fgetc
msql_list_fields	msql_list_fields
pdf_begin_item	pdf begin item
fieldwidth	fieldwidth
mssql_fetch_row	mssql_fetch_row
number_format	number_format
$maxlength	maxlength
openssl_csr_export_to_file	openssl_csr_export_to_file
ftp_nb_put	ftp_nb_put
$plaintext	plaintext
$sections	sections
$doc	doc
$uid	$uid
pdf_show	pdf_show
values	values
pdf_set_layer_dependency	pdf set layer dependency
$criteria	string
openssl_pkcs7_decrypt	openssl pkcs7 decrypt
debug_print_backtrace	debug_print_backtrace
$is_associative	bool
openssl_public_decrypt	openssl public decrypt
continue	continue
pdf_closepath_fill_stroke	pdf_closepath_fill_stroke
$signcert	mixed
$env_keys	$env_keys
mssql_execute	mssql execute
$dictionary	string
linkinfo	linkinfo
msql	msql
ctype_upper	ctype upper
apache_get_modules	apache get modules
included	included
style	style
$skip	skip
pdf_fill_pdfblock	pdf_fill_pdfblock
$outfile	outfile
dbase_create	dbase_create
$is_output	is_output
is_object	is_object
csr	csr
ftp_mdtm	ftp_mdtm
note	note
get_headers	get headers
$link_identifier	link_identifier
pdf_add_thumbnail	pdf_add_thumbnail
msql_error	msql error
sent	sent
pdf_set_text_pos	pdf set text pos
mysql_close	mysql close
fdf_set_status	fdf_set_status
vars	vars
$x3	float
pdf_setlinejoin	pdf setlinejoin
ob_get_contents	ob get contents
oid	oid
ingres_num_fields	ingres num fields
mongodb\bson\tophp	mongodb\bson\tophp
$seed	seed
$beta	$beta
pdf_close_pdi	pdf_close_pdi
$field_offset	field_offset
typelib	typelib
ukey	ukey
$y2	float
rewind	rewind
fbsql_field_name	fbsql field name
keys	keys
$style	style
array_search	array_search
$section	$section
array_flip	array flip
$c1	float
$user_compare_function	user_compare_function
autocommit	autocommit
imagetruecolortopalette	imagetruecolortopalette
$row_number	$row_number
$out_charset	out_charset
$array2	$array2
$assoc	assoc
oci_bind_array_by_name	oci bind array by name
$haystack	$haystack
$max_chars_per_line	max_chars_per_line
array_push	array_push
$operation	int
$script	script
$fdf_document	resource
fdf_create	fdf create
$decrypted	$decrypted
code	code
pdf_add_table_cell	pdf_add_table_cell
pg	pg
imap_rfc822_parse_adrlist	imap_rfc822_parse_adrlist
$certs	array
dom_import_simplexml	dom_import_simplexml
$f	f
chmod	chmod
pdf_arc	pdf arc
$domain	string
utf16	utf16
$values	values
ob_get_level	ob get level
oauth_urlencode	oauth urlencode
$pagenumber	int
pdf_delete_table	pdf_delete_table
curl_error	curl error
level	level
$msgid1	string
imap_setflag_full	imap setflag full
$mode	string
pdf_pcos_get_number	pdf pcos get number
$c	c
$row_a	$row_a
mcrypt_cbc	mcrypt_cbc
dgettext	dgettext
$search_criteria	string
array_udiff_assoc	array udiff assoc
setarmor	setarmor
$message_type	message_type
$proj	proj
pg_fetch_assoc	pg fetch assoc
$array1_sort_flags	array1_sort_flags
pg_field_type_oid	pg_field_type_oid
$local_file	$local_file
$bitreverse	int
mssql_data_seek	mssql data seek
$result_array	$result_array
$max_table_length	int
pg_get_pid	pg_get_pid
raw	raw
dba_open	dba open
pdf_add_weblink	pdf add weblink
$dn	dn
imap_delete	imap delete
bcpow	bcpow
$mode	mode
base	base
modules	modules
$n	$n
krsort	krsort
msql_result	msql_result
getsubscribed	getsubscribed
pdf_clip	pdf_clip
__clone	  clone
get_meta_tags	get meta tags
$i	$i
oauth	oauth
$limit	limit
$hostname	string
ctype_graph	ctype_graph
pg_field_name	pg field name
pg_field_type_oid	pg field type oid
$ph_name	$ph_name
checkpurpose	checkpurpose
$x2	x2
$walk_to_top	walk_to_top
imap_lsub	imap lsub
$is_null	is_null
$types	types
pg_connection_status	pg_connection_status
crack_check	crack check
$fd2	mixed
ob_end_clean	ob_end_clean
$note_value	string
dbase_delete_record	dbase_delete_record
dio_open	dio_open
msql_connect	msql connect
$certificate	certificate
openssl_public_encrypt	openssl public encrypt
$modulus	modulus
iconv_get_encoding	iconv get encoding
clip	clip
hostname	hostname
loop	loop
hebrevc	hebrevc
$arg_separator	arg_separator
lcfirst	lcfirst
ftp_raw	ftp_raw
is_uploaded_file	is_uploaded_file
pdf_shading_pattern	pdf shading pattern
mssql	mssql
msql_field_flags	msql field flags
$row_b	row_b
dirname	dirname
$result_type	result_type
__clone	__clone
$x509	$x509
glob	glob
mysql_errno	mysql_errno
$contents	contents
$y3	$y3
$chunklen	int
$base	int
$x509	mixed
array_multisort	array_multisort
imap_listscan	imap_listscan
real	real
user	user
$errornum	$errornum
array_replace	array replace
fbsql_error	fbsql_error
is_executable	is executable
$pos	int
$tobase	int
connect	connect
mssql_free_statement	mssql_free_statement
$end	end
$double_encode	bool
$callable_name	$callable_name
$skip	int
pdf_begin_item	pdf_begin_item
imap_rfc822_parse_headers	imap_rfc822_parse_headers
$tag_name	$tag_name
method	method
curl_errno	curl errno
pdf_closepath_stroke	pdf closepath stroke
$resumepos	resumepos
$second	$second
pdf_info_matchbox	pdf info matchbox
$c2	$c2
openssl_free_key	openssl free key
$x1	x1
pdf_delete	pdf_delete
$proj	$proj
gzcompress	gzcompress
msql_connect	msql_connect
rect	rect
function	function
dbase_get_header_info	dbase_get_header_info
$tablename	tablename
mysql_connect	mysql connect
pdf_arcn	pdf arcn
$which	int
open	open
layer	layer
rollback	rollback
pcntl_wstopsig	pcntl_wstopsig
imap_uid	imap uid
inet_pton	inet_pton
$case	int
ob_iconv_handler	ob_iconv_handler
array_push	array push
imap_fetchstructure	imap fetchstructure
pdf_create_gstate	pdf create gstate
$miter	$miter
$num	int
array_map	array_map
$pagenumber	$pagenumber
$page_number	$page_number
msql_list_dbs	msql list dbs
$x	$x
exif	exif
pdf_endpath	pdf_endpath
gnupg_encrypt	gnupg encrypt
pdf_setlinejoin	pdf_setlinejoin
pdf_arcn	pdf_arcn
chunk	chunk
$connection	connection
$fields	$fields
mysql_list_tables	mysql list tables
curl_init	curl_init
$keys	$keys
$infilename	string
$suffix	$suffix
$extra_headers	extra_headers
maxdb_more_results	maxdb more results
ob_end_flush	ob_end_flush
$hex_string	string
$domain	$domain
$part_number	$part_number
imagegif	imagegif
$user_agent	$user_agent
$blackls1	$blackls1
$full_info	$full_info
$x3	x3
font	font
pdf_set_text_pos	pdf_set_text_pos
$get_as_float	bool
openssl_pkcs12_read	openssl pkcs12 read
init	init
$entry	$entry
imap_errors	imap_errors
pg_close	pg close
fget	fget
$minute	$minute
apache_lookup_uri	apache_lookup_uri
$context	$context
$preserve_keys	bool
strerror	strerror
setopt	setopt
pg_field_prtlen	pg field prtlen
array_reverse	array reverse
$ch	$ch
mssql_get_last_message	mssql_get_last_message
crack_closedict	crack closedict
eio_dup2	eio_dup2
pdf_pcos_get_number	pdf_pcos_get_number
get_browser	get_browser
$ip_address	ip_address
$additional_parameters	string
$mime_encoded_text	mime_encoded_text
db	db
cal_days_in_month	cal_days_in_month
com_load_typelib	com load typelib
oci_fetch	oci fetch
len	len
$priv_key_id	priv_key_id
mssql_num_fields	mssql num fields
array_merge_recursive	array merge recursive
inclued	inclued
jddayofweek	jddayofweek
fbsql_free_result	fbsql free result
$old_mbox	old_mbox
log	log
$wx	wx
$ch	resource
ingres_cursor	ingres_cursor
gettext	gettext
ignore	ignore
$errno	$errno
ingres_prepare	ingres_prepare
$array1	$array1
$cipherid	cipherid
cbc	cbc
$timezone_identifier	timezone_identifier
shfill	shfill
$filters	int
as	as
$to_parse	to_parse
gzdeflate	gzdeflate
$result_array	result_array
pdf_begin_template	pdf_begin_template
$return	bool
$protocol	string
pdf_fill_imageblock	pdf fill imageblock
$addtl	$addtl
natcasesort	natcasesort
dba_nextkey	dba nextkey
fbsql_field_seek	fbsql_field_seek
$return_float	return_float
dbx_sort	dbx_sort
mssql_min_message_severity	mssql_min_message_severity
imagearc	imagearc
ftp_get_option	ftp get option
directory	directory
mssql_rows_affected	mssql rows affected
$hebrew_text	$hebrew_text
$userdata	userdata
$k	int
$param_name	string
pdf_create_bookmark	pdf create bookmark
bin2hex	bin2hex
fit	fit
dbase_get_record	dbase_get_record
getmailboxes	getmailboxes
openssl_pkcs7_sign	openssl pkcs7 sign
pdf_open_image_file	pdf open image file
$ordering	string
connection_status	connection_status
openssl_pkey_get_details	openssl pkey get details
msql_create_db	msql_create_db
$return_var	$return_var
function_exists	function exists
pg_delete	pg_delete
$key	key
$x	x
get_declared_classes	get_declared_classes
imap_check	imap check
$client_flags	$client_flags
pg_dbname	pg_dbname
mysql_insert_id	mysql_insert_id
pdf_end_item	pdf end item
maxdb_more_results	maxdb_more_results
$component	component
$row_a	row_a
$part_number	part_number
$from	string
mt_srand	mt_srand
fbsql_autocommit	fbsql autocommit
jewishtojd	jewishtojd
fbsql_hostname	fbsql hostname
ob_iconv_handler	ob iconv handler
$dictionary	$dictionary
$calendar	$calendar
$...	mixed
ingres_fetch_row	ingres fetch row
$record	record
offset	offset
element	element
$octal_string	string
dba	dba
ldap_connect	ldap_connect
apache_request_headers	apache_request_headers
pdf_rect	pdf_rect
$bz	bz
$errstr	string
$value	mixed
from	from
$workfactor	$workfactor
$cc	cc
flags	flags
$msglist	$msglist
get_defined_vars	get defined vars
$x509cert	$x509cert
$enc_type	enc_type
imap_alerts	imap alerts
fdf_set_file	fdf set file
$target	string
ingres_fetch_object	ingres fetch object
$bind_arg	$bind_arg
matchbox	matchbox
ibase_fetch_row	ibase_fetch_row
array_replace	array_replace
$user_agent	user_agent
curl_multi_exec	curl_multi_exec
ob_start	ob start
$weight	array
$fontname	string
pdf_set_value	pdf_set_value
textblock	textblock
literal	literal
$lowerlefty	$lowerlefty
oci_free_statement	oci free statement
$passphrase	$passphrase
delete	delete
halt	halt
$subject	$subject
$result	result
$pdfdoc	$pdfdoc
ftp_size	ftp_size
$to_parse	string
fbsql_password	fbsql_password
ldap_connect	ldap connect
__set_state	__set_state
$d	$d
$position	int
$chunk_size	$chunk_size
convert_cyr_string	convert_cyr_string
$column_key	column_key
$uv	$uv
suspend	suspend
$privkey	mixed
$opt	$opt
password_verify	password_verify
remove	remove
array_flip	array_flip
ingres_field_precision	ingres field precision
dbase_numrecords	dbase_numrecords
$new_mbox	string
array_slice	array_slice
8bit	8bit
mysql_error	mysql_error
$whence	$whence
encryptsign	encryptsign
$field_name	field_name
$host_name	$host_name
mssql_pconnect	mssql pconnect
$database	string
$method	method
is_float	is_float
needs	needs
lob	lob
$jday	$jday
exif_thumbnail	exif_thumbnail
get_resource_type	get resource type
$file	mixed
mysql_get_host_info	mysql_get_host_info
import	import
filepro_fieldtype	filepro_fieldtype
$contents	int
$result	object
mysql_fetch_assoc	mysql fetch assoc
msql_free_result	msql free result
with	with
$pub_key_id	mixed
proto	proto
$lowerlefty	lowerlefty
pdf_create_3dview	pdf create 3dview
$perms	perms
extension_loaded	extension_loaded
$query	string
pg_field_type	pg_field_type
array_unshift	array unshift
fbsql_data_seek	fbsql data seek
imap_8bit	imap_8bit
$bcc	bcc
$is_dst	$is_dst
eio_grp	eio grp
$dither	$dither
unset	unset
$result_id	$result_id
ping	ping
cosh	cosh
imap_mail_copy	imap mail copy
imap_num_recent	imap num recent
$padding	int
$doc	int
contents	contents
expunge	expunge
fbsql_error	fbsql error
$section	section
mysql_select_db	mysql_select_db
bytea	bytea
$dest_width	$dest_width
mysql_client_encoding	mysql client encoding
$signmode	int
mysql_create_db	mysql_create_db
$fl	int
oci_fetch_row	oci_fetch_row
array_rand	array_rand
filetype	filetype
pdf_get_errnum	pdf_get_errnum
$dither	bool
chgrp	chgrp
$sx	sx
mssql_field_name	mssql field name
imap_utf7_encode	imap_utf7_encode
$field_number	$field_number
long	long
$c2	c2
handler	handler
ingres_autocommit	ingres autocommit
$newflags	newflags
handle	handle
isset	isset
mode	mode
$signature	signature
pg_copy_from	pg_copy_from
$text	$text
$x509certdata	$x509certdata
imap_createmailbox	imap_createmailbox
setlinejoin	setlinejoin
compact	compact
http_build_query	http build query
openssl_csr_sign	openssl_csr_sign
$connect_type	connect_type
ldap_modify	ldap_modify
pdf_fill_stroke	pdf_fill_stroke
$mxhosts	mxhosts
sync	sync
names	names
$ty	ty
pg_get_notify	pg_get_notify
fbsql_field_name	fbsql_field_name
$database_options	database_options
gstate	gstate
xy	xy
openssl_sign	openssl_sign
msql_field_len	msql_field_len
dns_get_record	dns get record
imap_search	imap search
lineto	lineto
com_load_typelib	com_load_typelib
$modifier	$modifier
numeric	numeric
execute	execute
addslashes	addslashes
$result_array	array
$extracerts	string
$option	$option
fflush	fflush
pdf_findfont	pdf findfont
$prefix	string
curl_exec	curl exec
$open_data	string
mysql_drop_db	mysql_drop_db
gzseek	gzseek
$quality	int
dbs	dbs
$code	string
$module	$module
$envelope	array
openssl_pkey_get_private	openssl_pkey_get_private
fbsql_field_table	fbsql_field_table
$msgid1	$msgid1
fbsql_fetch_row	fbsql fetch row
bbcode_add_element	bbcode_add_element
unshift	unshift
ctype_upper	ctype_upper
$internal_date	internal_date
$format	format
getlastmod	getlastmod
$initial	$initial
$r	r
cursor	cursor
$threshold	$threshold
pdf_utf16_to_utf8	pdf_utf16_to_utf8
pdf_begin_document	pdf begin document
$in_charset	in_charset
$recipcert	$recipcert
by	by
$client_flags	int
fbsql_autocommit	fbsql_autocommit
uintersect	uintersect
$unescaped_string	$unescaped_string
imap_setacl	imap setacl
$host	string
headers_sent	headers sent
$image	int
ingres_field_type	ingres field type
sort	sort
pdf_circle	pdf circle
pdf_new	pdf_new
$result	resource
ingres_field_nullable	ingres_field_nullable
$text	text
$limit	int
$addtl	addtl
$cx	$cx
msql_field_table	msql field table
$year	year
$server	string
func_get_arg	func_get_arg
lsub	lsub
$typemap	typemap
connection	connection
checkdnsrr	checkdnsrr
$a	$a
acosh	acosh
buffer	buffer
$unescaped_string	unescaped_string
$cipher	cipher
msql_drop_db	msql_drop_db
mysql_insert_id	mysql insert id
pg_dbname	pg dbname
$tx	tx
natsort	natsort
$b	$b
$f	float
fbsql_select_db	fbsql select db
$remote_file	$remote_file
$length	length
punct	punct
$image	resource
$csr	resource
closelog	closelog
$stmtname	string
$jday	jday
ingres_fetch_array	ingres fetch array
dbx_fetch_row	dbx_fetch_row
$escape	string
$variable	$variable
$pasv	pasv
$url	$url
$params	array
$operand	operand
$in_charset	$in_charset
pdf_stringwidth	pdf_stringwidth
password	password
$input	$input
$field_number	int
$str1	$str1
pdf_setrgbcolor	pdf setrgbcolor
pdf_restore	pdf_restore
$quota_root	quota_root
$direction	string
$limit	$limit
imap_get_quota	imap get quota
$charset	int
imap_undelete	imap undelete
$len	$len
fdf_set_value	fdf_set_value
