selection	group-like selection & object aggregation implementing carries tables mixin interface table operation
iterator	iterator "__next__()" provide manage iteration obtain subclass interface table define method unpacking
visitor	engines ast subclass custom parsers walker class
datetime	unified attribute inteface datetime boxed index properties tz timestamp implementation support subclass custom accessor holding dtype np int64 duck-typed metaclass immutable ability ops series resample object provides datetimetzdtype objects mixin datetime64 represented internally data class ndarray determines type datetimelike values common implement suitable subclasses groupby block
unary	unary operator hold parameters operands
scalar	compat scalars quickly access scalar block
fy5253quarter	week fiscal dates 4-4-5 increments business year also 52-53 known calendar quarter dateoffset
group	plot aggregate implementing provide attribute object class facilities see objects mixed relational aggregating data groupby grouping
cssto	styles declarations callable 2 parts excelwriter converting supports css
field	fields dataframes converts specialization fixed-width
mmap	read mmap wrapper properly csv python's class
writer	files binary use sheets parameters xlwt default dta xlsx excel dataframe writing objects stata xls class openpyxl
window	rolling calculcations window provides
dict	provide access nested dict attribute-style
text	dialect overrides parser related passed options
holiday	federal dates start/end observance government rules certain abstract us holidays following create https specified interface based calendar holiday class //www defines
easter	dateutil defined logic using holiday easter dateoffset
appender	function target docstring decorator addendum append
bin	operator binary hold operands
styler	style series according dataframe html helps data css
non	hold blocks methods nonconsolidatable
string	implements index functions unless string vectorized object method long stay nas add str mixin series na defines acessor class __unicode__ methods
ops	unified periodindex ops series docs support / datetimeindex/periodindex index common mixin inteface datetimelike timedeltaindex/datetimeindex timedeltaindex
python	python evaluate expression space
rngcontext	set generator speed random number manager context returns numpy
appendable	support multi-index suppor formats new appendable table frame
month	tuesday month end parameters monthly two per custom describes month" week business **experimental** dateoffset's last one beginning day dates "the increments like day_of_month eom 2nd repeating dateoffset first
day	excluding business **experimental** days subclass n possibly holidays representing dateoffset
mapper	map group tuple ease suffering compressed key -> id
term	term condition/filter use construct value hold
hour	business days subclass n possibly custom representing dateoffset
semi	last two per month day_of_month dateoffset's repeating day first
locator	controlled locates series ticks :class along axis
cssresolver	resolving parsing callable atomic properties css
utf8recoder	iterator stream reencodes reads utf-8 input encoded
list	doesn't used container it's *but* item setting allow accumulating sparsearray converted data non-hashable structure technically
manager	core series manage dataframe etc single internal block implement data structure panel
merge	database perform two dataframe merge objects sql operation
delegate	methods/properties abstract base delegating class
sparse	sparseseries containing sparsearray form parameters point arrays dtype list dataframe 1-d labeled converted objects sparse accumulating implement data floating structure
div	operator case div casting special
quarter	doesn't dates increments like business 1/31/2007 = startingmonth - corresponds 1 4/30/2007 call representation quarter super dateoffset
grouping	information parameters holds single key grouping
calendar	holiday based government rules certain abstract us holidays following https specified interface calendar federal create //www
methods	index functions unless string vectorized dataframe stay nas accessor examples series na method plotting
contextmanager	manager behind context assert_raises_regex
series	ticks point series labels including examples table floating along axis parameters support one-dimensional :class ndarray new timedeltaindex plotting controlled time periodindex appendable data accessor structure locates method labeled sparse formats
frame	two-dimensional render point frame parser dataframe tabular legacy examples table floating hood containing rows form support axes dataframes beautifulsoup accessor html potentially suppor new plotting columns size-mutable multi-index lxml objects uses base appendable data class structure parse parsers method labeled sparseseries sparse formats heterogeneous self
unserializable	serialized raised warning cannot dataframe
numeric	provide operations type numeric
num	engine numexpr class
datelike	datetimeindex/periodindex timedeltaindex common ops
year	begin needs increments dates ends month year calendar dateoffset
tzblock	attribute implement tz block datetime64
plotter	dataframes explanation layout vertical/horizontal
html5lib	parser beautifulsoup dataframe html uses hood
index	operations unified raised set ordered series datetime64 numeric datetime basic rangeindex examples categoricalindex holding table time description index sliceable datetimelike timestamp etc perform create support slice / get error attempting lexsorted provides resample values hierarchical type immutable indicating ordinal multi-level particular provide boxed timedelta ops docs object monotonic slicing implementing objects mixin inteface represented years data class ndarray easily internally parameters column months multiindex intervalindex pandas implementation range regular int64 common multi-index quarters timedelta64 subclasses groupby periods
slice	easily perform create object slicing examples multi-index
eng	format float according engineering values formats
missing	observation's value missing
label	prepare categorical column formatted parse output
access	access scalars quickly
stata	files binary parameters prepare categorical column dta missing formatted value writing parse stata observation's output class
reader	dialect overrides parser lines related passed reader options fixed-width
new	prevents attributes new mixin adding
formatter	render float dataframe engineering tabular/longtable axis parameters self ticks :class environment timedeltaindex used controlled format periodindex along class latex list according formatting values formats output excelcells
method	keeping methods python abstract 3 2 error instead notimplementederror compatibility raise
mplplot	plot assembling matplotlib pandas base using class
indexable	represent pytables column generic indexed data
business	related one functions provide representing subclass custom business **experimental** holidays possibly mixin month beginning types dates increments excluding days eom n dateoffset
loc	integer-location selection based label-location indexing indexer label purely position
col	index generic represent description pytables definition column indexed holding represented table data class indexable
base	"__next__()" engines grouper provide holds obtain ast actually method internal subclass walker iterator custom parsers class
key	map group tuple ease suffering compressed key -> id
offset	doesn't kind used month - needs standard range call increment date representation quarter super dateoffset
properties	series object datetimelike properties values accessor
panel	represents 3-dimensional legacy parameters format support formats stored suppor wide new table array data appendable panel
fixed	represent dataframes specialization fields object lines generified version converts fixed-width reader fixed store
last	week dates last like monthly tuesday month describes month" "the
extension	dtype custom holding np duck-typed suitable class
of	week dates last like parameters monthly tuesday 2nd describes month month" "the
byear	dates increments business begin eom year dateoffset
range	index monotonic implementing range rangeindex immutable
plane	plotting hexbin abstract currently class plane scatter
context	temporarily context manager set statement options
attributes	prevents attributes new mixin adding
chain	multiple mappings dicts create together updateable single groups view chainmap
groupby	different simple expanding one implementation itertools provides resample rolling groupby
block	homogeneous dtype manage dataframe scalar unit canonical compat contained internal series pandas core n-dimensional data structure panel arrays list single etc sparse implement block
op	operations datetime/time/timedelta around operands binary series wrapper unary arity parameters arbitrary operator hold arithmetic
ndim	new appendable formats suppor table
wormtable	read-many format appending write-once allow table
simple	poor exists object __getattribute__ man's note mocking classes new-style works assumes
dtype	raised metaclass determines ability categorical categoricaldtype dtype subclass custom perioddtype intervaldtype warning incompatiblity holding np duck-typed suitable type class
substitution	function's string perform docstring take substitution decorator
period	series years periods ability implementation subclass accessor provides metaclass immutable indicating ordinal holding resample object regular perioddtype particular quarters properties ndarray determines type months datetimelike etc values time groupby
unsupported	function attempting object call numpy pandas
nframe	implement largest/smallest dataframe n
rolling	rolling implementation groupby provides
raises	manager behind context assert_raises_regex
table	operations represent frame read/writes legacy table tables layout generic support dataframes various suppor new define vertical/horizontal format sqltable explanation multi-index append/query/delete interface appendable types panel pytables iteration patch read/write allow formats fallback facilitate
array	parameters point labeled sparse floating data 1-d structure
custom	one custom excluding business month **experimental** days subclass n possibly holidays representing dateoffset
select	series implement largest/smallest dataframe n
plot	plot dataframe hexbin plotting series attribute abstract currently plane class implementing accessor objects examples scatter method groupby
legacy	operations allow support legacy append/query/delete table appendable frame panel
module	mocking modules class deprecated
categorical	categoricalindex limited fashion ordered classic categoricaldtype series number s-plus set subclass custom index categorical / accessor take holding dtype np duck-typed metaclass immutable ability class object implementing variable sliceable properties represents categoricals determines type r values suitable usually fixed
deprecated	mocking modules class deprecated
wrapper	function attribute-style provide mmap wrapper nested access read properly dict wrap csv python's class decorator
by	plot aggregate implementing provide attribute object class facilities see objects mixed relational aggregating data groupby grouping
openpyxl22writer	openpyxl gh7565 support currently note v2 2 experimental
usfederal	based government federal us rules https specified calendar holiday //www
options	options stores pandas plotting
call	function attempting object call numpy pandas
hdfstore	storing dict-like pytables format objects either io interface table fixed pandas
scope	added deal syntax object custom contexts scope hold pandas bells
type	represents msgpack determines ability categoricaldtype type subclass intervaldtype ext perioddtype datetimetzdtype metaclass exttype
empty	thrown exception c read_csv (by pd
engine	engine serving engines space python evaluate object base numexpr expression class
tzdtype	determines ability datetime type subclass custom np holding dtype datetimetzdtype tz duck-typed suitable metaclass class
option	exception backwards set statement keyerror options compatible manager temporarily context pandas
openpyxl20writer	openpyxl gh7565 support currently note v2 experimental
ndframe	analogue multi-dimensional store dataframe n-dimensional
assert	manager behind context assert_raises_regex
csswarning	parsed cannot currently css syntax
inferer	machine avoid sure state
sas7bdatreader	read sas sas7bdat files format
grouper	custom object target grouper holds instruction allows class time-interval internal user actually groupby specify grouping
bquarter	dates increments like business 1/31/2007 startingmonth corresponds 1 4/30/2007 quarter = dateoffset
case	case used originally nosetests framework test using class
multi	multi-level formats appendable parameters index support object multi-index objects frame table new hierarchical pandas
converter	styles declarations callable 2 parts excelwriter converting supports css
nseries	series implement largest/smallest n
frozen	doesn't used container it's *but* item setting allow non-hashable technically
expr	engine custom engines multiple like pytables ast 'terms' object subclass comprised possibly parsers parameters encapsulating walker numexpr hold expression class
value	term prepare categorical condition/filter missing use construct formatted parse column value observation's output hold
soup	parser beautifulsoup dataframe html uses hood
frequency	machine avoid sure state
error	raised multiindex methods variables encountered notimplementederror compatible slice raise attempting index exception subclass 3 2 (by lexsorted pd instead local abstract get python c keyerror compatibility thrown keeping backwards pandas nameerror read_csv error options
resampler	groupby-like provides implementation resample datetimelike groupby resampling operation data class
property	like implementing series accessor descriptor str properties
beautiful	parser beautifulsoup dataframe html uses hood
function	function attempting object call numpy pandas
sqlite	connections sqlite sqlalchemy without sqltable support patch sqldatabase version fallback
expanding	implementation expanding transformations provides groupby
abstract	serving methods certain abstract notimplementederror raise engines create compatibility rules 3 2 instead python object holidays base interface class keeping error following
parser	raised parser dataframe encountered parse parsers converts fixed-width lxml specialization dataframes beautifulsoup html hood pd base uses class thrown exception necessary whenever fields read_csv warning error
single	single manage block
warning	impact shown necessary warnings whenever dtype possible dataframe read_csv warning incompatiblity serialized pd performance raised cannot
at	lookups **label** based similarly label-based loc, scalar fast provides integer accessor location
file	dialect passed overrides parser excel dataframe parsing tabular objects related sheets options class
in	hold blocks methods nonconsolidatable
operation	database perform two dataframe merge objects sql operation
generic	index pytables represent generic format generified read/writes column version represented table fixed data
date	kind used controlled periodindex locates series ticks :class standard range increment formats date along axis
ewm	functions weighted exponential provides
no	prevents attributes new mixin adding
consolidatable	hold blocks methods nonconsolidatable
excel	xlsx dataframe parsing tabular converting use parameters excel writing parts supports css styles xlwt openpyxl callable objects sheets excelwriter 2 class default declarations list formatting xls excelcells
indexer	selection purely scalar **label** fast quickly integer-location based similarly indexer label access label-location location provides scalars label-based indexing loc, integer accessor lookups position
mix	hold blocks methods nonconsolidatable
accessor	categorical properties mixin implementing series object accessor descriptor add values str acessor class like
html	dataframes parse html base parsers class
ixindexer	based label-location indexer primarily position integer fallback
timelike	timedeltaindex/datetimeindex common periodindex ops
test	case used originally nosetests framework test using class
performance	impact performance shown possible warnings
pandas	read_sql subclasses abstract class to_sql objects various base methods/properties delegating baseclass pandas define
mock	poor exists object __getattribute__ man's note mocking classes new-style works assumes
week	week dates last like parameters monthly tuesday 2nd describes month offset month" "the weekly
map	multiple mappings dicts create together updateable single groups view chainmap
begin	custom begin increments business dates **experimental** first year two per month day_of_month calendar dateoffset's repeating one beginning day dateoffset
unsorted	index raised multiindex attempting get slice lexsorted error
timedelta	series axis implementation ticks :class timedelta64 accessor provides int64 timedeltaindex immutable controlled boxed timedelta resample object objects represented along data properties ndarray internally datetimelike values formats groupby
sqltable	tables sql mapping pandas
object	various objects baseclass pandas
docstring	wrap function decorator
sqldatabase	sqlalchemy handle database sql dataframe abstraction convertion databases using enables class
lxml	lxml parser dataframe html uses hood
mixin	unified selection methods series related facilities / defines adding functions & provide index support ops long add types new method string business group-like docs object aggregation implementing mixin inteface interface class __unicode__ implements prevents datetimelike common str mixed attributes acessor groupby
sql	to_sql read_sql subclasses define
variable	nameerror variables local subclass
end	startingmonth corresponds month year calendar end two per custom 1 = ends business **experimental** 4/30/2007 dateoffset's last one day dates increments like 1/31/2007 day_of_month eom repeating quarter dateoffset
data	represent pd two-dimensional render point dataframe tabular sparseseries floating containing rows form generic self axes potentially holding indexed (by columns indexable size-mutable c objects data structure thrown definition exception pytables column read_csv labeled sparse heterogeneous
latex	latex used render dataframe environment tabular/longtable output
undefined	nameerror variables local subclass
database	connections sqlite sqlalchemy support without sqldatabase version fallback
i	integer-location selection based indexing fast purely scalar location integer position accessor
interval	index set determines ability type intervalindex subclass implementing intervaldtype ordered sliceable metaclass immutable
concatenator	operation orchestrates concatenation blockmanagers
fy5253	week fiscal 4-4-5 52-53 also describes year known calendar
ext	represents ext msgpack type exttype
time	datetime/time/timedelta operations controlled around locates series class ticks :class wrapper custom timedeltaindex time-interval periodindex formats along axis groupby arithmetic grouping
unstacker	multi-level parameters helper index / unstack pivot data class
width	dataframes specialization fields lines converts reader fixed-width
