all	clock module see details kivy free_all
code	highlighted used navigation codeinput code behavior modifies displaying class textinput
text	information documentation module see class textinput
out	smaller centre screen transition transparent 'falls' new disappears becoming
focus	combined behavior focus provides keyboard
interrupt	execute free_only clock frame interval interrupted free class see base sleep module kivy interrupt free_all interrupts events details
manager	control addresses :attr manager manages osc utility responsible :class maps main screenmanager views screen recycleview exceptionmanager class exception handlers positioning callables recyclelayoutmanagerbehavior exceptions
selection	allow selection behavior :class org/wiki/mixin>_ wikipedia <https //en recyclelayoutmanagerbehavior combined mixin layoutselectionbehavior classes derived
keyboard	interface :meth windowbase returned keyboard
touch	post-processor reuse delay certains 'up' touch inputpostprocretaintouch conditions event
query	queried querydict dot dict()
kinetic	information documentation effect module see kinetic class
sidebar	widget panels interfacewithsidebar settings default menu :class switch used displays provides interface sidebar class
layout	scatterplanelayout responsible relativelayout scatterlayout tabbedpanel tabs house areas blank module :class layouts including file strip information fails errors layout views don't chooser stack combined layoutselectionbehavior main :attr box used positioning pagelayout recycleview derived cover base grid manipulation interface using class icon case entire exception documentation list see float classes recyclelayoutmanagerbehavior allow every implement anchor view
gi	implementation using gstreamer camerabase :parameters
previous	information documentation actionprevious module see class
style	initialize instance pep-8 options
dejitter	rid jitterish blobs get
group	information actiongroup documentation module see class
cur	touch 2dcur tuio
candidate	represents set algorithm paths data object :class unistroketemplate protractor user using input matched ie unistroke
title	organize settings simple title label used sections
menu	settingswithnomenu widget used interfacewithsidebar settings menu button :class single *no* displays provides interface close settingswithspinner class panel
cache	information see documentation module
bench	10000 creation dispatch label a-z) (10000 on_update a-z), (1000 clock + * event 1 empty core widget tick 10*1000 10 widget) button root drawing
spinner	module one see displays special information menu top :class spinner provides switching widget used dropdown settingswithspinner interface class panel settings default button documentation list switch time panels
color	wheel colorpicker documentation module chromatic see
window	widget windowbase abstract window implementation
setting	organize simple within numeric individual boolean option title implementation top :class label setting sections used string settingitem cannot path class panel settings list settingstring base
dict	queried querydict dict() implementation adapter :class pickled dict ~kivy store dictadapter using adapters dot around
swap	like screen transition ios window swap new appears looks
fade	fragment transition based shader fade
atlas	information documentation manage module see texture atlas
input	code tap inputpostprocdoubletap module codeinput see highlighted triple touch rid jitterish displaying check information touches post-processor blobs event delay 'up' inputpostprocretaintouch conditions inputs used reuse get recalibrate removes certains inputpostproctripletap inputpostprocignorelist class double documentation list ignore textinput
local	implementation local :class filesystemabstract files
app	information documentation module application see class
string	string implementation top :class setting settingitem
splitter	graphical used documentation :class module see kivy representation tbe class
safe	clear() help referent object list proxy's proxy want method
repr	:class ~kivy provides uix listitemreprmixin listview
grid	information exception errors layout documentation fails module see grid manipulation class
fall	smaller centre screen transition transparent 'falls' new disappears becoming
report	changed lines results filenames collect print checks
tick	core a-z), * 10 button creation label tick clock (10000
wipe	fragment transition based wipe shader
advanced	easily set additional variables :class update effectbase uniform shader behavior
contextual	information documentation module see contextualactionview class
drag	dragbehavior //en provides org/wiki/mixin>_ wikipedia <https mixin
builder	templates exception parser creating etc widget builder responsible :class raised rule parsing failed merging internal rules kv file apply results
bar	actionbar information widget bar creating documentation module see progress class actionbarexception
settings	module one single displays close sidebar check information contruct top :class subclass pages spinner instance widget used use ~kivy class panel settings button documentation switch *no* ui time panels
button	wikipedia creation module see uix a-z) (10000 information a-z), console clock actionbutton * :class listitembutton provides bubble core widget intended org/wiki/mixin>_ use <https ~kivy mixin tick class 10 //en button documentation actiontogglebutton toggle mixes togglebutton listview specialized
drop	information dropdownexception actiondropdown documentation module see class dropdown
list	clear() selection interfacing list creation primary compositelistitem file uix high-level adding touches management layout listitembutton implementation :class inputpostprocignorelist provides chooser listitemreprmixin type method widget filechoosercontroller removes lists post-processor base ~kivy collection using data class dictionaries mixes ignore simplelistadapter listitemlabel listview adapters view
shape	abstract implementations shape representation class rectangle
damped	see documentation class module dampedscrolleffect
ignore	touches post-processor list removes ignore inputpostprocignorelist
item	operations selection links tabbedpanelheader within header individual compositelistitem uix containing requirements accordion create :class content listitembutton provides widgets listitemreprmixin must type abstract actionbar used accordionitem base ~kivy mixin conjunction class panel actionitem settings mixes convenience cannot listitemlabel listview automatically
slide	direction used show screen transition slide right new left
vector	information documentation module see vector class
async	image documentation module see asynchronous class
enchant	enchant spelling based library backend
blur	horizontally given vertically :attr ~verticalblureffect blurs width ~horizontalblureffect input
view	limited set selectableview list recycleview stencilview primary module see uix high-level contextualactionview information combines errors built providing implementation optional views :class recycleviewbehavior label window build provides provider viewclass) flexible actionview node widget used treeviewnode instantiated object upon (:attr base ~kivy scrollview mixin using data class icon exception listview modalview items adapter documentation filechoosercontroller large classes behavioral model treeview adapters view
picker	see documentation module
node	node used treeviewnode object build treeview class
tuio2d	2dcur object 2dobj 2dblb touch tuio
postproc	tap inputpostprocdoubletap triple touch rid jitterish check touches post-processor blobs event delay 'up' inputpostprocretaintouch conditions inputs reuse get recalibrate removes certains inputpostproctripletap inputpostprocignorelist double list ignore
creation	core widget * 10000 10 + creation a-z), label 1 button clock tick root a-z) (10000
numeric	implementation top :class numeric settingstring setting
relative	information relativelayout documentation module see class
video	information videobase creating implementation reader videoplayer module annotation labels see used video provider implement class documentation
recycle	limited set recycledatamodelbehavior keeps list :attr converts built implementation optional responsible :class recycleviewbehavior window describes provides viewclass) flexible indexable views models recycleview upon (:attr base data class positioning large recyclelayoutmanagerbehavior behavioral model providing view
oscmessage	osc messages builds typetagged
event	2dblb point 2dcur abstract pos registers touch osc tuio listens factory event handles 2dobj provider wm_motionevent main supports abstraction represents object touchpad base touches/fiducials non-touch input factories representing class updating motionevent availables incoming socket messages contact loop
reify	instance replacing call effectively descriptor uses result non-data put dict method decorator first
page	pagelayout information documentation module see class
container	stores object container gesture information
clock	execute free_only clock default frame interval interrupted free class see base sleep module kivy interrupt free_all interrupts events details
fbo	extra allows :class ~kivy graphics functionality fbo
selected	exception language selected raised method prior language-using call called
redis	implementation using redis store database
factory	motionevent availables factory registers input factories class
label	actionlabel text creation module see uix a-z) (10000 information a-z), console clock * :class label core treeviewnode combines labelbutton ~kivy tick class 10 markup documentation mixes listitemlabel listview specialized
content	settings tabbedpanelcontent single displays panels displaying class
pen	profile motionevent representing pos wm_pen supports event
tracker	represents search instantiated completed ongoing operation
vkeyboard	multitouch keyboard vkeyboard support onscreen
template	represents vectors list stroke uni path normally class
membrane	help referent object proxy's proxy want
progress	represents search used bar creating instantiated many completed widget implementing base ongoing progress operation class view
recorder	information documentation please module check recorder class
metaclass	register :class ~kivy widgets new metaclass automatically
screen	control exception used screenmanager intended screen :class element manager main class
blb	object tuio 2dblb
widget	module documentation 10000 fired series creation graphical dispatch see apply event on_update information (1000 + :class children 1 widgets new gets metaclass empty widget ability exception ~kivy effects class 10*1000 widget) register root drawing automatically
popup	information exception popup multiple fired documentation module content see added widgets class
vertical	vertically given :attr blurs width ~verticalblureffect input
wm	profile motionevent representing pos wm_pen wm_motionevent supports event
json	storing pairs key-value implementation json file using store
free	free_only clock interrupts interval free events see base sleep module kivy free_all class details
standard	print collect results checks
base	don't text results manages sleep label implementation :class window input main variables handle rules effectbase effects interrupt 2 parsing easily execute videobase instantiate specific collect common transitionbase view glsl set frame module see video kivy animate event clock uniform reader progress checks core widget creating free exceptionmanager implementing base handlers many shader etc merging attributes implement automatically load image within loader screens simply use additional contains handles returns camera screenmanager interrupts updating default behavior exceptions loop free_only providers abstract parser implementations file responsible internal details events templates used windowbase update metrics spelling class builder interval modules interrupted kv free_all
proxy	function image() image returned loader
anchor	information layout documentation module class see anchor
interface	settingswithnomenu widget panels settingswithtabbedpanel settings default menu top :class switching spinner used displays interface sidebar class content
path	implementation top :class setting path settingitem
selectable	operations containing selection requirements selectableview instantiated list :class used mixin items classes class view
rect	representation class rectangle
panel	links tabbedpanel tabbedpanelheader head module header single displays strip displaying information contruct heading/tab tabbedpanelcontent :class subclass class content instance tabbedpanelexception tabbed provides type widget used intended settingswithtabbedpanel use implementing base ~kivy background pages panel settings button documentation see convenience panels automatically
pixelate	~pixelateeffect input pixelates according :attr
toggle	information //en org/wiki/mixin>_ provides wikipedia button documentation actiontogglebutton see module <https toggle togglebutton mixin console specialized class
obj	object 2dobj tuio
fxaaeffect	simple anti-aliasing fxaa via applies
language	exception language selected raised method prior language-using call called
sdl2	image sdl2_image based loader
accordion	information accordionexception accordion documentation :class module see used accordionitem conjunction class must
adapter	bridge selection interfacing creation converts adding management :class type around lists base ~kivy collection dictadapter data class adapter dictionaries simplelistadapter adapters view
transition	right show within switches drawer smaller transitionbase looks changing animate functions based appears opaque :class wipe next delay application window animation 4 fade new android swap transparent instantly direction used screenmanager centre fragment screen object ios collection larger uses x 2 rises class card screens 'falls' like disappears transition becoming shader slide animating similar left
provider	incoming socket messages class handles base provider osc tuio listens
scatter	scatterplanelayout information essentially scatterlayout unbounded convenience documentation widget module scatter see it's class
motion	2dblb point 2dcur abstract pos registers touch osc event listens factory tuio handles 2dobj provider wm_motionevent supports abstraction represents object touchpad base touches/fiducials non-touch input factories representing class motionevent availables incoming socket messages contact
separator	actionseparator information documentation module see class
modal	information modalview documentation module see class
recognizer	database :class facilities provides recognizer matching gesture
retain	post-processor reuse delay certains 'up' touch inputpostprocretaintouch conditions event
system	files used filechooser implementation :class system filesystemabstract <filechooser> implementing file local class view
navigation	modifies code navigation textinput behavior
options	option implementation list top :class settingitem
opacity	uses overscroll opacityscrolleffect class
compound	selection behavior org/wiki/mixin>_ wikipedia <https //en mixin
simple	~kivy :class simplelistadapter adapters
image	load pil image library loader single asynchronous sdl2_image images size image() based texture gif store function returned information mipmap base module container class represents ffpyplayer documentation see implement
float	information documentation layout float module see class
dispatch	on_update widget (1000 widget) dispatch event 10*1000
loader	load sound given based library ffpyplayer image implementations loader specific gif base common file sdl2_image using pil type implement best
down	information dropdownexception actiondropdown documentation module see class dropdown
header	head intended button implementing base tabbed panel
boolean	implementation top :class boolean settingitem setting
strip	tabbedpanel tabs house strip including blank layout heading/tab don't :class main kivy graphical used intended background tbe class areas case entire cover representation
diff	print collect changed lines results
open	implementation using camerabase opencv
cv	implementation using camerabase opencv
horizontal	horizontally given :attr blurs width ~horizontalblureffect input
stencil	information documentation stencilview module see class
invert	inverts input colors
chooser	directly don't list :class layouts filechooser use layout implementation chooser progress supports switching file used multiple views implementing base synced using class icon many filechoosercontroller view
only	free_only clock module see details kivy
annotation	labels creating used annotation class
gif	file image loader gif base something decodes decoder else class
checker	load style python coding source file tokenize check
handler	catches handler base exceptions runtouchapp :func
emacs	//en org/wiki/mixin>_ wikipedia <https mixin enables emacs-style
card	drawer transition application looks x android similar card 4
carousel	information documentation module see carousel class
osxapp	provided based features osx's appkit spelling backend
preview	used get frame back camera interface android preview
bubble	information widget intended button documentation use module see bubble class
store	storing pairs used key-value database implementation abstract redis pickled json dict file using implement class store
box	box information checkbox layout documentation module see class
option	used dropdown default list button :class spinner special
composite	:class mixes ~kivy compositelistitem uix listview
scanlines	scanlines adds input
tap	post-processor tap inputpostprocdoubletap double inputpostproctripletap triple touch check
slider	slider widget class creating
controller	use directly don't implementing base filechooser class
module	load handle self instantiate modules module access context kivy config automatically
decoder	gif else file decodes something
rst	widget used documentation module see base rst document store
ffpy	ffpyplayer image based library loader
overflow	information documentation module see class actionoverflow
with	10000 settingswithtabbedpanel creation one single displays close sidebar (10000 spinner a-z), clock menu + * :class label 1 content switching core widget used settingswithnomenu pages ~kivy interface tick class panel 10 settings default button switch *no* time panels root top
addon	implementing base class addons
sound	load sound given used represents abstract play loader cannot file using type class best
exception	raised fired manages something file apply fails errors layout dropdownexception :class class content failed handler widgets gets happened widget popup multiple added tabbedpanelexception exception exceptionmanager wrong base grid manipulation runtouchapp :func catches accordionexception handlers screenmanager builder rule kv exceptions treeview actionbarexception
launcher	thread instance launches acts application returns proxy
double	post-processor tap inputpostprocdoubletap double touch check
tree	node information exception errors treeviewnode object :class combines module label see used ~kivy build uix treeview class documentation
descriptor	represents single class image
behavior	accessible code associated positioning wikipedia frame keyboard focus :class selection sleep kivy recycledatamodelbehavior naming describes built clock data responsible namespace recycleviewbehavior coverbehavior classes combined provides inherited viewclass) layoutselectionbehavior :attr emacs-style model added org/wiki/mixin>_ allow views models upon interrupts recycleview derived free <https objects mixin optional class dragbehavior execute //en inheriting (:attr interval allows interrupted events base recyclelayoutmanagerbehavior behavior behavioral knspace modifies enables navigation textinput
error	exception language could selected raised called specific prior language-using call found method
knspace	accessible named added stores inheriting :class :attr inherited namespace instance objects allows kivy knspace associated naming class
property	represent inside property rule
root	widget 10000 + creation 1 root
guide	initialize instance pep-8 options
loop	handles loop input main event updating
interactive	thread instance launches acts application returns proxy
pil	pil image based library loader
triple	post-processor tap inputpostproctripletap triple touch check
cover	//en org/wiki/mixin>_ wikipedia <https coverbehavior mixin
abstract	used filechooser data adapter :class system abstract <filechooser> implementing ~kivy file provider using implement adapters class store view
parser	represent raised enhanced parser parse something file kivy configparser addition create content internal sections happened terms object wrong class represents exception language default supports inside rule values kv property
surface	used track/draw simple surface touch typically gesture movements
shader	transition shader screens 2 uses animating class
player	information used creating labels videoplayer module class see annotation documentation
stroke	gestures strokes made multiple
file	file don't chooser results <filechooser> layouts filechooser use layout implementation :class system print progress local checks files used multiple views filechoosercontroller filesystemabstract filenames implementing base synced using class icon supports many list switching collect directly view
in	opaque larger centre screen transition transparent changing new rises becoming
monochrome	input returns colors monochrome
null	implementation videobase provider
multistroke	represents set maintains :class multistrokegesture gesture
check	information checkbox documentation module see actioncheck class
unistroke	represents vectors list stroke uni path normally class
no	raised switches single displays close selected :class next delay animation call button method instantly widget used screen language-using interface panel settingswithnomenu exception language settings could transition specific prior *no* found called
switch	information documentation see module switch class
tuio	abstraction incoming socket messages handles touches/fiducials provider osc tuio listens
mix	color according mixes channels input property order
animation	definition widget used create object functions collection animation animate
tabbed	links tabbedpanel tabbedpanelheader head module header see displays strip information heading/tab tabbedpanelcontent :class pages content tabbedpanelexception tabbed provides type widget used intended settingswithtabbedpanel implementing base ~kivy background class panel settings button documentation convenience panels automatically
pygame	pil image based library loader
android	implementation using android api camerabase
document	widget used documentation module see base rst document store
config	addition sections default values enhanced supports class configparser
channel	color according mixes channels input property order
wheel	wheel colorpicker chromatic
draw	widget 10000 + 1 root drawing empty
rise	opaque larger centre screen transition transparent changing new rises becoming
context	access self config module context
camera	:parameters widget documentation information implementation camera abstract gstreamer module opencv see api using android camerabase class
console	widget console implementing button created module labelbutton base togglebutton loaded interface create_console(), addons specialized class
effect	glsl informations ~pixelateeffect set extra color series variables widget module according channels colors ~horizontalblureffect simply apply monochrome kinetic blurs fbo children horizontally given adds additional dampedscrolleffect :class uniform width returns functionality input :attr pixelates ability see vertically scanlines update effectbase effect base ~kivy effects graphics scrolleffect overscroll class graphical easily opacityscrolleffect documentation allows shader mixes inverts information ~verticalblureffect behavior uses property order
kit	provided based features osx's appkit spelling backend
metrics	use don't default contains metrics attributes class
action	actionlabel abstract module see contextualactionview information create actionprevious widgets actionview actionbar class actionseparator actionitem actiongroup actiondropdown documentation actiontogglebutton actioncheck actionbarexception actionbutton actionoverflow
mac	motionevent point supports pos touchpad contact representing
plane	scatterplanelayout information essentially convenience unbounded documentation widget module scatter see it's class
mixin	:class ~kivy provides uix listitemreprmixin listview
such	exception language could raised specific found
spelling	provided based features providers library base osx's appkit spelling enchant class backend
data	operations selection recycledatamodelbehavior converts images containing container implementation optional :class describes provides viewclass) indexable views models recycleview mipmap (:attr base mixin requirements data class list keeps view
stack	information layout documentation module class see stack
icon	filechoosercontroller layout implementation :class chooser file using icon view
lang	exception language could raised specific found
database	handle class gesture database
url	urlrequest usage see documentation module
markup	text markup label
calibration	recalibrate inputs
request	urlrequest usage see documentation module
rule	represent terms language represents inside rule internal kivy property
callback	used callables addresses get frame back maps osc camera interface android preview class utility
sandbox	raised used widget widgets sandbox trap child exceptions
model	recycledatamodelbehavior indexable models describes :class implementation list base provides keeps data class
scroll	information scrolleffect dampedscrolleffect documentation module see opacityscrolleffect scrollview uses overscroll informations class
gesture	set stores dopertchouk simple surface used touch http recognition movements information container implementation :class python //www object handle strokes maintains gestures multiple class represents made track/draw algorithm database oleg multistrokegesture typically gesture
