eterms	aberration frame system e-terms coordinate removed fk4
all	wait(return_when=first_exception search used storing perform all_completed) first results subclass successful cone query instead asynchronously data types result
partial	arrays raised overlap partially
iterator	flat returned iterator quantities object q quantityiterator iterate
dynamic	function cartesian matrix 3 yields specified coordinate x transformation
results	search results cone validation class store
scalar	scalars variable-length numeric joint handles formatter/locator array
comments	header used internally class comments
query	index given handle supplied indicates cannot query
alt	frame system coordinates altitude-azimuth coordinate horizontal
row	represent object one table class row
inverse	simple polynomial inverse imaging
graph	coordinate graph representing frames paths
removal	combines outlier technique removal fitting class procedure
spec	xml good workaround spec obvious file input violates
gnomonic	gnomonic sky - projection pixel
string	truncated julian assigned warning year 'j2000 support beautifulsoup epoch 0' 'b1950 besselian numpy string base representations hold data class string-like dates gets like column allows value length time strings
void	used & - private signature marker parameter
exception	uncertainties exception used associated extension parent instance uncertainty two requested different indicate classes exist hdu propagated cases ~astropy raised user
vlf	variable field length object
flatw0wa	cpl energy flrw curvature cosmology dark state equation
nesting	doesn't level indicates nesting error match
bounding	box templates (methods adjustable return tuple models given custom parameters--see base bounding actual class
disk2dkernel	2d trapezoid disk airy kernel
datetime	represent python object library standard ~datetime date datetime
minute	raised [0 60] value 60 range minute
splitter	work don't splitting self comma remove tab strip table extract deluxetable_ tables based whitespace ' width python's comma-separated-value since start split tsv csv method columns strings latex python base uses significant date end line data class headers splitter splits using ipac default positions & lines value | column delimiter fixed col names
hour	24 raised [0 hour 24) value range
irreducible	units irreducible defined terms
f	implements function parameters minimized knuth_bin_width class
list	contains list nested elements file sense table capture given errors xmlwriter subclass write tuples types instead sorts type used handler records astropy class structure column allows specific verification attributes makes order
prefix	another version simply si-prefixed unit
p	variable p length table format
indices	name column list allowing indices table retrieval special
lsqfitter	square linear algorithm performing least fitting simplex statistic levenberg-marquardt squares class
fittable1dmodel	models fittable base class one-dimensional
commented	comment definition given faster begins column starts character :class header version read names file reader line commented commentedheader class looks
heliocentric	origin ecliptic heliocentric coordinates
second	raised [0 60] second value 60 range time
perspective	projection zenithal sky - slant conic colles' cylindrical perspective pixel
index	manager table special intended index make wrapper provides performance columns correctly function around object indexing possible slicing class improve queried actual modes column allows maintain values context indices makes
predictor	predict run class time
incompatible	uncertainties exception used incompatible versions two astropy different indicate classes change propagated cases warning class indicating previous
section	represents additional dictionary-like config image object indicates repeated file error sections section __many__
ticks	note line2d ticks derived markers
box2d	dimensional box model two
importer	submodules six importer meta import path moves
template	behaves like template string
threading	asynchronous multithreaded xmlrpc server
coordinates	coordinate helpers container system represents
contrast	account inverse takes stretch contrastbiasstretch bias transformation contrast
ioregistry	clashes error registry custom
e18	resource attribute one "meta" "results" element type must
wcsworld2pixel	world wcs transformation coordinates pixel
cylindrical	projection cylindrical area sky points - equal coordinates pixel base perspective pseudocylindrical representation 3d class projections
web	profile web samp dialogs xmlrpc supporting handler consent make writing easier base gui requests server class performed
groups	represent hdu within random heterogeneous groups fits table data class
path	submodules six importer meta import path moves
ring2d	symmetric two dimensional radial ring model
accessor	subset use return generic slice/filtering wrapping capabilities header's header way cards class
change	xml made incompatible versions astropy warning indicating file input class change previous
box	box templates (methods adjustable return tuple models given custom parameters--see base bounding actual class
convert	raised system cannot another coordinate converted
broken	break power smoothly one dimensional broken model law
items	lazy loading moved objects
changed	warning options configuration changed
zscale	asinh based linear estimating iraf's interval mapping stretch zscale
docstrings	methods metaclass base filled docstrings override makes class automatically
e10	elements later param 1 field votable must
options	fast one indicates invalid specified reading options
moffat2d	dimensional model two moffat
named	units base class name
e12	meant used application attribute number width characters output input indicate
projection	pix2sky sky base sky2pix class projections
dtype	info dtype gets parent mixin
trapezoid1d	dimensional trapezoid model one
replace	via column warning replaced table cases class
sliced	function index actual around make object wrapper slicing provides class correctly
vounit	units used vo ivoa standard
unix	utc 00 seconds 1970-01-01 unix time
boolean	datatype handles boolean values array
hdudiff	unknown (but hdu type image table two hdus headers objects including contain diff data
configspec	whilst configspec parsing occured error
voerror	exceptions base class vo
disk2d	symmetric airy two dimensional radial trapezoid model disk circular
unit	already si-prefixed exists defined allows abstract magnitudes related one scaled catch manages exist expressed another allowed converting expressions unit physical containing errors sphere parameters create specifically previously setting correctly units main metaclass function used terms format composite version db return base registry representation fits using class logarithmic instantiated parse name instances via irreducible points sometimes enabled recognized specific involving constructor usually simply subclasses interpreting
absorption1d	absorption gaussian one dimensional line model
plot	~matplotlib pyplot plot_date matplotlib input
sersic2d	profile brightness two surface dimensional sersic
from	represent multiple point interval times epoch base time particular floating class unit (e
illegal	24 raised [0 hour 60] 24) second value 60 range time minute
two	tables whitespace ' width read lines splitting two write header reader splitter table fixed data first
jsviewer	table html export provides interactive
duplicate	already keyword exists title url section vo access catalog specified
handler	info capture used logs xmlrpc stdout web list messages standard records handler profile performed stderr debug streamhandler requests specialized
hduexception	exception used __new__ signal mainly custom _basehdu class
polyconic	sky polyconic - projection pixel
type	text indicates boolean subclass allowed consists physical errors strtype specifically numtype describes units type setting used quantities numerical wrong integer data class types floating-point column value supplied specific classes superclass
kernel1d	filter kernels base class 1d
flat	flrw constant curvature cosmological cosmology
elliptical	frame elliptical
composite	transformations combination composite series create two together single-step previously defined transforms combining units using expressions transformation unit constructed
factor	scale redshift one dimensional factor model
flag	containing dictionary provide arrays flags purpose nddata class
healpix	polar projection sky healpix - class base projections "butterfly" aka pixel
unimplemented	implemented feature votable_ spec
dex	parameters expressed magnitudes units logarithmic physical
const2d	dimensional model constant two
err	errors list nested verification class structure
gcrs	celestial reference gcrs frame geocentric system coordinate
science	used science manage results global state items affect subclasses
legendre2d	2d polynomial legendre
dev	deviation error uncertainty gaussian standard propagation assuming order first
soup	data hold allows strings beautifulsoup
bias	account inverse takes stretch contrastbiasstretch bias transformation contrast
values	domain used field_ within values_ element elements values param_ define
transformation2d	perform 2 affine transformation dimensions
executor	executors abstract concrete base asynchronous class
w53	resource least one votable contain element must
w52	binary2 format 1 3 votable introduced
w51	integer range field value size
w50	string defined astronomical invalid standards catalogues version 2 unit
corrupted	hdu corrupted class
stream	info logs stdout messages stderr debug streamhandler specialized
deprecation	deprecated feature indicate warning soon-to-be class
attribute	associated attribute frame describe header shape invalid non-mutable keywords given specified coordinates units earthlocation optionally quantities act objects fits hold data properties column object descriptor cartesianrepresentation time coordinate attributes ~astropy validation quantity
lorentz1d	dimensional model lorentzian one
tabular	table returns lookup value interpolated
proxy	profile interaction xmlrpc hub via thread-safe standard objects simplify client proxy samp serverproxy class pool
stereographic	pixel sky - stereographic projection
tab	engine tab don't parsing header remove file strip tab-separated tables whitespace since :class version split reader tsv ordinary separated read basic optimized uses significant data c faster unlike lines value
normalize	matplotlib used class normalization
sip	sip simple inverse imaging polynomial model
classproperty	property, similar allows class-level properties
verify	exception methods verify warning verification shared class
six	submodules moved urllib_robotparser meta moves loading urllib_error create six namespace importer urllib 3 urllib_parse import lazy python objects path urllib_request urllib_response resembles
namespace	items subpackage configuration namespace
range	range raised part angle valid
w26	given declared inside supported however element version votable specified
w27	deprecated coosys element 1 version votable 2
w24	www database retrieved vo catalog version designed newer
w25	network service due vo failed arguments malformed error query
w22	used specification 1 0 version votable definitions
w23	raised network service database outage updated vo possibly due
w20	given version parser number 1 written explicitly votable file assumes
w21	files may unknown vo votable arise using table issues
csv	io writerow delimiter=' replace header comma file writerows comma-separated-values ascii tables functions ' comma-separated-value writer :class internal split version basic ordinary csv engine read optimized astropy uses parsing data class case c faster csvsplitter
config	configobj set associated file testing manager stored subpackage raises primarily configparser use errors create behaves namespace write setting config files temporary read object astropy path configuration class like items value base context
w28	given declared attribute supported however element version votable file specified
w29	files "v1 form number version votable 0", specify
profile	profile web samp dialogs xmlrpc supporting handler consent make writing easier base gui requests server class performed
dialect	dialect format dumps tables fits csv ascii pyfits
mar	levenberg-marquardt squares least algorithm statistic
galactic	galactic coordinates
w	constant energy flrw curvature cosmology dark state equation
outlier	combines outlier technique removal fitting class procedure
max	represents interval based comparison tuple purposes value maximum minimum values infinite data
mapping	asinh(q ~collections namedtuple intensities preserving minimum dropped /stretch)/q duplicated blue stretch - zscale colours estimating green = red inputs asinh used linear reordered uint8 mapping independent brightness allows map values x baseclass
collection	containing dictionary provide arrays flags purpose nddata class
mac	function string current returns key null ascii returned
astropy	set list primary thereof warning unicode previous incompatible warnings feature custom indicate safeloader indicating core used safedumper tuple python object constructs objects base date class change represents logging versions deprecated instantiate well inherit astropy time soon-to-be
mag	parameters expressed magnitudes units logarithmic physical
fits	within "[±y]yyyy-mm-dd[thh ])]" file encapsulating array unit container non-standard realization files sss]][(scale[ format standard fits class entire hdu ss[ extension mm single record
data	don't random splitting cds imagedatadiff line tables one-dimensional :class add tsv info read exception splitter \enddata arrays fixed csvsplitter portable meta enclosed diff images special whitespace ' matter since uniform reader reading parent \startdata base (really extension starts uncertainty rdb attributes first groups image primary header strip table array unit doesn't use width assumed two indicate 2 way basic uncommented separated deluxetable_ case hdu ipac whether originally value descriptor classes 1-dimensional ~astropy property treated storing associated tab attribute io ascii instance rawdatadiff used though object astropy uses significant data class latex "pixels") lines without
response	lazy loading six moved objects urllib_response moves
a	provided targeted iers usno table class
bar	size spinner total bar depending whether display terminal displays progress operation progressbar class either
short	correct short datatype signed supplied handles value integer type 16-bit
e20	defined fields table *x* data columns
e21	defined *y* fields table *x* data columns
ucdwords	ucd acceptable manages list words
lines	subsequent lines joined ending continuation_char line inputter
element	xml represent elements file don't simple info require param parsing field classes votable machinery base class special outputting
q	description format arrays length q carries variable type
alias	wraps translate like aliases* object existing creates *key dict along mutablemapping,
ortho	chebyshev legendre models 2d base class
inline	latex style based guidelines negative iau output powers display unit
first	used wait(return_when=first_completed)
order	column list astropy specific tuples sense table sorts attributes makes order
const1d	dimensional model constant one
mexican	2d mexican kernel symmetric two dimensional one filter 1d model hat
replier	function errors returned allows bound maps call decorator grab samp automatically notify
htmloutputter	object astropy html table output data
group	random group field_ object one elements groups param_ group_ element data
xmlrpcserver	profile supporting secure xmlrpc web server connections asynchronous multithreaded samp sockets
affine	perform 2 affine transformation dimensions
daophot	read iraf daophot produced header file routine
wcspixel2world	world wcs transformation coordinates pixel
complex	handle arrays floatcomplex variable-length datatype handles complex double-precision numbers base single-precision pair array ieee class fixed-size doublecomplex
longitude	angle degree longitude-like contiguous within range wrapped 360
latitude	latitude-like angle -90 range deg +90 must
besselian	0' like point value 0 epoch 1950 year 'b1950 floating besselian string
pending	deprecated feature indicate warning soon-to-be class
arguments	bind holds mapping call result signature arguments
w13	files use non-standard datatype votable names wild
auto	updated downloading handle provide iers necessary values most-recent data automatically
safe	handles transaction xml-rpc https server
fk4no	aberration frame system e-terms coordinate removed fk4
equidistant	projection zenithal sky - conic equidistant pixel
knuth	implements function parameters minimized knuth_bin_width class
not	requested raised extension hdu exist user
sorted	implements container arrays list using sorted array numpy
rotation	implements actual rotatecelestial2native rotations base computation angle rotatenative2celestial intrinsic class euler
day	"yyyy day-of-year mm year sss ss hh doy time "
association	exception used associated parent instance uncertainty indicate ~astropy
voserror	exception vo service general
search	storing search asynchronously perform results first general successful returns exception cone instead query validation class store result
name	already catalog title exists vo
parameter	incorrect represents wraps used handle parameters function individual signature indicates definitions cannot values passed reader input parameter
decimal	corresponding decimal time midnight values year integer day first
conic	projection area orthomorphic sky - equal pixel conic colles' base equidistant perspective pseudoconic alber's class projections
mode	modes allows indexing manager context performance improve special intended
timeout	operation deadline given exceeded
fitness	functions blocks derived overload method following base fitness bayesian classes class
cobequad	spherical cube projection sky - cobe quadrilateralized pixel
found	requested raised extension hdu exist user
notifier	object provides register listeners objects mixin services changes class
homogeneous	given elements contains list subclass type types
vowarning	exceptions base class warnings vo
w19	elements embedded field column fields defined file fits using match headers
w18	elements) rows actual attribute number nrows explicitly present (tr specified match
w17	appear within description parent element
w15	name attribute required element field every
hat1dkernel	filter hat mexican 1d kernel
w12	name field attribute element record either id array numpy order columns must
w11	used reference versions attribute specification earlier element gref votable link glu specify
w10	specification parser invalid element exist context encountered appears
vosdatabase	represent voscatalog class collection
meta	already constant exists submodules primary instances meta exist moves unit adds currently :class time_formats importer time_delta_formats merge_strategies provides import metaclass registries return mergestrategy respectively registry path six registers timedeltaformat fitter sometimes descriptor classes constructor timeformat model property subclasses purpose
static	cartesian matrix defined 3 coordinate x transformation
year	"yyyy corresponding day-of-year mm decimal time midnight sss ss hh doy values year integer " day first
ephemeris	ephemerides calculating default positions solar-system bodies
getch	function null string get screen character returns standard current single without key input echo ascii returned
container	use wish class "remember" classes attributes order metaclass ordereddescriptor
matrix	function cartesian matrix defined 3 yields specified coordinate x transformation
item	type issued value stored astropy file specified expected associated configuration warning setting match
squared	stretch convenience 2 class power
content	info elements outputting don't simple require param parsing field base machinery class special
reader	outputter methods instances read data specified write header inputter using table providing ascii class
rec	fits record array class
ref	implements paramref_ used remote field_ inside mixins element param_ elements fieldref_ nddata group_ refer
linear	blue map square linear stretch values performing uint8 least fitting green intensities class red
ast	exception used exception-catching mechanism indicate astropy ipython placeholder
hat2d	symmetric mexican two dimensional model hat
small	small type supplied value correct
unrepr	unrepr parsing mode error
base	chebyshev represent parameters implementation :class dict input transformation return get read indexing collections joint [0 (_asciicolumnformat) using python's splitter name instances list keyed 2d arbitrary polynomial-like outputter methods gaussian library meta specified (just _columnformat) reader metaclass method 3d exceptions objects inputter groups output interface :py search extension column range base requests point image within number header directly frames table array diff unit 1], use service stretch bintrees system fast 1d transformed function form binary representing coefficients info hdu datasets anything work tree classes values formats heterogeneous ~astropy providing called computed associated abstract vo asynchronous legendre ascii defines information different write split units used n-dimensional models object concurrent astropy uses fits data class following interval lines formatter/locator coordinate representation validation
inputter	subsequent return get lines list joined ending inputter input table line continuation_char
byte	unsignedbyte datatype unsigned handles integer 8-bit
card	subset use return generic slice/filtering wrapping capabilities header's header way cards class
definition	incorrect models used definitions
backwards	incompatible versions astropy indicating warning class change previous
logging	exception errors features deactivating activating logger-related astropy various logger typically occur
waiter	wait(return_when=first_exception as_completed used wait(return_when=first_completed) all_completed) provides event block wait
supergalactic	al coordinates (see et lahav supergalactic
catalog	already exists title url missing vo access catalog
multiprocessing	using validation multiprocessing failed
filter	filter record origin
sampproxy	exception samp proxy hub
sampintegrated	simple samp client
iso	" ss format mm 8601 hh sss "yyyy-mm-dd compliant iso date-time
delta1d	dimensional function delta dirac one
signature	function represents object overall signature
voigt1d	dimensional profile model voigt one
lambda	flrw constant curvature cosmological cosmology
origin	filter record origin
mixin	subclasses within services table provide storage ndarrays add provides nddata unitbase numpy arithmetic object slicing objects mixin interface using class callable column makes register listeners allow arbitrary changes
outputter	name column overrides object astropy keyed objects dict table output
law1d	break exponential power smoothly one dimensional broken model law cutoff
primary	fits hdu primary class
unsupported	fitter raised type support constraint
date	~matplotlib dates plot_date point julian pyplot support matplotlib epoch base 'b1950 input floating besselian class string
fast	acts names library one indicates addressed underlying invalid tab specified tables implementation bintrees writer :class fast version basic ordinary reading engine wrapper handle intended format read reader indexing search binary optimized uses using line parsing commentedheader class c csv faster header column tree commented rdb similar options looks
orthographic	projection - sky slant orthographic pixel
array	'*') simple numeric (i variable-lengths numbers using array functionally container lengths fixed-length handles wrapper variable-length complex nddata bits arithmetic around scalars minimal equivalent object mixin variable sorted class implements e arrays numpy list boolean values fixed-size fixed *arraysize*
size	even kernels called size
carree	plate carrée projection sky - pixel
cartesian	cartesian attribute frame coordinates points cartesianrepresentation specified units representation 3d
xmlrpcrequest	profile requests handler xmlrpc standard
lazyproperty	property(), computes works value similarly
orthomorphic	projection orthomorphic - sky conic pixel
unknown	implements function requested unknown uncertainty check type class
system	ephemerides calculating default positions solar-system bodies
wrapper	function automatically errors around simple allows bound wrapper maps call decorator mixin notify using array samp numpy grab minimal returned
flamsteed	sanson-flamsteed sky - projection pixel
too	short big long supplied value small type correct
airy	kernel projection sky - two dimensional 2d airy model disk pixel
ordered	body whose use descriptors class "remember" base preserved ordereddescriptor wish attributes classes metaclass order
model2dkernel	2d kernel create model
wpwa	cpl redshift energy flrw curvature cosmology dark state pivot equation
gps	utc 00 630720013 seconds 1980-01-06 time example gps
subplot	wcsaxes class subclass
mjd	date julian format modified time
option	interpolation missing value specified
asymmetric	keeping based asymmetric interval fraction specified pixels
completed	wait(return_when=first_exception as_completed used all_completed) wait(return_when=first_completed)
acquire	ordered acquire manager future context conditions
var	scalars '*') e lengths variable-length numeric arrays handles (i numbers variable array complex *arraysize*
votable	xml represents made workaround entire votable_ spec good obvious file input element violates change
rst	format read <http restructuredtext write simple table //docutils
quad	spherical cube projection sky - pixel base quadrilateralized projections quad class
std	deviation error uncertainty gaussian standard propagation assuming order first
distance	distance one-dimensional
b	provided b targeted iers table class
ipac	splitter header read format ipac write headers see reader table data
double	handle datatype double pair handles double-precision doublecomplex ieee
future	represents asynchronous result computation
str	column indicates data consists text
cards	given used return keyword sequence header values commentary list-like history
sec	00 center seconds tt time si delta chandra 1998-01-01 x-ray
galactocentric	coordinate frame galactocentric system
tangential	spherical cube projection sky - tangential pixel
futures	ordered acquire manager future context conditions
hat1d	dimensional hat model mexican one
julian	'j2000 like point julian 2000 value 0 epoch 0' year floating string
raw	case treated one-dimensional data 1-dimensional images array imagedatadiff rawdatadiff special
iersrange	dates outside iers range valid error
sampclient	acts application create manage server callable facilities compliant client provides exceptions xml-rpc samp class utility
curved	abstract base transforms curved class non-affine
cosmology	use : general default cosmology implemented placeholder class change
moffat1d	dimensional model moffat one
conversion	used terms related errors specifically units converting interpreting
angle	parses rotations one including angular 02 01 angle * degrees units various euler equivalent joint intrinsic implements 30 radians value formatter/locator formats
min	based opposite interval maxvalue maximum minimum values representation data e
delta2d	dimensional function dirac two delta
fitting	combines outlier technique removal fitting class procedure
client	simple samp client
httpsconnection	communication via allows class ssl
commentary	given used return keyword sequence header values commentary list-like history
w40	protocol simple support terrible results access archive hack image
w41	xml namespace element votable file specified expected match
w42	namespace root specify element
w43	defined referenced elements referees
w44	elements reference element content values another
w45	: attribute one link following content-role element must
w46	given string long char field length unicode specified
w47	intended default char field '1' arraysize specified rarely implied
bst	engine binary search used python indexing tree pure basic
w49	cell illegal 1 prior 3 votable integer empty
barycentric	origin ecliptic barycentric coordinates
regular	blocks "tick" length regular fundamental fitness bayesian data events
representation	spherical ~collections point attribute frame sphere specified unit cartesian system coordinates convention units theta 3d namedtuple phi used cylindrical object (using base using representing points cartesianrepresentation azimuth coordinate representation inclination physics
encoder	default support encoder json data types
class	already return exists sometimes instances exist constructor metaclass unit
latex	guidelines header table unit tables style based & negative write split iau read date data class latex default delimiter output powers display
fitter	fit fitter currently share models base registry provides classes parameter class fitters
request	profile web lazy loading xmlrpc urllib_request handler six moved objects performed requests moves
ext	hdu non-standard extension class
physics	spherical phi using azimuth coordinates (using points convention representation inclination physics theta 3d
slsqp	sequential algorithm programming least optimization squares
sersic1d	profile brightness surface one dimensional sersic
quantity	associated iterator attribute frame number scaled shape meta superclass specified unit description information container parameters units physical type function flat optionally returned format quantities object iterate like logarithm represents name q quantityiterator specific representation ~astropy quantity
gaussian1dkernel	filter kernel 1d gaussian
ndiomixin	astropy input/output connect mixin nddata class registry
cdm	constant cosmological redshift energy flrw pivot curvature cosmology dark state spatial variable cpl equation
ring2dkernel	2d filter ring kernel
gaussian1d	use models gaussian one dimensional base 1d directly model class
inconsistent	indicates table inconsistent way input
cds	u-strasbg astronomiques de http strasbourg format read <http support cds see données fr/doc/catstd centre reader table //vizier data //cds htx
earth	information container like format attribute frame description coordinates meta location act earth ~astropy earthlocation name
htmlsplitter	table html data split
e19	xml doesn't raised appear element votable either file root
resource	resource_ elements table_ groups element
vosbase	vosdatabase voscatalog base class
sine1d	dimensional model sine one
async	:py successful search instead service storing perform results first vo concurrent returns base asynchronous cone query using requests asynchronously class result
e11	meant digits places attribute decimal express precision number either significant (e
iowarning	network cache occurred io error using recovered
e13	1 2 votable spec
writer	case functions xmlwriter ' writerow delimiter=' list writer allows replace write internal file writerows instead csv class
e15	attribute coosys elements id must
e14	attribute elements value param must
e17	attribute positive extnum integer must
e16	: attribute coosys system one following element must
dict	represent wraps translate return like column items() object subclass existing creates *key dict preferred attributes along mutablemapping, specialized order aliases*
ecsv	comment definition values enhanced format column starts overrides object character conforms ecsv header separated astropy read file table output line class
parabolic	parabolic sky - projection pixel
circle	spherical within angle certain create formed - patch points central circle representing
columns	set ordereddict columns subclass
plate	plate carrée projection sky - pixel
cube	spherical cube projection sky - pixel cobe base quadrilateralized tangential quad class projections
gaussian2d	dimensional model two gaussian
geocentric	origin requested precessed equinox gcrs defined frame geocentric coordinates ecliptic manner coordinate similar mean
sanson	sanson-flamsteed sky - projection pixel
joint	models parameter share fit
progress	size spinner total bar depending whether display terminal displays progress operation progressbar class either
timing	tables tests object useful contains two api various timing attributes
gaussian2dkernel	2d filter gaussian kernel
itrs	terrestrial reference frame system coordinate international itrs
coord	information providing container description format object name coordinate manipulation meta systems representation interface flexible high-level celestial transformation like
reload	failed operation 'reload'
mercator	sky - pixel mercator
x	binary x tables format
fixed	splitting header single names table defines tables end whitespace ' start self two write width split reader read base based line data class splitter splits column positions lines | fixed col first
kernel	even kernel convolution kernels create list called filter base array class size
set	use set temporary primarily applications may testing cache manager astropy context download path config (though
dump	dialect format dumps tables fits csv ascii pyfits
zenithal	projection zenithal sky - slant pixel base equidistant projections class perspective
frame	classic attribute frame non-mutable relative shape specified frames arbitrary :class oriented collections elliptical units store optionally quantities object objects position hold data class rectangular specific descriptor base match cartesianrepresentation time coordinate attributes ~astropy can't quantity
module	lazy loading urllib_error urllib_request namespace create six moved urllib_robotparser urllib python 3 objects urllib_response resembles urllib_parse moves
num	column indicates numerical data consists
fitsfixed	raised modified standards header compliant warning fits contents
hammer	sky hammer-aitoff - projection pixel
nonstandard	hdu non-standard extension class
record	fits record class
urllib	lazy loading urllib_error urllib_request namespace create six moved urllib_robotparser urllib python 3 objects urllib_response resembles urllib_parse moves
hist	inverse stretch image equalization histogram scaling histeqstretch ~astropy transformation
state	used science manage results global state items affect subclasses
w05	2396 defined attribute uri rfc valid <http //www must
import	indicates reading table present dependency
formatter	fitsheader essentially around joint format tool object convert wrapper class header formatter/locator hdulist file fits table display
model1dkernel	kernel create model 1d
concatenate	concatenate right merge objects np using left
w08	avoid differences number vo local-dependent table parsing
w09	letters name attribute specification identifiers uses uppercase votable unique id specify
parent	info dtype gets parent mixin
missing	accessible raised associated build-time issued argument one indicates warning specified message check indicate cache due supplied instance vo interpolation used parent missing problem standard usually generated cannot configuration needed permissions exception uncertainty catalog value defaults directory accessed ~astropy providing first
w04	2046 use defined attribute syntax rfc mime <http //tools content-type must
comp	hdu compression synchronized image object keep header underlying hdus compressed properly class designed
w06	unified attribute emitted syntax content descriptor ucd warning match
w07	: julian astro field regular year besselian expression matching
w01	cell contains number states complex votable array spec
w02	xml ids ^[a-za-z_][a-za-z0-9_\ regular following : expression match must
w03	says name id 1 vs votable following spec
sip1d	implements sip simple imaging polynomial model 1d
shaped	provide methods class mixin shape-changing
trapezoid	dimensional kernel two 2d trapezoid model circular
ipython	singleton given access etc streams ipython class
carbon	function string current returns key null ascii returned
configuration	raised build-time issued warning file specified due expected type match missing usually generated cannot configuration permissions exception changed value astropy defaults directory accessed problem options
optional	indicates reading table present dependency
uncertainty	implements deviation error unknown uncertainty gaussian standard propagation assuming order type class first
equal	projection zenithal sky area - equal conic cylindrical equidistant pseudoconic bonne's pixel alber's
cache	accessible set testing argument indicates manager warning primarily download message use cache (though temporary may standard applications astropy path context directory providing first
context	modes allows indexing manager context performance improve special intended
hermite1d	hermite kind") 1d polynomials ("physicist's
col	tables coldefs column implementation definitions ascii class
cutout2d	2d create object array cutout
isot	" format mm 8601 sss ss compliant "yyyy-mm-ddthh iso date-time
fitstable	dialect format dumps tables fits csv ascii pyfits
lev	levenberg-marquardt squares least algorithm statistic
point	floating-point blocks parameters point measures base fitness bayesian datatypes class
simple	info elements outputting don't simple require param parsing field base machinery class special validator
fitsdiff	files two hdulist filename objects fits diff
map	coordinate helpers container system represents
loader	core objects tuple python well constructs custom astropy safeloader unicode
header	keep splitting produced underlying hdus looks line tables :class daophot <http list-like columns return around format read convert reader using splitter internally remove fixed commented set sequence exposes diff extract whitespace since comments version routine deluxetable iraf objects compressed interface definition c column starts | base rdb first comment fitsheader //fits character image number header names table given compression start data two fast width basic uncommented engine wrapper tool essentially properly deluxetable_ begins splits keyword ipac csvsplitter headers values display history separated file synchronized tab none, ascii tells dict-like write split commentary used io object hdulist astropy uses designed fits commentedheader class sextractor latex faster autonamed lines without
cxc	00 center seconds tt chandra 1998-01-01 x-ray
chebyshev2d	2d chebyshev kind polynomial 1st
sky2pix	perspective spherical carrée projection zenithal - molleweide's hammer-aitoff sky2pix orthographic pseudoconic projections polar area orthomorphic sky sanson-flamsteed cobe quadrilateralized parabolic airy polyconic pixel plate cube healpix slant "butterfly" cylindrical equidistant class gnomonic bonne's equal conic colles' base tangential mercator aka alber's stereographic
polynomial	chebyshev legendre form parameters models number 2d base arbitrary polynomial polynomial-like class coefficients
diff	one-dimensional image primary header table images diff array imagedatadiff special doesn't assumed two whether unit rawdatadiff though objects (really fits data class case hdu "pixels") extension arrays originally matter base 1-dimensional treated
robotparser	lazy loading six moved urllib_robotparser objects moves
stretch	square 1], image contrastbiasstretch bias alternative array inverse log stretch range 2 transformed transformation contrast asinh return linear power histogram scaling base histeqstretch sinh class takes account [0 equalization convenience classes values ~astropy root called logstretch
voscatalog	represent catalog class service vo
nduncertainty	classes nddata uncertainty metaclass used
json	default support encoder json data types
sharedmethod	name classmethod allows share instancemethod method decorator
basic	acts followed header addressed underlying table end top writer :class wrapper basic ordinary character-delimited handle intended format read reader line data class c lines single
numpy	restore use generator (for random rng number value specific manager seed context numpy statement)
engine	string helper perform help class interpolation
asinh	/stretch)/q independent asinh asinh(q linear brightness stretch preserving - mapping colours estimating zscale minimum x =
moffat2dkernel	2d kernel moffat
linearity	raised non-linear linear fitter passed model
lomb	code compute presented [1]_ implementations lomb-scargle [2]_; based periodogram
func	functions blocks derived overload method following base fitness bayesian classes class
iloc	rather variant order values allowing indexed data retrieval tableloc row
hdu	corrupted stream within requiring image random primary header single hdus file encapsulating table ascii unit binary container non-standard written provides instead files used base compressed groups fits data class entire hdu extension capability table-like classes
exponential	cutoff power exponential one dimensional model law
unscaled	identical doesn't scale format generic part display unit
pix2sky	tangential spherical carrée projection zenithal sky molleweide's hammer-aitoff stereographic orthographic pseudoconic projections polar area orthomorphic - sanson-flamsteed cobe quadrilateralized parabolic airy polyconic pixel plate cube healpix slant "butterfly" cylindrical equidistant class gnomonic bonne's pix2sky equal conic colles' base mercator aka alber's perspective
value	represents small short e comparison big tuple correct purposes value maxvalue needed long supplied opposite allowed infinite representation one type check
rectangular	frame rectangular classic
sesame	specifies resolve name database url web-queryable mechanism sesame default sesame's coordinates using query
optimization	base class optimizers
euler	implements actual rotations base computation angle intrinsic class euler
error	discretization iers whilst deadline inconsistent converting activating xml loading system outside clashes failed valid input logger configspec spec match good handle string format big cannot nesting using parsing minute hour level mode defaults small multiprocessing exists requested related bounds second specified operation violates even index errors section deactivating overlap written future various goes reader reading correct lazy non-linear terms linear doesn't 24) future-related cancelled unrepr base proxy configuration dates constraint determining non-overlapping generated recognized dependency range astropy options missing raised already features build-time one scaled raises another table size kernels given fast occured additional workaround unknown support two specifically custom passed sections function way hub logger-related search repeated part catch line general present partially exception [0 keyword arrays type maximum value supplied 60] converted values client error exceptions called configobj objects exceeded moved vo indicates cone file allowed moves occur incorrect angle __many__ urllib_error verify six depth invalid check setting query units samp parameter interpolation badly used models long wrong involving registry fits class short fitter unit-specific 'reload' time coordinate definitions model validation typically user-specified interpreting
cancelled	cancelled future
loop	depth exceeded maximum string interpolation
helper	control helper :class coordinates one ~astropy class
site	earthlocation objects bare-bones registry
parse	badly lazy loading six moved indicates written objects error urllib_parse line moves
fittable2dmodel	models fittable base class two-dimensional
cone	search asynchronously perform results first general successful returns exception cone query validation class store result
conf	iers visualization samp parameters validator wcsaxes utils vo jsviewer fits astropy votable io nddata table logger configuration data quantity
timezone	tzinfo object ~datetime subclass used
trapezoid1dkernel	trapezoid 1d kernel
ecliptic	origin barycentric geocentric coordinates ecliptic heliocentric
shift	coordinate shift
ascii	tables coldefs implementation similar specifically _columnformat ascii columns
dumper	represents safedumper objects core python tuple well custom astropy unicode
az	frame system coordinates altitude-azimuth coordinate horizontal
hermite2d	2d hermite polynomial
generic	format data frame object can't arbitrary attributes hold "generic" store
sqrt	stretch square root
ogip	files fits guest office programs support investigator ogip units
epoch	represent point julian year floating unit (e 'j2000 support 0 epoch 0' 'b1950 besselian multiple string base 1950 particular class dates like interval value times 2000 time
html	read write html tables
unrecognized	parse allows correctly unit
rngcontext	restore use generator (for random rng number value specific manager seed context numpy statement)
units	raised warnings missing invalid units unit-specific base exceptions class
decibel	parameters db expressed units logarithmic physical
events	unbinned blocks parameters "tick" length binned regular fundamental fitness bayesian data events
interpolation	errors string helper missing perform behaves specified help maximum value two like depth base template exceeded configparser class interpolation
defs	tables coldefs column implementation definitions ascii class
rdb	tables faster extra read starts format rdb definition column :class header 2 version file reader line reading data tab-separated similar
wcs	wcs paper_ table-lookup transformations perform standard objects distortion based sip_ correct
hdulist	hdu object list fits top-level class
sys	coordinate defines coosys_ system element
aastex	tables column <http \startdata \enddata data write deluxetable aastex read names //fits deluxetable_ extract enclosed
user	warning primary astropy class
validate	indicates check failed error
identity	inputs returns unchanged
sextractor	read header produced file sextractor
precessed	requested precessed equinox gcrs defined frame manner coordinate similar mean
scargle	code compute presented [1]_ implementations lomb-scargle [2]_; based periodogram
undefined	undefined value
database	specifies resolve name database default mechanism sesame coordinates using query
inherit	methods metaclass base filled docstrings override makes class automatically
hat2dkernel	2d hat mexican filter kernel
bonne	projection area sky - equal pseudoconic bonne's pixel
coo	coordinate defines coosys_ system element
coordinate	control given helper attribute frame object :class system coordinates one frames base transforms another coordinate ~astropy class
model	incorrect raised used linear non-linear models built-in fitter fitting base algorithms passed using polynomial definitions model metaclass class fitted
fk4	coordinate frame fk4 system
fk5	coordinate frame fk5 system
spherical	spherical projection - within certain sphere tangential unit angle create sky coordinates cobe quadrilateralized convention theta circle pixel 3d phi cube formed (using using representing central patch points azimuth representation inclination physics
true	origin barycentric geocentric coordinates ecliptic heliocentric
iers	handle provided functions b most-recent necessary generic data updated iers targeted downloading values usno provide table defining class automatically interpolation
ndslicing	provide slicing interface objects mixin nddata using
unicode	unicodechar console unicode format utf-16-be data output-only handles formatting pretty using type display characters
slsqplsqfitter	algorithm slsqp least optimization statistic squares
secure	supporting secure xmlrpc server connections sockets
tables	tables tests object useful contains two api various timing attributes
console	console format output-only formatting pretty display
sky	celestial frame relative meta high-level information position container oriented systems flexible transformation match description format rotatecelestial2native object base manipulation interface class name like specific coordinate representation rotatenative2celestial providing
unsigned	unsignedbyte datatype unsigned handles integer 8-bit
param	paramref_ incorrect used remote parameter inside element elements constant-valued passed param_ group_ data columns refer
spinner	size terminal total depending whether display spinner either operation progressbar class displays
location	information container like format attribute frame description coordinates meta location act earth ~astropy earthlocation name
continuation	subsequent lines joined ending continuation_char line inputter
input	incorrect used values definitions input parameter
logger	logging used set class astropy
polynomial1d	polynomial model 1d
ndarithmetic	object add mixin nddata class arithmetic
bin	binary hdu class table
fittable	models built-in fitting base algorithms using class fitted
format	fits time_formats table ascii (just binary adds format carries specifically _columnformat) arrays type columns registries description tables respectively time base (_asciicolumnformat) _columnformat delta variable representations class represents timedeltaformat column metaclass q p length formats timeformat x similar called time_delta_formats
big	big type supplied value correct
flrw	homogeneous describing cosmology friedmann-lemaitre-robertson-walker isotropic class
box2dkernel	2d box filter kernel
integer	datatypes base integral class
bit	bit datatype handles bits array
unique	uniquely specifier object format requiring create time explicit without base formats class
like	used methods provide table-like hdus mixin shape-changing data class
rotate	spherical celestial transform coordinates native
vdt	function requested incorrect big unknown allowed long supplied one needed wrong short value passed type correct small parameter check
e08	actual attribute legal element values either type must
e09	attribute elements min, option always value max must
e06	supported unsignedbyte int double float long short boolean datatypes : bit
sampmsg	function errors returned allows bound maps call decorator grab samp automatically notify
e04	bit '0's array '1's string
e05	case insensitive format tabledata value one boolean following : strings
e02	specifier elements number field specified array data match
e03	separated whitespace two complex values numbers
e01	specifier optionally followed asterisk number char field unicode size must
specific	specific quantities type superclass physical
spine	single axes side
box1d	dimensional box model one
planar2d	dimensional model plane two
samphub	profile exception interaction hub via server simplify client proxy samp class standard
qtable	heterogeneous represent data class tables
smoothly	power smoothly one dimensional broken model law
manual	values user-specified interval based
streaming	file stream requiring capability written provides fits instead data class
table	represent via ordereddict table_ order header optionally hdus inconsistent file diff tables table ascii special row doesn't rows matter rather contains pseudo-list two subclass whether way indexed input set reading columns used binary replaced object variant hdu heterogeneous astropy allowing fits cases data class present convert name extension indicates arrays originally list element dependency table-like base values column indices output warning retrieval tableloc
linear1d	dimensional line model one
server	hub xmlrpc server objects samp serverproxy thread-safe pool
transport	handles transaction xml-rpc https server
cirs	cirs celestial reference frame system intermediate coordinate
rotation2d	given angle perform 2d degrees rotation
scale	dimensional used fits format redshift recognized one scaled units errors multiply scale factor catch model involving
htmlinputter	input html lines valid form
merge	right sources single registers operator two strategy merge_strategies mergestrategy np metaclass metadata concatenate objects registry using class defining merge merging base plus output subclasses left
wcsaxes	wcs used show wcsaxes axes coordinates subclass world main class
overlap	raised arrays determining non-overlapping overlap partially
emconstant	electromagnetic constant
w48	defined attribute specification
masked	use extension column numpy object trivial masked table data define
tophat2dkernel	2d filter tophat kernel
nddata	associated ndarray-based meta functionally defines information container nddata numpy arithmetic used n-dimensional equivalent object mixins base interface using class implements datasets metaclass astropy
celestial2native	spherical celestial transform coordinates native
measures	blocks parameters point measures fitness bayesian
run	predict run class time
power	break inverse exponential power smoothly stretch ~astropy one dimensional broken model law cutoff alternative transformation
legendre1d	polynomial legendre 1d
percentile	keeping based asymmetric interval fraction specified pixels
simplex	neald-mead algorithm least simplex statistic squares downhill [1]
offset	specific oriented frame relative position match
icrs	coordinate icrs frame system
hcrs	frame axes system heliocentric coordinate icrs aligned
obj	configobj files errors read create object write base raises config class
extension	requested raised extension hdu exist user class
constraint	fitter raised type support constraint
column	represent contains associated describe one return header specialized subclass specified keywords table ascii ttype, (just binary properties format specifically _columnformat) tuples dict masked sorts columns define sense tables object use preferred base (_asciicolumnformat) _columnformat fits data class info represents e anything g column makes items() list order specific descriptor astropy formats attributes definition similar called
psfkernel	kernel psf filter instance astropy initialize
plus	right merge objects plus operator using left
dialog	profile web dialogs consent make writing easier base gui class
or	size depending whether progressbar spinner either operation total class displays
cutoff	cutoff power exponential one dimensional model law
discretization	models wrong discretization called goes
sampwarning	astropy warning samp-specific class
redshift	use scale **deprecated**, redshift :class one dimensional redshiftscalefactor factor model
image	synchronized image primary header underlying hdus diff array unit compression assumed two used though object matplotlib properly compressed (really fits data class normalization hdu "pixels") extension arrays keep base designed
float	floating-point handle datatype ieee floatcomplex float handles describes single-precision pair data
bound	bind holds mapping call result signature arguments
locator	joint formatter/locator
url	already exists database url web-queryable invalid vo access catalog sesame's
strategy	right metaclass single metadata strategy sources merging registers merge_strategies registry mergestrategy left output base subclasses class two defining
uncertainties	uncertainties exception used two different indicate classes propagated cases
log	via image number one scaled curved unit physical containing inverse log parameters stretch exception-catching mechanism power indicate units transformation used parabola instantiated scaling astropy ipython law placeholder ~astropy logarithmic logarithm dimensional exception sometimes specific usually representation model subclasses called logstretch
val	simple validator
area	projection zenithal sky area - equal conic cylindrical equidistant pseudoconic bonne's pixel alber's
sampsimple	profile requests handler xmlrpc standard
transform	defined series abstract combining one single-step transforms another specified frames curved constructed paths wcs cartesian matrix graph system coordinates 3 transformed returns transformation function combination object base two world representing class transformations accepts together pixel yields non-affine coordinate x
long	value datatype signed supplied handles long integer type correct 64-bit
custom	kernel default create list encoder filter json array data support types
width	splitting header single names table defines tables end whitespace ' start self two write width split reader read base based line data class splitter splits column positions lines | fixed col first
pool	serverproxy objects xmlrpc thread-safe pool
box1dkernel	box filter 1d kernel
function	defined abstract number scaled unit returns transformed units unitbase transformation function object callable base mixin representing class c makes accepts coordinate representation subclasses
dummy	writeable object noop
epsilon	represents given value version comparisons largest" "next valid
delayed	file-reading data delayed
gaussian	absorption gaussian one dimensional line model
link	documents reference link_ uri used servers elements external
numeric	scalars fixed-length numeric handles base array data class types
solar	ephemerides calculating default positions solar-system bodies
delta	represent days seconds julian delta two times si base 86400 time representations difference class
convergence	used methods numerical divergence and/or error report non-convergence class
line	tables whitespace ' width read lines splitting two write header reader splitter table fixed data first
inverted	inverse image contrastbiasstretch scaling histeqstretch ~astropy transformation logstretch
with	info combines elements outputting don't simple require outlier technique param parsing field fitting base machinery procedure removal class special
loc	rows column pseudo-list values allowing indexed table retrieval
dist	inverse power stretch transformation ~astropy alternative
info	storing portable attribute astropy meta table information use container subclass uniform add ~datetime way dtype tzinfo gets elements description parent format object standard base mixin data class name info pairs key-value like anything column used descriptor classes extensions info_ arbitrary attributes
converter	handles base class subclass converters
temp	use set temporary primarily applications may testing cache manager astropy context download path config (though
default	exception configuration missing default issued use raised build-time class change python generated warning split defaults cosmology : using csv strings columns
access	access url invalid
bounds	bounds raised angle outside user-specified
w31	reading descriptor nan's fields support since value field directly specified represented integer null must
w30	files floating-point "null" non-standard missing ways write values "-" votable
w33	name two field table unique must
w32	fields two field table unique id must
w35	info elements name required value attributes
w34	xml defined attribute value 1 token valid requires
w37	defined specification supported vo 3 votable datatypes
w36	specifies conform given datatype value field null must
w39	raised support upon warning values masking bit
w38	binary base64 encoding data specification supported votable local
flatw	constant energy flrw curvature cosmology dark state spatial equation
constant	constant extension metaclass astronomical :class primary trivial masked physical numpy purpose
int	32-bit int signed datatype handles describes integer data
parser	02 * angle like 30 parses behaves 01 various formats including configparser
moved	lazy loading moved objects
descriptor	body whose use descriptors class "remember" base preserved ordereddescriptor wish attributes classes metaclass order
char	unicodechar 7-bit datatype type unsigned char utf-16-be handles characters data
as	as_completed used
warning	accessible raised via truncated build-time issued argument due assigned unit-specific second warning value file specified table message implemented violates contents previous xml versions cannot primary workaround incompatible inherit verify missing feature indicate compliant minute expected obvious gets numpy spec match 24 string warnings standard usually generated base input fits indicates cases configuration class change permissions 60 made hour header column type changed modified votable_ standards cache length astropy replaced indicating defaults deprecated directory accessed problem providing options soon-to-be first
file	writeable represents entire object votable_ element noop file fits disk file-like
ellipse2d	2d model ellipse
ipyexc	exception used exception-catching mechanism indicate astropy ipython placeholder
kernel2d	2d filter base class kernels
floating	floating-point datatypes base class
moves	lazy loading urllib_error urllib_request namespace create six moved urllib_robotparser urllib python 3 objects urllib_response resembles urllib_parse moves
check	function unknown check requested
vovalidation	exceptions base class validation vo
no	raised set methods number header superclass table none, tells tables autonamed width strtype since overlap numtype write start classes basic uncommented columns engine used read reader divergence and/or uses report using line data class c arrays starts non-overlapping fast column without error determining non-convergence fixed numerical first
eq	inverse stretch image equalization histogram scaling histeqstretch ~astropy transformation
invalid	issued mainly warning file specified __new__ invalid custom access attribute expected type match used astropy configuration class exception url signal value _basehdu validation
field	used remote field_ datatype inside fieldref_ element column describes particular group_ data elements refer
valid	base hdus class corrupted
bool	boolean describes data
molleweide	molleweide's sky - projection pixel
np	concatenate right merge objects np using left
jd	format seconds julian time days si delta date 86400
parabola1d	log parabola sometimes one dimensional power curved model law called
node	binary search tree containing element references key nodes data children
polar	polar projection sky healpix - "butterfly" aka pixel
repeat	__many__ section indicates repeated error sections additional
truncate	string truncated column value assigned length warning base gets numpy class
models	exceptions model base class
native2celestial	spherical celestial transform coordinates native
slant	projection zenithal sky - slant perspective orthographic pixel
chebyshev1d	chebyshev polynomial kind 1d 1st
registry	bare-bones objects enabled manages registry units earthlocation
ndarray	mixin column within storage ndarrays provide allow arbitrary table shape-changing numpy class methods
aitoff	sky hammer-aitoff - projection pixel
sinh	stretch sinh
polynomial2d	2d polynomial model
w0wz	energy flrw curvature cosmology dark state variable equation
interval	computed minimum specified array different based user-specified pixels iraf's fraction return asymmetric base data class keeping interval maximum zscale classes values following called
pseudo	projections pseudoconic base class pseudocylindrical
xmlwriter	xml indented nicely well-formed write class
validator	register 'checks' object allows set validator
time	represent delta midnight datetime ])]" (e like fits tt time_formats 0 input besselian 0' 630720013 string format python sss 1950 integer difference day name plot_date ss[ 1970-01-01 decimal instantiate list "[±y]yyyy-mm-dd[thh chandra 1998-01-01 timeformat date-time specifier frame 8601 library meta year 'j2000 00 container pyplot "yyyy-mm-dd unit 'b1950 metaclass registries "yyyy run seconds respectively matplotlib standard objects ~matplotlib dates day-of-year days times 86400 base iso support first uniquely point requiring thereof timedeltaformat unix manipulate " create two compliant julian gps corresponding quantities realization hh particular utc mm modified value descriptor values formats example x-ray time_delta_formats adds predict attribute floating information si epoch doy ~datetime multiple description sss]][(scale[ object astropy "yyyy-mm-ddthh date representations astronomy class string-like center ss interval explicit 1980-01-06 2000 without time
validation	attribute invalid failed using validation multiprocessing
w0wa	cpl energy flrw curvature cosmology dark state equation
