noverall	database matches top overall library n across connect molecules picking class best build
pyart	set default py face note fontmapping 'times'
similarity	attributes base class important
hierarchy	recap hold used class hiearchy
text	ugly draw used rotated text
saver	little saving parameters default canvas drawing class restoring utility
random	dbfp supporting os random access >>> supplier import supports
dupe	filter based duplicate assumptions canonical-smiles
threshold	used return similarity probe value threshold beyond compounds
ncontainer	elements maintains list number particular sorted data
font	represents style information typeface caches width names demand loads font class size
feat	instantiated one
redirect	file temporarily context stdout descriptors named manager optionally uses another suppress stdout/stderr output redirecting stderr low-level
nscreener	hits top n returns screener found
generator	whose signature - important molecules mol attributes worked
cache	information width names demand loads font caches
grabber	standard put place something need output times
spread	database matches library across connect picking class best
forest	decision unique forest trees
string	stringsegment string segments contains parsed intermediate representation xmlparser class
python	test python various descriptors implementation
matcher	based python - creation allows class filters filtermatcher
db	set usage abstract random back sample result additional away access >>> details fps supplier new molecules supports supporting intended dbmol databases db pickled dbfp forward objects import rdconfig come class interacting fields rdkit iteration supplies many os
clusterer	set based correllation cluster bits class
vect	bv1 vc vectcollection() datastructs >>> =
mol	set usage allows pickled sample minimum result saved additional support molecules supplier supplies supporting dbmol db back forward new come properties must fields rdkit iteration
recap	recap hold used class hiearchy
bit	signatures set based score correllation collection cluster used bitvects bits class store
knnmodel	represent used predictor knnclassificationmodel knnregressionmodel base neighbor k-nearest class
bar	status quit bar clear well buttons displays left mouse button location
h	function hyperbolic tangent standard
pdfdocument	writing responsible whole document linking
htmlpiddler	jjk 02/01/00
stderr	context file temporarily stderr manager another redirecting
output	named dump stdout/stderr manager assumptions something file need low-level suppress nodes smiles optionally descriptors standard base uses put class times dumps place context output redirecting
mldata	set **note** holding general ints data strings floats
picker	database matches top overall library n across connect molecules picking class best build
status	status quit bar clear well buttons displays left mouse button location
set	set **note** ints quantized data random iteration general access holding forward supports strings floats
smiles	supplier smiles sample usage
back	pp made patterson algorithm don't i've back propagation connectivity assumptions implement *think* 153-154
module	lazy loading urllib_error urllib_request namespace create six moved urllib_robotparser urllib python 3 objects urllib_response resembles urllib_parse moves
pdfcanvas	containing methods operators list marking page call accumulating pdf works strings
qcanvas	ugly draw used rotated text
connect	intended many abstract databases details away class interacting
pdfpath	represents graphic certain 'modes' path pdf
canvas	renderers' canvas set format default backends py drawing note base fontmapping 'times' file pdf interface 'plug-in face specialized class low-level plan
network	network neural
sigmoid	function sigmoidal standard
rot	ugly draw used rotated text
factory	sigfactory's relevant creating parameters getsignature() one method used time calling setting
urllib	lazy loading urllib_error urllib_request namespace create six moved urllib_robotparser urllib python 3 objects urllib_response resembles urllib_parse moves
prop	pp made patterson algorithm don't i've back propagation connectivity assumptions implement *think* 153-154
access	dbfp supporting os random access >>> supplier import supports
re	files comment whitespace dealing lines comments convenience blank beginning class
state	little saving parameters default canvas drawing class restoring utility
supplier	random back minimum additional support access >>> fps forward import supporting molecules dbmol dbfp supplier new rdconfig come must fields rdkit iteration os
wxcanvas	status quit bar clear well buttons displays left mouse button location
net	node network neural
run	building set parameters database composite fields results default added class store
pharmacophore	pharmacophore radii explicit locations point
base	backends canvas base specialized class
bayes	_naivebayesclassifier_s accessible functions via composite decision statistics setter/getter **notes** pieces bayesian state internal proxy following using model save standard
pdfliteral	wish quote ready-made one
c	named optionally context descriptors manager uses file suppress stdout/stderr output redirecting low-level
dec	represent used simultaneously decision trees _dectreenode_s branches roots
package	container package composite calculator needing (compounds predictions descriptor objects molecules model class etc
items	lazy loading moved objects
classifier	_naivebayesclassifier_s accessible functions via setter/getter pieces state internal following save standard
filter	smarts creation one assumptions filters associated matching based pattern - duplicate molecules input nodes filtermatcher python base class count allows filter patterns canonical-smiles
act	activation base class" functions "virtual
pdfoutline	nothing null outline yet
mlquant	**note** set data quantized holding
trainer	base class" network trainers "virtual
smarts	count smarts pattern one filter patterns assumptions transforms molecules removing associated atoms matching
classification	signal used problems generating predictions
compound	used central calculating point calculation descriptors descriptor
color	blue represent used color green components class red
vis	visualization viewing stores options cluster
pdftext	independently text separates logically graphics coordinate pdf drawing change systems
pdfcatalog	set requires refpages refoutlines
robotparser	lazy loading six moved urllib_robotparser objects moves
pdfpage	integers bastard set presumes pagelist use list needs standard etc attribute one resources
knnregression	k-nearest represent used classifier neighbor
top	number library connect best top returns build molecules screener across elements matches maintains overall particular sorted picking data class hits database list n found
transform	assumptions filter base input nodes class
params	instantiated one
forward	supporting dbmol >>> rdkit iteration dbfp forward rdconfig supplier import
screener	used return compounds similarity value probe base threshold attributes beyond class important
molecular	descriptors used molecules calculating
composite	building set parameters database composite fields decision statistics results default **notes** added proxy bayesian using model class store
naive	_naivebayesclassifier_s accessible functions via setter/getter pieces state internal following save standard
remover	smarts removing atoms patterns assumptions transforms molecules matching
functor	function added based python global list creates property
func	activation base class" functions "virtual
pscanvas	meant files canvas used inclusion thus generating encapsulated postscript documents eps really
case	test python various descriptors implementation
default	status quit bar clear well buttons displays left mouse button location
tree	represent used simultaneously decision tree trees standard _dectreenode_s branches class roots bog
descriptor	generating used central signal calculating point calculation descriptors abstract problems descriptor base values molecules calculators class
error	lazy loading urllib_error problems signal six moved generating used predictions descriptor objects values moves
property	function added based python allows global list pickled creates molecules rdkit property saved properties
pickle	set db pickled sample objects result usage supplies
fingerprinter	storing fingerprinting run class details
result	forward iteration random supports access
supply	sample smiles set objects supply things assumptions pickled db supplier base result molecules usage supplies nodes class
stdout	file temporarily context stdout manager another redirecting
calculation	generating used signal problems descriptor values
request	lazy loading urllib_request six moved objects moves
calculator	used central calculating point calculation descriptors abstract descriptor base molecules calculators class
moved	lazy loading moved objects
parse	lazy loading six moved objects urllib_parse moves
cluster	storing remarks** class **general clusters/data
pdfstream	used page contents
file	files comment whitespace dealing lines comments convenience blank beginning class
tan	function hyperbolic tangent standard
moves	lazy loading urllib_error urllib_request namespace create six moved urllib_robotparser urllib python 3 objects urllib_response resembles urllib_parse moves
sdsupply	supplier sample usage sd
knnclassification	k-nearest represent used classifier neighbor
six	lazy loading urllib_error urllib_request namespace create six moved urllib_robotparser urllib python 3 objects urllib_response resembles urllib_parse moves
data	**note** set data quantized holding
sig	sigfactory's relevant creating parameters getsignature() one method used time calling setting
details	storing fingerprinting run class details
test	test python various descriptors implementation
ensemble	signatures used collection score bitvects bits store
fp	supporting random additional >>> fields rdkit iteration back access dbfp forward rdconfig os fps import supplier new come
map	instantiated one
node	represent set dump supply pickled library sample assumptions result roots dumps network things decision virtual molecules usage input nodes node smiles used simultaneously hiearchy db trees standard supplier base supplies recap hold class branches neural tree filter objects _dectreenode_s output sd bog
object	represents graphics graphic certain separates independently 'modes' text logically path coordinate pdf drawing change systems
collection	integers bv1 set datastructs vectcollection() presumes pagelist list >>> vc attribute =
segment	stringsegment string segments contains parsed intermediate representation xmlparser class
response	lazy loading six moved objects urllib_response moves
explicit	pharmacophore radii explicit locations point
pdfinfo	info information documents embedded reader acrobat viewable file basic pdf document |
vlib	nodes base library class virtual
pdfobject	precise objects base measurement pdf class
model	represent used container molecules objects package composite calculator needing (compounds predictions class descriptor k-nearest neighbor model classifier etc
opts	visualization viewing stores options cluster
