rejectedexecutionexception	thrown exception task cannot link execution executor accepted
all	implements category dotall mode unicode metacharacter dot
code	code letters point defined uppercase errormanager two currency unicode consists character three converted 'z' u requested string form tested offset 'a' question country directionality points iso error property ua
sci	code false scientific notation engineering true exponential
serializationproxy	used regardless implementation serialize enumset instances type class
iterator	initial iterator providers loader's set arg proper service attributedcharacteriterator sequence add contained lazily empty deque elements collection ascending descending reverse list queue loads order
unmodifiablelist	include
dollar	node end multiline mode input line anchor based
eldest	map recently least accessed entry accessordered inserted
sliceus	node case insensitive sequence literal characters class
month	given saving ending daylight time date month starting
invocationhandler	code instance handler invocation invocationhandler proxy interface implemented
abstractset	set implementation skeletal required minimize provides interface implement effort class
prefix	applied generating used string file's three least methods prefix native long characters wrapped must name
slicenode	slice nodes base class
deadline	epoch time milliseconds wait absolute
missingformatargumentexception	thrown specifier exception corresponding format index argument exist refers unchecked
annotationformaterror	thrown determines malformed read parser class attempts file annotation
httpcookie	represents http information object state agent server carries cookie user httpcookie
follow	redirects http whether boolean follow indicating
abstractqueuedsynchronizer	rely semaphores queues framework firstinfirstout implementing etc related synchronizers locks fifo provides events blocking wait
saved	saving rules number standard daylight milliseconds time respect effect advanced
localized	nonlocalized pattern chars appended characters contain true localized otherwise
row	cell number current state row physical
compact	put cmpchararray number
stringbuilder	mutable object reference characters sequence
tz	used zone fields time mask calculations offset bit specify
system	useful methods fields contains system several class
zone	given zone default use time new strings
threadmxbean	management java thread object system virtual machine link interface threadmxbean
base64	methods arrays translating base static encoded byte strings viceversa
to	exclusive set stringbuffer sublist high code specified returned index appended formatted keys text copied size final filled map object string returning buffer searched included sorted bit removed true endpoint last flip value element range time view
bufferedwriter	stream provide text writes writing efficient single characters characteroutput arrays buffering strings
swap	rule swapping se value asian
nativelibrary	library denotes instance inner nativelibrary loaded class native
weakreference	prevent made finalizable reference finalized reclaimed weak referents objects
responsecache	systemwide represents urlconnection implementations responsecache caches
tc	int bitset value
linkedhashset	set hash implementation iteration list order predictable interface table linked
digit	convert character number
random	generate used stream pseudorandom instance numbers class
string	code splitting month manager manages query children localized zone environment tail suite include indicating linetermination string lowercase memorytype tostring existing servlet schemespecific list applicable fewer cookie occurrence zero implemented port returned canonical even unavailable specification current userinformation version new method full cookie's never component objects operating hashtable address represented path appears every changed delimiter resulting weekday mime named followed tokenizer requiring boolean names zip destination thread's next memory type flag normalized known substring none thread values era root example def understable nearest compare prompt stream fragment attribute inaccessible synchronizer currency allowed absolute information end charset machine pathname native map nonlocalized description replacing typed variant collection catalog date data response short third element specifying representation object's fullyqualified usascii including blocked member style group uuid jit pathname's skipped descriptive matches matcher qualified association matched represents name fully directories level token node's found domain conventions newchar throwable naming array owns network space content may contained internet denoted newly localization derived given nth reason subsequences collation byte hrefhttpjava language created filter length iso leading hexadecimal first encoding number owned one erroneous long reached message guess management exists unknown system annotation needed returns userinfo white scheme store exactly part copy representing serializable biginteger double humanreadable subsequence determined historical false argument raw null contents conversion realm also switching argument's trace object cipher termination class url request uri radix text datetime substituting xml execution based parameters title implementation failed constant urlconnection notation cannot compiler resource settings fields consisting architecture set computed reference locale relative edition result calendar exponent managing pattern formatted state classes closed subarray available parent missing key interface c triggers country equal connection separator context requests expression otherwise comment point simple guaranteed header table allocated java source attributedcharacteriterator it's create three defined literal semaphore empty optionally present expanded single value n compile invoking error property anchor protcol backing ip concatenation encountered parse id binary containing generic hostname check shorter rules authentication incorrectly octal http keys upon running user characters buffer's stack undefined ampm builder well without flags basenbsp entry protocol oldchar actions underlying unicode integer captured previous unique console instance character unsigned requestor location input logger match gmt vendor around format read possible possibly preference using bit accepted mod identifying translated output security decimal replacement specifier sequence uppercase authority specified matching describing bigdecimal notification unmatched equivalent enum host offset emits lock obj socket package ids regular constructor primitive contains float appropriate references log hex textual width files decoded form denoting cloned library encoded line removed true info modifiers default eventobject record converted latch display associated scanner platformdependent int abstract general char engineering exist file trailing operation constructed compared boot detail virtual field valid node elements symbol bundle variable pool time directory strings
filenotfoundexception	attempt signals failed pathname file specified denoted open
bufferedinputstream	reset adds ability bufferedinputstream support mark buffer functionality another streamnamely input methods
clonenotsupportedexception	thrown called clone object class indicate cloneable interface implement object's method
void	code java keyword reference representing void object destroyed thread uninstantiable already hold placeholder class
classdefinition	block parameter class serves instrumentation
csize	set compressed size
synchronizedlist	include
bindexception	socket attempting bind address occurred signals error local port
memorytype	memorypoolmxbean link pool memory pools type types
filewriter	files convenience character class writing
fac	desired factory
exact	immediately return equal masks
filepermission	access represents directory class file
condition	code methods give notifyall objectnotify waitsets implementations notify combining use monitor factors distinct per objectwait instance lock new multiple object effect objects link condition wait arbitrary objectnotifyall
putfield	programmatic provide fields objectoutput persistent access written
annotatedelement	represents annotated currently vm element running program
sliceis	node case insensitive sequence supplementary literal including characters class
objectoutputstream.putfield	putfield fields holds serializable instance class
level	control logger's set messages one message null parsed defines index compression logged current new nodes red used pushlevel may standard levels e class log logging level identifiers tree value output
eventdispatchthread	thread notification event queue placed single background events delivers monitors
permits	release acquire number permits
list	iterator rotated typesafe produced httpcookie loading chain candidate memorymanagermxbean there's swap logger immutable sent arguments return string unmodifiable execution resource name composelist list server memorypoolmxbean view subset cookies sequence locale elements specified n builder's network currently formatted sequential consisting filled never objects threads interface taking range empty place cookie tasks within header associated array given java certificate create strings bundles copies program passed wrapped uris store registered commenced known line representing locales interfaceaddresss server's formatting match formats ordered synchronized process dynamically argument messageformat parsed returned containing shuffled virtual machine also take completed used http object collection garbagecollectormxbean proxies task futures uri element searched order
socketpermissioncollection	key ip init'd else cname wildcard wild card string
illegalargumentexception	thrown inappropriate illegal argument indicate passed method
p	received compare made incoming permission object request packet connection datagrampacket place proxy data check sent
optionaldataexception	exception belonging end stream read data object due failure serialized operation unread primitive indicating
vector	implements code growable objects vector array class
delegate	sub field notified fields locations fieldposition implementation adjust fielddelegate arguments beginend match
pipedoutputstream	stream create pipe communications connected input output piped
nodechangelistener	node listener preference receiving events change
inet6address	represents object protocol created ip address raw version ipv internet inetaddress class
unmodifiableclassexception	thrown implementation link java
evt	node describing parent object child event change
dir	working process inherit subprocess current file directory found null
the	slot waiting
concurrentlinkedqueue	based threadsafe unbounded queue linkplain nodes linked
objectstreamconstants	serialization written object stream constants
fence	past index search last one
socketaddress	point represents endpoint protocol socket reprensenting local end bound yet socketaddress connected attachment address remote null representing class proxy
socksconsts	implementation used protocol socks constants
ze	entry written zipjar file zip
reentrantlock	mutual code statements exclusion using lock reentrant methods synchronized link capabilities behavior basic accessed extended implicit semantics monitor
sync	control reentrantreadwritelock implementation lock countdownlatch synchronization base semaphore futuretask
dontcarefieldposition	fielddelegate noop dontcarefieldposition defines
sign	providing parameter result sign
scheduledexecutorservice	scheduled commands scheduledexecutorservice run thread schedule created given delay instance link execute executor newly executorservice periodically pool
nonfairsync	locks version nonfair sync object
zero	identical considered regarded distinct true otherwise
concurrenthashmap.segment	segment
unixdot	node dotall enabled metacharacter unix_lines class dot
query	url query part
threadlocalholdcounter	threadlocal subclass
unmodifiableset	include
classloadingmxbean	loading java object system virtual machine management link interface classloadingmxbean class
port	requested remote socket connection number machine host connect protocol port
append	string returning buffer stringbuffer appended formatted time text
index	accommodated exclusive set iterator inclusive beginning within searching replace high code value unicode specified listiterator array levels index use cleared end seq position pattern point character next char start converted call low skip units new nodes method filled subarray begin return returned sorted format checking modify object component search collection argument desired endpoint offset interface integer bit removed inserted insert sublist backwards last level ending represent list flip remove element range vector values searched following entry first
unmodifiableentryset	need addition unmodifiableset class map
addr	search bind remote network host ip site requesting port raw authentication address known inetaddress byte null order authorization socket
syncfailedexception	signals failed operation sync
writelock	lock link returned reentrantreadwritelockwritelock method
handlelist	simple integer handles list growable
unmodifiablesortedset	include
current	array string thread waiting
mbeanserver	mbeanserver registered mxbeans called platform time method first
version	use java implementation specification version protocolversion
new	size code associated key iterator less locale text number month symbols zero decimalformatsymbols formatter file specified calendar null description shown scale bigdecimal zone stamp pattern scan character mark priority state vector fraction new set analyze weekday used returned format may matcher formats use desired strength pushlevel offset date integer copy class reference log digits short thread object default level see value element filter length minimum era time successor original strings
net	specifies defer set group leave link specified interface multicastsocketsetinterfaceinetaddress null local multicastsocketsetnetworkinterfacenetworkinterface
retention	retained annotated long indicates type annotations
rejectedexecutionhandler	cannot tasks handler current executed link threadpoolexecutor
method	declared code methods issued single stored specified corresponding array null matching information invoked compression parameters access instance provides incorrectly entered local method http string matches typed public object objects proxy anonymous interface immediately representing class logging name default request element underlying either deflated parametertypes enclosing otherwise
urlstreamhandlerfactory	protocol stream handlers url factory interface defines
can	transformer's transformations retransformed
redirect	new property value
concurrentskiplistset	set based implementation shallow scalable concurrent link concurrentskiplistmap navigableset copy
hash	code hash key
suppresswarnings	named elements annotated warnings element indicates contained program suppressed compiler
bufferedreader	reading stream provide text lines characterinput reads efficient characters arrays buffering
internalerror	thrown unexpected java occurred virtual machine indicate internal error
executor	execute task tasks attempting implementation object submitted underlying executes executor link runnable
component	code type object component new array representing class
len	code int back append use inserted uncompressed write written input skipped read chars update number compressed characters subarray data class received b bytes maximum length specifying push
hours	value hour
desired	locale desired given version string
protection	domain protectiondomain protection defined redefined class
threads	threads number pool
hashtable	implements keys maps values hashtable class
address	remote socket ip socketaddress host connect address inetaddress
enumconstantnotpresentexception	thrown contains constant name enum access application tries specified type
path	node whose return name url component host preference file existence path checked
dateformatprovider	java service providers provide abstract implementations concrete link class
datagramchannel	associated socket created datagram null channel
digits	digits total converted fractional
datainput	binary primitive java stream bytes datainput reconstructing provides interface reading data types
modifier	member code methods access decode modifiers static provides modifier class constants
simpletimezone	represents use simpletimezone zone subclass concrete gregorian time timezone calendar
divisor	code bigdecimal divided value remainder computed
ahead	may preserving number mark read limit characters still
handlers	output logger's true parent sent
checksum	interface data representing value checksum
k	position fill
illegalaccesserror	thrown field modify access application attempts call method
usecaches	whether caching boolean allow indicating
queue	elements processing collection queue prior designed holding
pack200.unpacker	engine newly unpacker allocated
amount	added add signed field amount time date calendar
multicast	join address
abstractsequentiallist	backed linked implementation skeletal required list data access minimize sequential provides interface implement effort class store
action	action run privileged
unmodifiablerandomaccesslist	include
atomicreference	may updated object reference atomically
prolog	handle recursive loop sets quantifier structure
stackoverflowerror	thrown recurses occurs application deeply overflow stack
checkedcollection	include
executorcompletionservice	execute tasks completionservice supplied uses executor link
sliceu	node unicode_case_insensitivebmponly sequence literal characters class
submap	operations represent submap exists treemap underlying concurrentskiplistmap previous mappings sake support class maps returned releases link serialization navigablemap compatibility subrange submaps solely
tasks	tasks collection
regularenumset	implementation enum private sized regular enumset class types
inputmismatchexception	thrown scanner retrieved range indicate token pattern expected type match
sockettimeoutexception	socket read occurred accept signals timeout
pushbackreader	stream characterstream allows back pushed characters reader
socketpermission	represents via network class access sockets
timezonenameprovider	java zone service providers provide abstract link names time class localized
instantiationerror	thrown use java abstract instantiate construct application tries interface new class
delayqueue	delay elements unbounded delayed element queue linkplain taken expired blocking blockingqueue
objectoutput	dataoutput writing objectoutput objects extends interface include
decimalformatsymbols	represents set format decimal desired instance decimalformat symbols needed decimalformatsymbols separator numbers copy class grouping
emptyset	include
comparableusingcomparator	represents comparable comparator key
dictionarybasedbreakiterator	rulebasedbreakiterator use algorithm adds ability dictionary text subdivide possible subclass ranges statetablebased using beyond
cacheentry	represents cache entry
slicei	node sequence case_insensitivebmponly literal characters class
unit	ignored code blocks parameters desired determining never argument initialdelay delay sourceduration interpret timeout time timeunit parameter method unit result
regex	delimiting regular expression string matched
executable	operations execute false permission disallow access allow sets true
nullpointerexception	thrown case use required object application attempts null
from	code inclusive sublist set specified index start initial checking low copied filled map returned keys included sorted bit removed true search endpoint flip value element range searched first view
certificate	none certificate url object jar connection points objects file entry null otherwise
singletonset	include
pred	predecessor status node's holding
readable	source readable characters
negative	identical considered regarded number value negative distinct boolean whether true indicating otherwise
perm	requested specified permission
breakiteratorgetter	implementation instance breakiterator obtains breakiteratorprovider
mso	maxsecorder value
nosuchfielderror	thrown longer field object modify access application tries specified
handler	exports http takes handlers registered object messages handler cookie new logging logger null array unset log
protocolexception	thrown protocol tcp indicate underlying error
saddr	connection host socket accept address
msg	descriptive may catalog key message null string
iaddr	inetaddress
proxyselector	systemwide use referenced resource network url server connecting proxy proxyselector selects
cachekeyreference	cachekey get loaderreference bundlereference common interface
type	upper declared code constant represent programming declaration entity interface set superclass array requesting hold java represented class member field authentication implemented arguments new type method superinterface object return returned interfaces enum component exception objects proxy key element variable copy representing permitted types formal thrown represents lower actual language parameter list bounds value server underlying common order
milliseconds	time local day milliseconds standard
runnableadapter	runs task given callable returns result
rulebasedbreakiterator	whose rules list subclass behavior specified using breakiterator
deque	deque ends linear collection element insertion removal supports
normalizer	normalize composed sorting provides form text equivalent decomposed searching method easier transforms unicode class allowing
adler32	used compute stream checksum adler data class
completionservice	tasks consumption service decouples completed results production asynchronous new
on	enable false socket whether tcp_nodelay instruction feature disable tracing true option
arithmeticexception	thrown occurred condition arithmetic exceptional
serializablepermission	permissions class serializable
inherited	indicates type annotation automatically inherited
portunreachableexception	received signals datagram connected unreachable message icmp port
ctype	node matches posix class type
emptystackexception	thrown methods stack indicate class empty
unknownserviceexception	thrown exception service unknown occurred indicate
flag	process recognize possible comments ignore indicates flag flags logical cstyle true
cookiepolicy	cookies rejected cookiepolicy implementations decide accepted
futuretask	cancellable asynchronous computation
objectoutputstream	primitive outputstream objectoutputstream writes graphs objects java data types
hashmap	map hash implementation interface table based
chararraywriter	implements used buffer writer character class
abstractexecutorservice	executorservice methods default implementations link provides execution
endpoint	ip address number socketaddress bind port
word	index accommodated
g	added group thread specified
mc	use context
f	code float number scaled whose assumed two current field new node returned power printed signum successor obj floatingpoint ulp modified value converted starting
dest	data destination list position array starting
atomicboolean	updated code may value boolean atomically
nosuchmethodexception	thrown found cannot method particular
atomicinteger	updated code int value may atomically
spec	specification version vendor title
slices	node case sequence supplementary sensitive literal including characters class
augend	code added bigdecimal value
mxbean	name within platform connection mxbean proxy forward implemented interface
patternsyntaxexception	thrown exception pattern regularexpression syntax indicate error unchecked
era	date given era
v	rfc short int double specification float value netscape char written boolean cookie long byte original comply
basecalendar	date use calendarsystem specified
interfaceaddress	interface represents address class network
simpleentry	entry value key maintaining
def	node default long associated returned int double array float value interpreted backing cannot preference key byte inaccessible event store
stringtokenizer	tokens string tokenizer allows break application class
control	control information loading resource process bundle resourcebundle used expiration gives
f1	float dividend compare code first
f2	float second code divisor compare
zipentry	represent given used jarentry name zip zipentry entries object next created file found entry null class
prompt	realm string authentication user prompt identifies
stream	udp false socket stream tcp boolean value new input property true
socketexception	thrown accessing creating indicate error socket
process	process object subprocess managing link new runtime runtimeexecstringstringfile processbuilderstart
attribute	requested used whose keys attribute value identify key text attributes defines
thread.state	state thread's thread
datagramsocketimplfactory	socket factory implementations datagram interface defines
instantiationexception	thrown code instantiated instance newinstance create object method application tries cannot specified using class
packer	engine zip transformations stream compressor packer jar highly compressible various file applies gzip input pack making
ids	array ids thread
high	tested code value highsurrogate
currency	code letters locale uppercase number currency consists null u given three instance 'z' new used format 'a' represents country decimal iso ua
threadlocal	variables threadlocal class provides
minimum	desired minimum capacity
retransform	transformer's transformations retransformed
cloneable	implements java indicate link cloneable interface class
interruptedioexception	signals operation interrupted io
garbagecollectormxbean	management java garbage collection machine virtual interface
threadlocalmap	map hash thread threadlocalmap customized values suitable local maintaining
listiterator	traverse elements iterator sequence iteration allows list direction lists obtain current empty modify either specified proper position programmer starting listiterator iterator's
idn	domain methods ace normal unicode internationalized convert idns compatible names provides representation ascii encoding
digitlist	digit list
enc	href supported name
end	dayofweek exclusive saving wall within searching month daylight index end field appended character subsequence start copying input local milliseconds node ends buffer stop offset ending day case last clock range time following anchor
synchronousqueue.transferstack.snode	node cancelled matched
filepermissioncollection	permissions set stores filepermission filepermissioncollection
bnms	supplementary support version bnm
ascii	implements c ctype standard functionality class utility
dateformat	languageindependent dates dateformat abstract time parses datetime formatting manner formats date formatter subclasses class
checkedentry	map setvalue backing prevents illbehaved purposes serves two method client protects wrapper modifying class shortcircuiting
descendingiterator	listitr via provide adapter iterators descending
roundingmode	specifies operations given code corresponding numberformat capable rounding numerical precision object decimalformat discarding setting used value behavior integer roundingmode
delay	task one delay next executed time termination execution commencement milliseconds first
retentionpolicy	policy annotation retention
atomicmarkablereference	updated code reference maintains object mark atomically atomicmarkablereference along bit
csq	subsequence appended character append sequence
tarray	array objects copy thread
accessibleobject	objects class field base constructor method accessibleobject
map	filenamemap cookies set synchronized map backing request dynamically general stacktraceelement header style names specified table locale null builder's defined information containing management system field contained properties environment maps state keyvalue immutable store charactermapping collator's corresponding trace keys object mapping lists unmodifiable process cookie entries variable typesafe response represents thread stack fields array list value manifest headers connection values display view
printwriter	prints printwriter associated stream writer formatted console objects textoutput representations
privilegedthreadfactory	control thread factory loader access context class capturing
deflateroutputstream	implements compression stream format deflate compressing filter output data class
deprecated	dangerous annotated exists programmers deprecated one better program discouraged using alternative element typically
xmlformatter	xml standard logrecord format
may	task complete thread interrupted executing tasks allowed inprogress true otherwise
max	trace dumped maximum number entries stack
multiplicand	multiplied code bigdecimal value
after	dayofweek enddayofweek true rule endday first selects dayofmonth
variant	variant string
collection	map sorted synchronized hierarchy dynamically collection unmodifiable contained values key specified interface threads typesafe root order ascending view
rbclassloader	classloader wrapper
succ	expected current new successor
datagrampacket	represents class packet datagram
fd	systemdependent descriptor file filedescriptor date fixed
date	period month date year null parsed millisecond given compared zone cutover since formatted class start input milliseconds gmt digit string found object style precision gregoriancalendar gregorian offset represented instant years representing day represents last january calculated value specific formatting time representation fixed could two first
zipexception	signals sort exception occurred zip
zstreamref	z_stream zlib's structure reference native
data	string character send parsed currency array data byte
response	map returned header fields cache lists response field values names null representing immutable unset
types	array parameter
defaultthreadfactory	default factory thread
a	set rounded locale argument one char stored integer return array determined allocated returned code whose given angle long enough cosine deepcontentbased new absolute type filled week deque elements hash string big collection authenticator tested base tangent purpose backed sorted sine data floatingpoint contentbased equality compute double list radians value queue arc vector searched representation runtime otherwise
ambiguous	return ambiguousyear may true upon readjusted twodigit year need parameter parsed
short	radix primitive code copy stream truncated named address number numeric month padded prefix stored value file specified scanned range array tertiary row subnet wraps compared bigdecimal instance two next cell field state zeros holding nm indexed new type float required string reversing read object component containing obtain conversion input represented bit interpreted representing class secondary obtained short swapping element's argument double decimal transition bytes signed original equivalently length converted weekday strings
abstractqueuedlongsynchronizer.node	predecessor new node's node wait
filehandler	simple handler logging file
element	index object returned enum format stored pattern within inserted element high set inclusive low specified position endpoint type class
sb	compare code target buffer stringbuffer append string
angdeg	degrees angle
first	set executed table null initial next instance new node map run nonnull initially contain atom condition searches none task thread value element queue time entry first
queueingfuture	futuretask enqueue upon extension completion
order	returned value element collation next order previous
securecacheresponse	tls represents secure means retrieved originally cache response
securitymanager	established already returned application allows class current applications manager policy implement null security otherwise
blocker	thread synchronization responsible object parking
abstractpreferences	node unremoved task preferences exists implementation skeletal named children implementing link greatly provides child known easing null class
dateformatsymbols	week days time zone instance format months dateformatsymbols datetime symbols public formatting names encapsulating date data class localizable
symbols	format symbols desired decimalformatsymbols time date new
coll	whose maximum collection element minimum determined
unmodifiablesortedmap	include
ttl	packet use set default int send maximum value try hops live multicast timetolive specifying time optional numbers
unmodifiablecollection	include
itr	iterator underlying array index subsequent next version call forward node return returned optimized arrayblockingqueue abstractlist copy queue element q item snapshot works
descendingsubmap	include
lf	skipped true 'n' next
member	information identifying member field single constructor interface method reflects
style	applied given short string style long one all_styles formatting link either time date representation display names
group	index group matcher's capturing pattern
uuid	represents identifier uuid immutable value class randomly generated code specified array unique universally
runnablescheduledfuture	execute task callable runnable link scheduledfuture
lo	index element subtree first
cookiehandler	systemwide management http hook implementation object set mechanism cookiehandler return callback state handler cookie currently provides policy protocol means null
filechannel	associated stream file output input channel
managementfactory	managed getting managementfactory factory platform beans java class
cacheresponse	available represent retrieving cache channels instance cacheresponse null responsecache resources otherwise
jaroutputstream	used stream jar write jaroutputstream file output class contents
socketinputstream	fileinputstream implement extends stream socketinputstream
xmlutils	load xml used properties aid save class
pcl	listener add preference change
genericsignatureformaterror	thrown information needs generic attribute constructor encountered syntactically malformed signature reflective type method interpret
policy	policy cookie
checkedmap	include
treeset	implementation navigableset link treemap based
hashiterator	hasnext reference disappearance avoid next needed key strong
errormanager	logging handlers process handler errormanager attached objects error occur
return	came packet address
backingstoreexception	thrown preferences failure backing could indicate contact operation store complete
memorynotificationinfo	information memorynotificationinfo notification object cd memory represented null otherwise
item	item nonnull exchange
bmpcharproperty	version never satisfied supplementary optimized charproperty characters works properties
atomicintegerarray	updated code int may elements atomically array
allowuserinteraction	new value
mutablebiginteger	big holds magnitude mutablebiginteger endian order
enummap	map use shallow implementation type enum keys link copy specialized
interrupt	task complete thread interrupted executing tasks allowed inprogress true otherwise
arrayblockingqueue	queue bounded linkplain backed array blocking blockingqueue
documented	default type javadoc indicates tools documented similar annotations
filteroutputstream	filter classes streams superclass output class
day	dayofweek ends saving dayinmonth starts given month daylight time date ending starting day
holdcounter	read hold counter perthread counts
socketchannel	null associated socket channel created
name	status set constant defined attribute within system relative header resourcebundle variable platform file specified localize null parsed binary java opened zip source specification jar assertion localizing serializable machine field mxbean unicodeblock msg new logger virtual method attributes node queried updated used return string name localization may retrieved whose desired search bundle forward expected jarzip base preference internal child interface path data class environment network known toplevel resource look thread package default fully messages value connection qualified form expiration entry property names
randomaccessfile	support random writing access instances file reading class
parameter	array parameter
simpleformatter	format readable brief summary logrecord human print
l	value java long listener printed null event linkplain
locked	locked dump synchronizers ownable true monitors
illegalstateexception	invoked inappropriate illegal signals time method
magnitude	providing parameter result magnitude
mode	node combination defined o_ rounding decomposition flags mode new apply constants
timeout	ignored lock nanoseconds number zero minimum sleep specified unit giving long write call aborts units parameter method milliseconds used blocks read max never wait maximum value timeout time
toffset	looking begin string
consolehandler	publishes records handler log system
illegalformatconversionexception	thrown specifier exception corresponding format incompatible argument type unchecked
notbehind	width zero negative lookbehind
em	new errormanager
flgs	contractflags hash sequences character value contracting characters participate table
domain	domain protectiondomain protection defined redefined class
cmd	command system specified
outputstreamwriter	bridge outputstreamwriter java bytes specified character written streams characters using link encoded byte
eh	use object exception thread's handler uncaught
printstream	various adds printstream stream values namely functionality another representations print output conveniently data ability
generation	represented generation use barrier instance
groupref	expression regular group recursive reference
stringreader	whose character string stream source
atomicintegerfieldupdaterimpl	implementation using intrinsics hotspot standard
inflater	compression support zlib library general decompression purpose provides popular using class
simpledateformat	dates localesensitive parsing concrete formatting manner simpledateformat class
stacktraceelement	pertaining frame one stacktraceelement throwable array null monitor available elements returned trace represents object objects link representing stack throwablegetstacktrace locked thread element
fieldreflector	retrieving batch serializable field setting values class
expect	expected value
parseexception	signals reached unexpectedly parsing error
year	saving number daylight year need calendar parsed given twodigit parameter indicating return ambiguousyear may upon normalized date true bce value etc readjusted starting
classdataslot	given described form serialized data descriptor portion allotted object's representing class
patternentry	requested pattern normalizing patterns merging collation entry class utility
objectinputstream	primitive objectoutputstream objectinputstream previously written objects deserializes using data
checkedsortedset	include
message	may raw message null string
httpurlconnection	urlconnection httpspecific support features
out	outputstream localize stream fields object write jaroutputstream new output data
category	node matches category class unicode
bitsieve	prime used simple number candidates finding bit sieve
elementtype	program type element
noroutetohostexception	remote socket attempting address occurred signals connect error port
space	n spacing around puts entries
rounding	rounding apply mode
dst	saving rules dst offset number standard daylight milliseconds time respect effect copy data array advanced
req	server requesting authentication proxy entity type
factory	use creating thread factory creates threads executor new
day1	date fixed period day first
preferencechangeevent	node added preferences emitted value indicate preference changed removed event
entrypair	building contracting used character tables
rulebasedcollator	datadriven simple subclass concrete collator rulebasedcollator provides table class
gzipinputstream	implements stream format filter compressed file gzip reading data class
rel	or'ed gt combination lt relation eq
reader	associated abstract character streams reader console reading class
okey	key
rm	rounding integer convert legacy mode
lastnode	implements node classic addition occurred accept check see input using method match
ref	url internal reference
illegalformatcodepointexception	thrown exception code passed point defined character invalid link unicode characterisvalidcodepoint formatter unchecked
red	nodes red level
eofexception	unexpectedly end stream signals file input reached
breakiteratorprovider	java service providers provide abstract implementations concrete link class
breakdictionary	represents used dictionarybasedbreakiterator list words known class
dictionary	dictionary parent keys abstract maps values hashtable class
hashset	implements set hash hashmap instance actually backed interface table class
parameterizedtype	represents parameterizedtype type collectionltstringgt parameterized
args	code specifiers containing referenced string takes format used instance objects values arguments passed invocation call array null interface method proxy
eventlistener	associated extend interfaces listener proxy interface event tagging must
enumset	defined use set implementation copy enum containing element initially range elements link two specified endpoints specialized types
base	code value given sealed resource name package fully bundle java source resourcebundle qualified link expiration base specified respect null class
cookie	object question remove httpcookie cookie policy
proxy	code methods dynamic socks instances static superclass http invoked also instance setting provides invocation type method return creating handler proxy address class represents socket created classes typically
deqiterator	index returned subsequent next call element
e5	initially contain set another element
e4	initially contain set another element
byte	code primitive interpreted padded radix ttl wraps field character send input string read none obtain cannot preference bit decimal bytes eightbit output accessible truncated numeric directionality specified bigdecimal current new component key address represented byte receive range named extra float array doesn't transform next zeros type wellformed copy representing biginteger b default double signed converted property def result associated stream ip argument resultant char raw scanned exist performed file null contents containing compared nm length instance timetolive holding indexed node used buffer object conversion value entry data class required representation two'scomplement original
fieldreflectorkey	cache lookup key fieldreflector
e1	initially contain set element
e3	initially contain set another element
e2	initially contain set another element
thrown	throwable message associated log
cachekey	cached bundles used resource key
logging	implementation logging class loggingmxbean
netif	test interface null done networkinterface
thread	code owned executing owner null constructed creates use create currently factory longestwaiting program new creating rejected threads execution wait thread request queue executor queued first
concurrenthashmap	supporting full hash retrievals adjustable updates concurrency expected table
abstractitr	iterators base class linkedblockingdeque
timer	tasks thread schedule facility future threads background execution
filter	control provided used beyond log may object logged filename filter provide levels grain file null fine
envp	current settings subprocess namevalue format inherit element environment process variable array null strings
length	biginteger used returned bitlength number packet desired length set buffer file copied new array copy data receive elements andor
formatflagsconversionmismatchexception	thrown exception incompatible conversion flag unchecked
pathname	tested abstract compared pathname
unknownformatconversionexception	thrown exception unknown given unchecked conversion
w	worker
currencynamegetter	implementation currency obtains currencynameprovider localized names
timed	timed operation true timeout wait
enumsetiterator	elements word returned iterator set current vector bit representing yet
getfieldimpl	default getfield implementation
checkedlist	include
invalidobjectexception	one tests failed deserialized indicates objects validation
user	url username password part userinfo
doinput	new value
typevariable	superinterface represent declared code typevariable generic variables objects common declaration kinds array type
suffix	case generating used name file's may file null type string suffix
encoding	supported character name encoding
fieldposition	prefix used resulting format fieldposition fields formatted simple fieldpositions identify positive output array subclasses class
concurrentmodificationexception	thrown exception methods may object concurrent detected permissible modification
number	int abstract float number parse superclass null parsed fails bigdecimal formatted long new string format line substituted integer byte representing class biginteger short double value classes specifying
referencequeue	reference garbage changes queues appended detected reachability appropriate objects collector registered
one	interrupt worker true one
hook	hook remove
exceptionininitializererror	exception unexpected occurred initializer signals static
another	compare compared string double float character long short code date calendar byte
validationlist	prioritized graph object list deserialized callbacks completely performed
owner	everybody execute owner's permission applies true otherwise
array	code java provides get arrays dynamically access create static components array copied class methods
clazz	class
decimalformatsymbolsgetter	decimalformatsymbolsprovider instance decimalformatsymbols obtains implementation
unixdollar	node end lines unix multiline mode input line anchor based
inet4address	represents protocol address version ipv internet class
size	ignored set number zero uncompressed size even send indicate new parameter core buffer object desired threads stack pool thread receive bytes maximum keep idle vector
threadfactory	current thread object factory creates threads demand new
atomiclongarray	updated code may long elements atomically array
seq	code sequence char instance values unicode charsequence units
service	interface abstract representing class service
width	output written minimum number characters
serversocketchannel	associated socket created serversocket null channel
fmt	href described string format
rbcollationtables	static used tables routines contains state various collation rulebasedcollator class
toomanylistenersexception	case unicast exception used java multicast toomanylistenersexception annotate source part implement model event special
weekdays	new short weekday strings
annotation	represent characteristics represented extended directly specified array null parameters wrapper class method types text type annotations used corresponding object else declaration interface annotation present formal attribute element's arrays value element common constructor order
priority	priority set thread
navigablesubmap	include
groupcurly	style deterministic maximum curlybrace handles minimum occurrences specified cases repetition
params	array entered method parameters
countdownlatch	operations set allows one synchronization threads performed aid completes wait
sockethandler	simple handler logging network
japaneseimperialcalendar	implements system supported numbering japanese imperial erabased japaneseimperialcalendar era year meiji calendar
white	n spacing around puts entries
scheme	authentication scheme
bits	primitive code methods arrays random long ordering bigendian values packingunpacking using integer byte bits inout utility
hashentry	entry concurrenthashmap list
mimetype	content type handler mime desired
synchronizedsortedset	include
notserializableexception	thrown instance required interface serializable
that	compared object uri check collator filepermission
pipedinputstream	stream bytes whatever written connected provides output input data piped
completed	exception worker due died user
illegalformatexception	thrown specifier exception string format illegal contains given syntax arguments incompatible unchecked
copieslist	include
cacherequest	storing represents cacherequest cached channels recording responsecache response resources
holder	array one least size
serializable	implementing enabled class serializability java
copyonwritearraylist	link variant threadsafe java
unpacker	engine stream jar converts file unpacker packed
datagramsocket	represents socket sending packets datagram receiving class
distance	distance rotate list
biginteger	code final ^ scanned ~n specified array element size gcdabsthis whose bigdecimal val bitlength initial two meantime big_ten_powers_table probably gets bits immutable bigintegers greater arbitraryprecision ~val absval input integer absthis remainder thisexponent prime integers biginteger ~this unscaled expanded value n lesser converted mod quotient | first
b	code stream int back pushed single boolean another array whose use exponent opaque anchoring make destination uncompressed class write read written converted indexed input indicating dictionary buffer argument component update decompress printed new byte data transparent received biginteger loworder whether checksum bytes bounds value regions push output compressed
privilegedcallableusingcurrentclassloader	control established runs settings classloader access callable current
target	sequence locale tryterminate sublist char indicates shutdown kinds terminated use compared source state program replaced gets type method run string securitypermission buffer rulebasedcollationkey whose object stop bundle desired characters tidying annotation name search resource target read list applicable element collationkey values either called
behinds	positive supplementary width zero surrogates including characters unpaired lookbehind
double	logarithms code less primitive interpreted padded wraps number instance point distributed coordinates underflow degrees scalefactor input cube string read obtain cannot preference theta integer bit pseudorandom bytes radians magnitude x mean mathematical square xnbspnbsp truncated gaussian numeric sign arc result measurement acode lnnbspcode closer returned bigdecimal pattern smallest xnbspy new available component base tangent key represented intermediate sqrtxnbspy sine remainder holding floatingpoint limits larger equal times range load named rnbsptheta angrad float corresponds negative smaller array size cartesian log hyperbolic positive system next start cosine zeros type function direction lncode signum e overflow copy representing logarithm biginteger b f double ulp value ecode converted root def associated stream specified argument scanned exist file greater containing compared angle divided length field adjacent largest indexed absolute node polar infinity closest object uniformly conversion eight class natural average required without angdeg normally original
unmodifiablemap	include
enabled	disabled belonging subpackages false package default classloader enabled named loader henceforth classes assertions initialized loaded true class
dataoutput	binary primitive java stream series bytes dataoutput writing provides interface converting data types
headers	map returned header fields request lists response current field values names representing immutable headers
r	requested executed thread previously completed task stored instance runnable new array elements replete
param1	entered parameter method
softreference	reference garbage collector demand objects discretion memory cleared soft response
blockdatainputstream	inputs see modes stream format default bracketed object two markers written mode dataoutputstream input serialization data specification block details
stale	slot index searching encountered key known entry stale null first
scheduledfuture	result cancel null extract completion whose method pending used return get upon delayed action representing throw exception task resultbearing cancelled scheduledfuture cancellation
integer	wraps code string int representing object primitive value argument instance radix holding specified represented integer property type class nm
fileoutputstream	stream writing file filedescriptor output data
filenamemap	filenamemap map provides simple mechanism mime file interface type string name
rbtablebuilder	code object pattern contains rbcollationtables parse rulebasedcollator build class
linkedlist	implementation interface list linked
longoverflow	biginteger equal long
seal	given code java package source link sealed respect null
pri	priority new group thread
argument	index use format argument new
loaderreference	garbage nobody weak loaders references collected using else class
illegalthreadstateexception	thrown requested thread state indicate appropriate operation
seed	initial seed
locksupport	creating thread locks synchronization basic primitives classes blocking
reversecomparator2	include
wildcardtype	represents code super expression number wildcardtype extends wildcard integer type
inputstreamreader	bridge java characters bytes character reads streams decodes specified link using byte inputstreamreader
any	argument
inflaterinputstream	implements uncompressing stream format deflate filter data class compression
abstractstringbuilder	mutable object reference characters sequence
latency	latency int relative importance low expressing
strength	new strength value
qnode	node transferqueue class
min	desired minimum capacity
filereader	files convenience reading character class
synchronizers	locked synchronizers true dump ownable
membersignature	signatures fieldconstructormethod computing calculation caching class serialversionuid
kkey	key
stringindexoutofboundsexception	thrown index string negative greater indicate either size methods
uncaughtexceptionhandler	exception invoked thread handlers due terminates interface uncaught abruptly
numberformatprovider	java service providers provide abstract implementations concrete link class
urisyntaxexception	thrown exception checked string reference could uri indicate parsed
abstractplainsocketimpl	default implementation socket
notbehinds	negative supplementary width zero surrogates including characters unpaired lookbehind
illegalclassformatexception	thrown implementation link java
flags	modify format flags output
propertypermissioncollection	propertypermission set stores propertypermissioncollection permissions
objectinput	reading datainput objects extends interface include objectinput
copyonwritearrayset	java link
streamcorruptedexception	thrown control stream information read object checks internal consistency violates
begin	node index begin inclusive dst character start range copying offset input beginning anchor first
ins	read properties stream
maddr	address group used internet
trace	throwable elements associated stack trace
buffer	appended string lost format buffer scratch input affix modify formatted value modified current file stringbuffer contains byte must class contents receiver
datagramsocketimpl	datagramsocket socket instance implementation abstract attached datagramsocketimpl datagram multicast base new class
object	default code iterator less hierarchy blocker truncated obtain padded elapses previous current removed parameters field alternate environment failed tail according invocation encapsulates compiler match resolved return string dateformat read possibly front bit execution matched represents name success header interrupt list comprising operation item token vector node's timeout mapped found security isn't declared set old computed reference sequence simpledateformat cancel result specified proper stack manifest compilerspecific message returned index represent numberformat trimmed highest currently content initially waiting new newly order method available args dictionary deleted implementationdependent interfaces never component substituted cookie hashtable key element represented refers suggested received last thread created arraylist nulls equal deserialized queue length plus constructor zerolength distinguish first named tasks fetched nonnull previously number one pair appropriate obj thread's another marker array size given log ordering top contains due least next casting dispatching returns handler checks wrapped annotation type empty rulebasedbreakiterator deque head corresponding option initial sufficient shallow occurred else failure calling child e hole copy representing present absent none comparator checking caller iteration maximum value serialized classes replaced behavior formats cancelled primitive property root called lowest compare later associated linkedlist stream defined attribute argument signers interrupted threadlocal minimum cloneable timezone null parsed contents greater information containing perform range enumeration event member instance indexed node map elements http enum provided clone object mapping collection timed entry date newlyconstructed cleared inserted class types they're implements natural url values required messageformat contenthandler loader keyvalue greatest time position allocated original proxy
throwable	raised exceptionininitializererror reference superclass throwable operation null saved terminated errors java unknown instance cause may undeclared object nonexistent loading checked class thrown exception target language error exceptions
singleu	case given insensitive matches character unicode
cmdarray	call array command containing arguments
callable	function execute task may object exception submitted callable returns result throw
singlei	case given insensitive matches character bmp
deflater	compression support zlib library general purpose provides popular using class
propagate	tryacquireshared return value
position	keeps returned field track text within desired position input alignment string
threadinfo	alive cd synchronizer exist array null id information given monitor live input corresponding trace whose object containing threadinfo objects link represented stack info locked thread ids element threads otherwise
formattableflags	formattable fomattableflags link formattableformatto passed
subset	represent set subsets character instances unicode particular class
future	one asynchronous result computation specified null completion whose given next waiting method pending return get completed upon elapses representing present represents none task value future time
segment	hash segments specialized tables versions
class	represent code issued underlying immediately whose field assertion source jvm return get exception qualified mismatched using execution represented desc queried represents name identifying fully public redefined enclosing referred redefine set protectiondomain member superclass specified stack implemented instance cast specification subclass method missing interfaces enum component desired objects proxy members interface optional thrown logging created retransform resulting constructor zerolength runtime load declared loader instances names loaded array occurrence java class constant's type corresponding triggered representing serializable none package descriptor classes retransformed constant nonsystem defined argument null containing form virtual machine application internal parameter status may declaring object toplevel running data annotation types recent implements request element initiating
cbuf	buffer destination character back read written characters push array data
stringcharacteriterator	implements protocol stringcharacteriterator characteriterator string
collationrules	building tables default contains collationrules rules base en_us collation
runnable	case whose runnable intended thread instances worker null decremented submitted executed interface task exit wrapped workercount implemented class must
numberformat	generalpurpose numberformat format abstract percent number datetime currency base values formats integer formatter uses class
arraystoreexception	thrown made attempt object indicate wrong objects array type store
url	code caused locator file world null pointer constructed web loading java field privileges get jar uniform source authentication invoker adequate reading doesn't resources wide equivalent object urlconnection's link path representing class represents search resource url could uri value requesting connection classes urls found
classloader	occurrence nonsystem defined loader delegation represented loaded null loading responsible system class method parent object interface using stack recent none thread classloader classes context
request	map header request lists current field values names representing headers
uri	cookies associated reference relativized resulting accept equal file query parsed absolute whose network field representing send uniform instance policy new scheme abstract resolved requested used string form normal fragment equivalent hierarchical cookie authority consult path come represents resource undefined url required request uri connection pathname specifying components serverbased identifier
sortedset	toelement exclusive fromelement synchronized inclusive dynamically typesafe set specified total whose ordering strictly less portion provides elements greater unmodifiable link sorted equal range view
nosuchfieldexception	doesn't name signals field specified class
securityexception	thrown indicate security manager violation
exp	affix expanded corresponding positiveprefix
neg	width zero negative lookahead
synchronizedsortedmap	include
operatingsystemmxbean	management java object system virtual machine running operating interface link operatingsystemmxbean
charsequence	string sequence specified readable subsequence char generated values charsequence input matcher's
serviceloader	loading service facility simple serviceprovider loader new
dot	node dotall enabled metacharacter class dot
threadpoolexecutor	task threads methods executors configured factory submitted one possibly pooled executes link using executorservice normally several
callerrunspolicy	code case runs tasks unless thread execute rejected task discarded handler directly executor shut calling method
radix	code scanning use radix string int long value short token used numbers representation parsing interpret interpreting
jarentry	represent given used name jarentry url object jar next connection points file found entry entries null class
objectstreamexception	stream object specific classes superclass exceptions
prio	default good callbackszero order controls
unsupportedclassversionerror	thrown major java read supported virtual machine attempts version numbers file determines class minor
text	containing string iterator scan characters text source part iterated time test new analyze parsed
affix	affix corresponding may pattern expanded positiveprefix posprefixpattern null
priorityqueue	queue based unbounded priority linkplain heap
nosuchmethoderror	thrown definition longer instance class application tries call either specified static method
threshold	threshold new bytes value
pack200.packer	packer engine newly allocated
d2	double second code compare
runnablefuture	callable given runnable run underlying callable's yield task runnablefuture provide future link value call cancellation result
d1	double compare code first
slot	slot index location heuristic heavily cache lessen searching cas'ed encountered padding effects key known entry stale null atomicreference first
zipinputstream	implements files zip stream format filter file input reading class
parameters	message log parameters
title	implementation specification title
memorymanagermxbean	interface manager management memory
buf	set buffer packet read written characters byte data array
grouptail	group grouptail successfully locations ending handles setting groups beginning matched
cache	creation resource look cache specified bundle manages time key entries policy based null response unset
linkedblockingqueue	based linked queue linkplain optionallybounded nodes blocking blockingqueue
behind	width zero lookbehind positive
socketimpl	socketimpl sockets abstract attached actually instance serversocket classes superclass new implement class common
timezone	associated understood daylight specified saving calendar null id given zone parsed timezone also newly gmt dateformat object cannot offset represents created default savings figures time
only	everybody execute owner's permission worker one applies interrupt true otherwise
datainputstream	primitive java machineindependent stream read application lets underlying way input data types
objectinputstream.getfield	getfield fields object persistent deserialized representing
factor	code used scale power f
override	intended indicates superclass declaration override method
classfiletransformer	files implementation transform agent class provides interface order
dateformatgetter	dateformatprovider instance obtains implementation dateformat
peekinputstream	operations peek stream supporting singlebyte input
info	url username password part userinfo
urlconnection	represent urlconnection application url abstract object communications classes link superclass class
filterwriter	abstract character writing streams filtered class
undeclaredthrowableexception	declared code invocationhandlerinvoke runtimeexception clause handler's throwable invoked checked instance handler invocation method invoke dispatched link proxy types thrown assignable exception error throws
handletable	handle wire hash mappings integer unsynchronized object well tracks ascending assigned maps handles objects lightweight classnotfoundexceptions table associated deserialized order identity
permission	urlconnection necessary permission make object connection add represented representing
replacetable	hash maps objects lightweight table identity replacement
readwritelock	operations associated readwritelock maintains one locks readonly link lock pair writing
zipfile	used zip read file entries class
unsupportedoperationexception	thrown indicate operation supported requested
xmlsupport	xml support java
listener	invoked removed object propertychange listener changed property
tbl	collator's contractingcharacter value expandingcharacter table expandtable contracttable
exchanger	pairs elements point within synchronization threads swap pair
abstractplaindatagramsocketimpl	socket implementation abstract datagram multicast base class
dooutput	new value
during	saving rules number standard daylight milliseconds time respect effect advanced
breakiterator	implements break word methods iterator sentence text breaks line boundaries location finding breakiterator class character
urldecoder	decoding html class form utility
synchronizedset	include
compiler	provided code javatonativecode support related services compilers class compiler
authenticator.requestortype	requestor authentication type
resolve	resolve true class
resource	used name localizing messages resourcebundle logger
abstractqueuedsynchronizer.node	predecessor new node's node wait
h	insert head target use value handler hashtable null
bytes	byte random bytes array fill
linenumberinputstream	current keeping added stream track number filter functionality provides input line class
invalidclassexception	thrown runtime problems one following serialization detects class
typenotpresentexception	thrown definition string found representing access application tries specified type's using type name
crc	crc value
objectstreamfield	containing null description named object persistent serializable field objectstreamfield array element class
redefined	load redefine triggered retransform redefined retransformed null class
abortpolicy	code rejectedexecutionexception tasks rejected handler throws
duplicateformatflagsexception	thrown provided exception format duplicate flags specifier unchecked
x	code raise int float number char boolean computation mathcontext array returned whose compared bigdecimal hyperbolic long cosine print string chars object tangent printed sine xnbsp exponent insert biginteger e abscissa double value ecode item coordinate
fixed	digits last maximumdigits maximum period converted fractional date representation fixed true day first
nodeaddedevent	used knows thread nodechangeevents whether childremoved two dispatch classes call eventqueue distinguish event childadded
caches	audit descriptors cache mapping subclass results classes security local
set	redirects code synchronized list dynamically typesafe backed resourcebundle set including specified follow elements containing mappings contains bundles contained duplicate intersect immutable indicating available map currencies http identitybased parent keys object collection ascending bitset key corresponding sorted bit unmodifiable enum whether mask value order default boolean identitymappings property strings view
protectiondomain	protectiondomain class
reference	available within reference blocking becomes abstract object specified period value one base objects timeout immediately expected new null class otherwise
abstractownablesynchronizer	synchronizer may thread owned exclusively
locale	available requested supply locale installed currency resourcebundle decimalformatsymbols names specified loaded array null calendar localized string whose given java numberformat instance provide localization political dateformatsymbols virtual machine comparing subformats geographical provider new transformation week applied used creating dateformat instantiated object use bundle desired cultural objects rules service scanner's breakiterator data needed locales case represents search resource name instances default country region collator value specific expiration representation fallback display otherwise
objectinputvalidation	graph within callback objects allow interface validation
nibble	convert nibble
packet	received
up	field rolled value indicates specified calendar
mathcontext	numerical bigdecimal settings rules certain operators describe class objects link context implemented encapsulate immutable
resourcebundle	locale one resourcebundle null given cache bundles instance call localespecific someone returned parent localization may bundle objects put expired locales none cachekey resource name default could cached base contain found
arraydeque	deque resizablearray implementation link interface copy
chunklen	write chunk bytes number
result	object return returned text appended result
arg	represent object like anything notifyobservers acquire argument value tryacquireshared conveyed link uninterpreted release passed method otherwise
calendar	set constant methods abstract month year converting calendar compared next field provides manipulating new associated formatter week used format link date datetime class instant hour getting fields day_of_month specific time
headindex	track nodes keep heading level
writeabortedexception	thrown write one signals objectstreamexceptions operation
privateentryiterator	iterators base class treemap
rqst	map string field request lists current header values names representing method headers
error	application error problems subclass try indicates serious value reasonable new catch throwable property
capacity	desired minimum capacity
exponent	exponent
urlclassloader	load files search used referring directories jar loader classes resulting urls path class resources
runtime	current java application object allows running environment instance single every interface associated runtime class
pattern	domain nonnull scan skip within messageformat visible see used message null description regex containing pattern create properties arguments compiled new empty take added string form format may matcher possibly regular cookie representation date scanner's class search delimiting name composelist taking created list according rfc formatting specifying time posprefixpattern expression
transferer	queues stacks api dual shared internal
cowsublist	copyonwritearraylist sublist
strictmath	operations performing functions code methods exponential contains trigonometric numeric logarithm square basic elementary root class strictmath
filename	load file
state	terminated use thread tryterminate stop value desired state either shutdown tidying new
classes	requested java types array class indicating
genericarraytype	represents code whose component parameterized either variable genericarraytype type array
props	new system properties
runtimemxbean	management java object system virtual machine link interface runtimemxbean runtime
inflateroutputstream	implements uncompressing stream format deflate filter stored output data compression
formatter	use formatter printfstyle may support format logrecords formatting link provides interpreter null strings
conditionobject	serving basis implementation lock abstractqueuedsynchronizer link abstractqueuedlongsynchronizer condition
comparable	implements objects ordering imposes interface total class
str	substring search compared end string concatenated chars appended bytes uri char written characters array parsed character
parent	value logger's bundle's parent bundle loader delegation thread's output true class sent
assertionstatusdirectives	status c enable package assertion collection p disable directives assertions class
dateformat.field	field calendarfield representing instance
comp	element determine comparator maximum
interfaces	interfaces list deserialized descriptor proxy interface implement class names
checkedinputstream	stream read checksum maintains also input data
phantomreference	phantom determines reference reclaimed may enqueued referents objects collector otherwise
conditionalspecialcasing	class string utility
bitset	implements code grows needed range vector bitset new bits class
key	exclusive code associated presence int request float high thread specified array string whose needs hold cache form attributedcharacteriterator inclusive system long low type node map returned dictionary keys object mapping bundle possible tested hashtable key known resource byte removed permitted name endpoint e look keyword desired double list value local placed searched property preference
invocationtargetexception	thrown exception invoked checked wraps constructor invocationtargetexception method
interface	interface mxbean implemented proxy
logmanager	loggers used set log logmanager global state object single maintain services shared
annotationtypemismatchexception	thrown whose serialized attempted changed element access indicate program compiled type annotation
collationelementiterator	used string iterator class character walk international collationelementiterator
objectstreamclass	fields read describes serialization's serializable descriptor classes specified class
abruptly	exception worker due died user
mcastaddr	leave multicast join address
observable	represents observable modelview object paradigm data class
c	contractflags set hash int question sequences back char pushed added participate table array null append inserted code whose containing checked representing character enumeration field written handler indexed new ordered collator's elements http returned enum component collection unmodifiable cookie printed characters contractingcharacter initialize obj bit removed data class retained comparator contracting list modified value queue converted specifying containment link view unset contracttable
transferqueue	queue dual
curly	style maximum curlybrace handles minimum occurrences specified repetition
limits	top contains value ascending formatand want sorted order parsed
indexoutofboundsexception	thrown sort string index indicate range vector array
country	code letters string form country two ua iso uppercase 'a' u 'z'
cookiemanager	cookies surrounding implementation cookiemanager storage rejecting cookiehandler concrete link provides separates policy accepting
unmodifiableentry	map setvalue backing prevents illbehaved purposes serves two method client protects wrapper modifying class shortcircuiting
constructor	declared code constructors single underlying specified array null information access provides local public matches object objects anonymous immediately representing class parameter list constructor enclosing parametertypes otherwise
gzipoutputstream	implements stream format writing filter compressed file gzip data class
connection	use short int mbeanserverconnection relative importance connection expressing time forward
ioexception	sort thrown exception last exists readable occurred signals io scanner's appendable null
threadlocal.threadlocalmap	bindings map containing inheritable parent's
urls	search classes resources urls
attributes	associated attribute names file specified null jar maps main added string object attributes class none name url manifest connection points values entry otherwise
cyclicbarrier	set barrier point reach allows synchronization threads common aid wait
treemap	redblack based implementation tree link navigablemap
col	dictionary means column character number cell input physical
checkedset	include
comment	comment string
choiceformat	choiceformat format allows attach range numbers
socketoutputstream	socketoutputstream implement extends fileoutputstream stream
ch	code point text char contracting directionality unicode parsed whose pattern character mirrored field interested we're new requested string tested date column value token converted property starting
unicodeblock	blocks family subsets specification character unicode representing
cl	get custom annotate descriptor proxy test data class
buildapi	private constructor
cb	buffer read characters
serialcallbackcontext	readobjectwriteobject methods stream object upcalls context classdefined
nosuchelementexception	thrown elements nextelement enumeration indicate method
pos	fieldposition text zero array alignment index described source positive destination formatted field input information object origpos desired data lookahead identifying parseposition error position starting width
loader	load bootstrap loader null whose use system transformed provider defining define files used returned initiated may bundle proxy class resource classloader failing list classes providerconfiguration
formattable	specifier needs java perform conversion custom formatting link 's' interface using implemented formattable class must
header	header setcookie string specifying
lastmatch	node ended last location match
filterinputstream	additional stream possibly transforming contains source filterinputstream uses way basic input along providing data functionality
classcastexception	thrown instance code cast attempted object subclass indicate
shutdown	containing virtualmachine packageprivate data sequence governing shutdown logic structures class utility
ioerror	thrown serious occurred io error
cs	compare code string sequence
iterable	target object allows implementing foreach statement interface
orig	origpos
caret	node line beginning anchor
delegatedexecutorservice	methods implementation wrapper exposes executorservice class
codesigner	entry none codesigner null objects
submapiter	traverse variant iter submaps main class
linkedblockingdeque	deque based linked linkplain optionallybounded nodes blocking blockingdeque
preferencesfactory	preferences object factory objects generates
reentrantreadwritelock	supporting implementation readwritelock reentrantlock link similar semantics
stamp	expected stamp value new
unsatisfiedlinkerror	thrown definition declared java virtual method machine nativelanguage appropriate cannot find native
grouphead	begins group restores grouphead saves done location match locals
jarinputstream	used stream jarinputstream read jar file input class contents
lockinfo	information ownable locked thread lock synchronizers object otherwise waiting objects lockinfo array null representing blocked
strategy	new compression strategy
malformedurlexception	thrown indicate url malformed occurred
getfield	stream provide fields persistent access read input
reduction	number remove permits
timertask	scheduled task timer onetime repeated execution
semaphore	counting semaphore
expected	expected stamp reference value mark
inheritablethreadlocal	inheritable initial thread parent inheritance provide variables created threadlocal values receives child extends class
missingresourceexception	signals resource missing
dataoutputstream	primitive java portable stream write application lets way output data types
decimalformat	numberformat decimal subclass concrete numbers formats decimalformat
pipedwriter	characteroutput streams piped
gregoriancalendar	used system subclass standard concrete provides world calendar gregoriancalendar
listitr	optimized version abstractlist
direction	neighbors code start's value start indicating returned
enable	use enable false objects parameter object disable deserialized enabling boolean resolveobject every true replacement
negativearraysizeexception	thrown create negative application tries array size
memoryusage	unused recycling cd effort null constructed java notification memoryusage virtual machine valid memory usage method supported recently object nonheap objects link peak heap represented representing pool represents snapshot expended otherwise
synchronousqueue	insert corresponding versa thread vice remove wait queue linkplain another operation must blocking blockingqueue
pushbackinputstream	adds ability stream pushbackinputstream back one namely functionality another push input byte unread
precision	output written maximum characters number
bytearrayinputstream	stream buffer contains bytes bytearrayinputstream may internal read
serversocket	implements sockets class server
deleteonexithook	set deleted holds vm filenames hook exit shutdown class
invalidpropertiesformatexception	thrown conform complete xml could collection indicate appropriate link per specification input operation document type properties
socketoptions	interface getset options methods socket
netpermission	permissions various class network
abstractmap.simpleimmutableentry	entry fitting null relation new
c2	collection
c1	collection
f2ary	frenchsecondary flag frenchsec value
brokenbarrierexception	thrown exception enters barrier thread waiting upon state broken tries wait
scheduledfuturetask	break ties number fifo sequence
exception	exception want form application conditions indicates reasonable catch throwable subclasses class might
currencynameprovider	java service providers provide abstract display symbols currency link names class localized
genericdeclaration	declared generic variables entities variable common declaration interface type declare
urlc	url connection
comparator	set elements specified null code total ordering function map comparable used keys collection objects uses interface sorted comparison natural reverse comparator according queue imposes implement order
unscaled	code bigdecimal value unscaled
inetaddress	protocol addresses ip socket's bound raw manager array null operation given unbound network checkconnect it's machine field internet inetaddress local method sent either available inetadress used received object site broadcast host connected address interface representing class name represents unresolved remote socket created packets value requesting datagram multicast authorization allow security
threadgroup	represents set group thread parent instantiated threadgroup thread's threads new
value	set associated verbose less boolean attribute table number zero minimum specified false calendar null returned code whose shown copy parent zone attributedcharacteriterator disabling presence precision system thread's current field future fraction expected new parameter possible map used corresponding option form indexed may initial enable component given else tested disable hashtable key output finalization integer hold true permitted string floatingpoint digits socket default type threadlocal value double enabling stored indicating time entry property
n	control code ten point skip move number cells set logn unless null elements index raise scan list pool test boundary bits inheritdoc node skipped return returned power bound possibly threads characters found bit logtable reference bigdecimal case distance places shift decimal bytes flip n random scanned entry stale clear left
dateformatsymbolsprovider	java service providers provide abstract instances link class
rulebasedcollationkey	implementation concrete collationkey rulebasedcollationkey class
blockingdeque	operations deque storing retrieving nonempty space available element link additionally become supports blocking wait
notactiveexception	thrown serialization active deserialization
formats	use returned resourcebundle limit want formats new
descendingitr	descending linkedblockingdeque iterator
timeoutexception	thrown exception blocking operation times
arraylist	containing elements resizablearray returned implementation list enumeration specified interface array include
loop	count handles repetition curly greedy
sockssocketimpl	socket implementation tcp rfc socks v
illegalformatprecisionexception	thrown exception support negative value precision unsupported otherwise unchecked conversion
verifyerror	thrown sort contains though formed well problem verifier internal file security detects class inconsistency
reflectaccess	implementing sun class packageprivate
is	xml stream read objectinput regarded object number value negative whether boolean positive input document true indicating
it	inprogress collection iterator
networkinterface	obtained represents made addresses name index ip currently list networkinterface assigned null multicast scoped specified interface set attached class address network
ctry	country code
emptylist	include
eras	new era strings
in	xml restore stream jarinputstream read object inputstream file localize input document data order jarfile
decimalformatsymbolsprovider	java service providers provide abstract instances link class
enumerator	enumerator hashtable class
submapiterator	iterators submaps
bindpoint	socketaddress bind
id	given option zone new custom field thread form time integer identifies id string
if	specifies defer set specified executing tasks allowed null group multicastsocketsetinterfaceinetaddress local complete link interface inprogress true task thread interrupted leave multicastsocketsetnetworkinterfacenetworkinterface otherwise
principal	principal server sent server's
urlencoder	encoding html class form utility
flushable	flushed destination data flushable
abstractcollection	implementation skeletal required collection minimize provides interface implement effort class
atomicintegerfieldupdater	utility code int fields reflectionbased designated classes volatile atomic updater enables updates
executors	methods threadfactory defined scheduledexecutorservice factory package callable classes link executor executorservice utility
millis	saving number daylight sleep respect event given zone since millis epoch new local milliseconds gmt rules effect standard base offset day advanced utc length time
s	set stream sequence int dynamically serialize printstream typesafe manager code integer array parsed append returned containing synchronized written long decode waiting wrapped new match node printwriter string read chars enum component use unmodifiable indexed printed output initialize sorted byte accepted search short socket literalized bytes value connection boolean translated representation security view
enumeration	subset series bound one dictionary resourcebundle including file specified table java network zip subinterfaces bundles enumeration machine contained logger empty propertypermission elements generates parent keys components object collection objects link hashtable entries interface filepermission implements resource name inetaddresses default list socketpermission vector values urls time found property strings networkinterfaces
ziperror	signals occurred unrecoverable error
zipoutputstream	implements files zip stream format writing filter file output class
writer	stream abstract writer character writing streams output class
periodic	false task true delayed periodic
arguments	array objects formatted substituted
matcher	engine operations java matcher link performs pattern new match
unknownerror	thrown exception java unknown occurred virtual machine serious
streamhandler	logging handler based stream
lenient	lenient true parsing
composition	composelist used take arguments
checkedrandomaccesslist	include
status	status useful returned inputoutput ignore exit termination parameter
classnotfoundexception	thrown load forname string method application tries using class name
noclassdeffounderror	thrown load java creating definition found could classloader normal virtual method machine instance tries part call using new expression class
context	security systemdependent context
instrumentation	code java language instrument programming needed provides services class
codesource	codesource
nif	interface must associated address
snode	node transferstacks class
illegalformatwidthexception	thrown exception format negative value width unsupported unchecked otherwise
passwordauthentication	provided none used data null one authenticator passwordauthentication user gotten collected usernamepassword holder class can't
running	task complete thread interrupted executing tasks allowed inprogress true otherwise
purpose	comment string url user display specifying
fileinputstream	bytes system obtains file input fileinputstream
localenameprovider	java service providers provide abstract link names class localized
stack	lastinfirstout ignored elements associated thread trace indicate lifo class desired zero objects represents new throwable parameter stack size
weakhashmap	implementation map keys hashtablebased weak
illegalformatflagsexception	thrown exception combination illegal given flags unchecked
unsupportedencodingexception	supported character encoding
task	scheduled none task run thread created execute submit callable runnable remove new null first
off	storing code int within back array destination character writing start written input reading characters offset data class b taking bytes specifying push starting first
i	code swapped int one table index long field inetaddress key's hash string object new printed position known integer hold obj modified value element converted entry stale
permissioncollection	storing socketpermissions filepermissions permissioncollection granted object codesource propertypermissions new suitable permissions
sortedmap	exclusive synchronized inclusive dynamically typesafe specified total option whose ordering strictly less range provides map greater keys unmodifiable link key sorted association portion tokey equal fromkey values property strings view
httpretryexception	thrown needs http streaming enabled request due indicate cannot mode retried automatically
recurse	group thread whether recursively also flag threads groups enumerate included include indicating subgroups
messageformat	way means languageneutral concatenated messages messageformat produce provides
dateformatsymbolsgetter	implementation instance dateformatsymbolsprovider obtains dateformatsymbols
lport	local port
illegalaccessexception	thrown field set executing invoke instance illegalaccessexception create get method access application tries constructor currently specified array definition class reflectively
loggingmxbean	management logging facility object link loggingmxbean interface
incompleteannotationexception	thrown definition added serialized attempted element access indicate program compiled type annotation
command	execute task string list containing system program command arguments specified array runnable
filesystem	abstraction packageprivate abstract filesystem local class
y	ordinate coordinate value
entry	list collision threadlocal file table special zip properties field internal new weakreference main ref linkedhashmap node map hash extend object hashtable key entries pair using class represents casing always tree creates keyvalue entry
tclass	field objects class holding
backref	expression refers group regular
stringwriter	used string stream buffer writer character construct output collects
filedescriptor	represents used associated socket stream datagram object socket's system value descriptor connection fd fileoutputstream file filedescriptor field representing
load	put loaded cache bundle time
redirects	redirects http whether boolean follow indicating
matchresult	last matcher matchresult state result operation match
protocol	use protocol name requesting connection link java that's
processbuilder	builder processes used process create system operating class
atomicreferencearray	updated elements may object atomically references array
being	load redefine triggered retransform redefined retransformed null class
cowiterator	array snapshot
executionexception	thrown exception task retrieve attempting throwing result aborted
blockdataoutputstream	buffered modes stream format default outputs bracketed object two markers see mode dataoutputstream output serialization data specification block details
rest	initially elements set remaining contain
ascendingsubmap	include
nanos	additional max nanoseconds number value maximum range sleep timeout time timed wait
chararrayreader	implements used stream buffer character characterinput class
bandwidth	high int relative importance bandwidth expressing
reversecomparator	include
synchronizedcollection	include
bytearrayoutputstream	implements stream array written output byte data class
stringbufferinputstream	string stream read bytes create allows supplied application input class contents
appendable	destination reference appended object char values sequences output appendable
managementpermission	code java methods calls permission securitymanager defined running management platform interface check
transformer	transformer unregister register wraps prefix using classfiletransformer
abstractmap	map implementation skeletal required minimize provides interface implement effort class
console	current associated methods java system virtual access device machine characterbased console null otherwise
listresourcebundle	use listresourcebundle locale convenient abstract list subclass resourcebundle manages easy resources
readlock	lock link returned reentrantreadwritelockreadlock method
atomicreferencefieldupdater	utility code reference fields reflectionbased designated classes volatile atomic updater enables updates
point	digits requested code maximumdigits point question offset character maximum directionality tested converted unicode fractional property true points
character	wraps compared representing object character primitive value char instance c type class
dataformatexception	signals error data occurred format
source	occurrence text argument list duration inf null parsed unit whose given compared sourceduration nan long source transformed issued new entered target method string may part key collation beginning class must search logging name sourceunit request value converted time first
filenamefilter	used filenames filter instances classes interface implement
collections	return methods exclusively static consists collections operate class
bnm	slice string using attempts boyermoore algorithm input matching match
input	string sequence processed character split input new matched
logger	nearest private existing null matching log system application new newly used parent retrieved object component logger none name created messages specific found suitable
mod	set modifiers
signedmutablebiginteger	represent use used often integers efficient array space number occupy reallocated multiprecision allowing part arrays allocated makes class
delayedworkqueue	use javac wrapper convince delayqueue annoying class blockingqueue
opt	identifies option
boolean	represent externally code iterator setchanged global eldest executing prefix deadline fairness synthetic whose zone so_keepalive oobinline oldval successfuly jvm indicating started bigdecimal's digit random returned denoted anonymous entries redefinition filepermission entire currentclassloader level list manager vector application cookies incremented dequeofferfirst zero multicasting simpledateformat port index stringcharacteriterator opaque specification current public waiting version volatile shared ever method hash cookie's compilation component equals desired objects threads compressed groups address represented path along anchoring appears change items changed usecaches ignoring queue multicast permit action named tasks followed verbose 'udfff' private put boolean ipv names marker traversing retransformation use synchronized would remains positive contains bundles two next call cls attribute scope associated type deque composite flag transient normalized broke known encountered substring lowercase language permits values sent couldn't executor following modifier def control stream process lock interruptedioexception synchronizer subregion allowed locale incheck absolute linklocal successful needs end declared provide holds write maps dequeofferlast trusted iso ancestor map may earlier mapping collection fits monitoring data annotation status short tryrelease succeeded interrupted element cannot automatically object's order exclusive interpretation primitive interpreted disabled held machine group monitor strictfp actually destroyed platform succesfuly hidden main httpurlconnection's renaming return contention titlecase matches matcher clearchanged allowuserinteraction reaches transparent matched represents urlconnection's name hook always directories normally iff mode timeout found toffset identifier queued domainmatches subset interruption suspended conventions stacktraceelement reacquiring static year http operation array termination whitespace space since contained print protected supports shut tryreleaseshared dictionary iteration free standard base cookie proxy collation byte backwards retained thread created could enqueued length pathname timed strictly booleanindicating doinput already saving suffix number owned one date another reached message size given reference indicate ordering system least needed returns white final store maximumdigits completed exactly tokens released part defaulted attempt copy representing character biginteger b effective double enabled transferred subsequence determined seterror browser bridge enull false argument unicast isolatin lefttoright null conversion mappings reloaded mechanism instance high take indexed added unless generator's normal buffer object 'udc' toplevel preset connected letter position pair scanner's expired class considered later uri definitely wildcard redirecterrorstream consumer radix text supported padded threshold wraps removed cpu distributed assertion failed constant local count queueoffer hit permission designated obtain barrier synchronization new dooutput pseudorandom compiler prime settings calling whether contain release valid hashtable set exists acquired tree respect resourcebundle result calendar invoked 'udbff' righttoleft pattern currently state classes enumerated closed probably boundary available recently parent onetime succeed bitset key interface configuration stale last reverse region equal connection ioexception urls exceeds attributes expression otherwise point logged corresponds header mirrored shutdown table builder's ownable java it's due mark defined loopbackmode semaphore setinput ignorable empty direction nonnull else serversocket instant present case exception comparator sitelocal value replaced error cancelled property scheduled ip site according ie id so_reuseaddr greater containing deregistered acquire hostname socketpermission enumeration member rules periodic reachable arguments lenient collectionadd nodelocal simpletimezone keys published upon so_broadcast possible running uses user characters 'ud' stack identity recent task surrogate oldvalnull infinity analysis savings keyvalue components entry signalled redirects protocol starting actions assigned underlying unicode mathcontext organizationlocal yet previous transformer accepted also guaranteed exclusively source terminating decompression usage input logger match identical format read execute elapsed collator preference elapses using bit execution string mod propertypermission daemon necessary success tcp_nodelay signal server arrays imposes either fully resolved output logically accessible methods removenode sequence stringbuffer successfully alive supplementary urgent daylight specified proper manifest matching scale bigdecimal windows loopback token leap continue inetaddress matcher's refer core run deleted equivalent enum lowsurrogate logrecord offset obj socket package compatible range regular constructor discard introduced block logger's previously float numerically bound negative variable url parties package's terminated log support truncated long detectably start sealed uppercase forward head registered memory repeated construction link instancefollowredirects e line tablebased true reset default bounds record native bidi called intersects scanner inclusive int abstract measurement moved char scanned exist file trace nan virtual field setting node elements preceding uniformly bundle includes loading meaning included pool remote typically required mask original implied u time directory requires strings
vendor	implementation specification vendor
format	abstract within syntax symbols href numbers specified loaded elements index use described pattern arguments new used string format formats bundle base date class dates resource localesensitive messages element information formatting time
read	may preserving number mark read limit characters still
requestortype	authentication requesting type entity
rnd	used tested random source candidates primality bits select
collator	comparison string default locale desired collator performs class localesensitive
filterreader	abstract character streams filtered reading class
classcircularityerror	thrown class circularity detected initializing
cookiestore	represents currently object storage manager used cookie cookiestore store
weakclasskey	objects weak class key
bit	index biginteger returned bitlength bit cleared
cd	representing compositedata threadinfo memorynotificationinfo monitorinfo
jarfile	unsuccessfully searches used java opened read bootstrap jar system loader connection contents file searched class jarfile
desc	objectstreamclass stream instance write descriptor class
propertypermission	property class permissions
daemon	daemon group thread normal marks true otherwise
classfile	format buffer modified file input byte class must
treemap.entry	map given map's key contain entry null
d	slot index code floatingpoint power whose deleted double number value two scaled converted printed signum duration newly starting empty returned
runtimepermission	runtime class permissions
stringcoding	decoding encoding class string utility
interruptedexception	thrown thread interrupted sleeping waiting either activity occupied otherwise
manifest	none used associated corresponding object jar manifest connection maintain names file attributes entry null class
ignore	identical skipped considered regarded next distinct 'n' true otherwise
arrays	sorting methods arrays contains searching various manipulating class
collationkey	represents given based string rules object collator's collator specific collationkey collation
mergecollation	normalizing patterns merging collation class utility
t	map exception execution checked mappings thread caused completed removed current stored termination null normally added
abstractqueue	operations skeletal implementations queue link provides class
parseposition	used format simple parseposition keep current track position parsing subclasses class
laddr	local address
initargs	primitive e object wrapper appropriate objects call arguments passed constructor wrapped values array type types
sequenceinputstream	represents concatenation logical streams input sequenceinputstream
backlog	queue length maximum backlog listen
replacement	string sequence char substituted values replacement match first
branchconn	node guard end branch atom
concurrentnavigablemap	operations supporting concurrentmap reverse map recursively order link submaps navigablemap navigable view
old	old character value key specified expected associated
runtimeexception	thrown java normal runtimeexception virtual machine superclass exceptions operation
inetsocketaddress	implements case made attempt socket ip hostname number class also resolve unresolved address pair representing port inetsocketaddress
stringbuffer	object threadsafe reference sequence characters stringbuffer appended formatted value number current buffer passed holding text mutable datetime target toappendto string
bitclass	latin creates vector values bit matching
socketimplfactory	interface socket factory implementations defines
pipedreader	characterinput streams piped
authority	url part authority
localeserviceprovider	spis service locale interfaces sensitive provider super class
malformedparameterizedtypeexception	thrown needs instantiate parameterized encountered malformed reflective semantically type method
daylight	return daylight true savings name
discardpolicy	discards tasks rejected task handler silently
slice	node case sequence sensitivebmponly literal characters class
concurrentmap	java link
duration	duration given sourceunit time
navigableset	toelement exclusive set methods inclusive elements fromelement targets code whose given less range keys map extended greater closest matches navigable reporting link true search reverse equal sortedset portion navigation order view
cal	date calculation calendarsystem used
executorservice	executorservice tracking methods thread created tasks manage one instance produce link progress provides executor termination asynchronous future newly pool singlethreaded
hibyte	high character byte resulting unicode
writethroughentry	entryiterator entry used class custom
assertionerror	thrown indicate assertion failed
jarverifier	schemers roland
scale	code bigdecimal power f value scale used quotient returned
bigdecimal	code rounded final ten point specified one according removed appropriate multiplying equivalent numbers right unscaledval mathcontext n array element trailing dividetointegralvalue size result whose scale ulp bigdecimal val subtrahend initial two approximately thisn maintain zeros possibly input scanned immutable closed bigdecimal's greater power arbitraryprecision moved multiplicand overall preferred standard ansi part value integer absthis remainder numerically necessary divisor using settings decimal unscaled equal signed times lesser augend determined places reduced x left dividing quotient
abstractmethoderror	thrown abstract application tries call method
channel	otherwise null channel inherited
subtrahend	code subtracted value bigdecimal
linkedhashiterator	iterator backing list value believes modcount
resourcebundle.control	resourcebundle
timerthread	implements reschedules task helper timer's waits fire removes spent timer executions queue thread tasks cancelled nonrepeating repeating execution class
memorypoolmxbean	interface management pool memory
comments	property list description
week	dayofweek given saving ending daylight time date starting
contenthandlerfactory	interface content handlers factory defines
singles	node matches character supplementary unicode class
decomposition	new decomposition mode
period	executions task successive milliseconds time
utfdataformatexception	signals hrefdatainput string malformed
o2	second object compared
o1	object compared first
identityhashmap	implements map hash keys values objectequality comparing referenceequality place using interface table class
observer	wants observable observer informed objects interface implement changes class
core	even core use number corepoolsize bound else maximumpoolsize idle threads new keep true pool size
putfieldimpl	default putfield implementation
run	index getruncount run
obey	count use stop one field parsing abuts know directly next true
reflectpermission	operations reflective class permission
inetaddr	leave multicast address
seconds	seconds value
enum	code return name language java enum specified object base common enumeration constant type class types
atomiclongfieldupdater	utility code fields reflectionbased designated long classes volatile atomic updater enables updates
use	output logger's true parent sent
classformaterror	thrown java malformed read virtual interpreted machine attempts cannot file determines class otherwise
expiry	seconds max age maximum unspecified discarded cookie's zero cookie specifying immediately integer otherwise
host	remote name url ip connection hostname site value requesting host belongs connect socket specified interface null local port address authentication
logrecord	used logging log handlers individual framework objects logrecord pass requests
threadlocal.threadlocalmap.entry	entry null associated key
jarurlconnection	java url jar connection file entry archive
offset	scanning code saving int text searching char raw daylight stored array null check append index given zone inserted initial character needed forward new gmt begin return string base offset subarray data level value amount points values time position original first
outofmemoryerror	thrown available made java garbage could object virtual machine cannot allocate memory collector
properties	represents set class system persistent properties
attributedstring	information attribute holds related text attributedstring
lock	operations obtained code statements methods synchronized provide lock locking implementations writing used using extensive reading
src	position checked stream sequence stop writer list start char source values connect copying offset output array starting piped
randomaccess	used constant indicate generally support random list implementations access interface fast time marker
obj	compare set invoked stream int lock abstract testing number tablebased char date code url specified throwable extract check fill whose compared stringcharacteriterator cast get long write field test pathname wait method added simpletimezone format object component substituted printed ownership collation byte conditionally reference must thrown insert short equality receive double list modified value element callback float underlying replaced validation
socket	implements sockets socket class also client new called
idx	node index string expanding list value topmost inserted
package	available set defined code array null archive whose given java implementation specification assertion instance version new newly status requested corresponding information object codebase objects known packages class name package default classloader callers contain found
charproperty	node satisfying abstract character one boolean property class match
of	dayofweek given saving ending daylight time date starting
certainty	code prime biginteger caller probability certainty uncertainty tolerate returns willing call measure exceeds true
months	new short strings month
ob	object compared
o	compare set observer deque stored whose compared checked appear presence map sole returned deleted object collection desired repeatedly removed present observable search equality tested list remove element queue vector containment entry added
charconversionexception	exceptions conversion base character class
attributedcharacteriterator	information args describing attributedcharacteriterators iterator entire attributedcharacteriterator attribute value selected iteration formatted related access wrapping allows passed text attributes providing
unknownhostexception	thrown ip could indicate host determined address
urlstreamhandler	protocol stream handlers abstract specific urlstreamhandler superclass class common
positive	positive regarded true number
iport	port number
fairsync	locks version sync fair object
os	xml stream object written objectoutput output document emit
closeable	source destination data closeable closed
block	unicodeblock name
stringbuilderhelper	code places starts intcompact long returns cmpchararray characters offset representation array representing
readlimit	read becomes bytes maximum invalid mark limit position
lazyloop	count handles repetition curly reluctant
synchronizedrandomaccesslist	include
filefilter	filter abstract pathnames
float	function named code associated stream truncated copy float sign primitive numeric interpreted four scanned exist file specified infinity array absolute closer instance wraps compared smaller bigdecimal start positive distributed range next field magnitude zeros adjacent indexed input size type node direction signum string read component object uniformly containing obtain holding larger cannot preference key new represented number bit pseudorandom representing class conversion padded biginteger b floatingpoint f argument scalefactor ulp required bytes value times length converted pattern double original def
bound	boundaries handles word
cancellationexception	exception task retrieved valueproducing cancelled cannot link result futuretask indicating
outputstream	body outputstream socket stream normal subprocess abstract bytes connection response written classes writes superclass input output writing representing class localized connected
bufferedoutputstream	implements buffered class stream output
entryiterator	use iterator don't since objects entry
scanner	primitive scanner simple text parse regular using expressions strings types
concurrentskiplistmap	map concurrentnavigablemap implementation shallow scalable concurrent link copy
mark	value one least expected new array mark size
math	operations logarithm functions contains methods exponential performing trigonometric numeric code square basic elementary root class math
simpleimmutableentry	key entry value immutable maintaining
nodechangeevent	node added preferences emitted indicate child removed event
val	code computed stream float char minimum array null or'ed whose use xor'ed bigdecimal gcd divided two and'ed stored field written bigdecimals subtracted multiplied elements complemented may biginteger compared integer byte aligned remainder referring convert short name unscaled default double maximum value magnitude assign added
concurrentskiplistmap.node	predecessor node last key nearest fitting likely relation holding null empty first
collatorprovider	java service providers provide abstract implementations concrete link class
initial	delay execution first time
u1	url object
iter	classes base iterator
long	represent code rounded notification nanoseconds random midnight named interpreted padded implementationspecific tasks virtual committed threshold ownable availability previous millisecond delay wraps position uuid also representation cache distributed state actually collections usage input expired might remaining gmt scheduled division urlconnection skipped return returned format read two's elapsed indexed cannot preference new userlevel integer bit execution crossed conversion disabled resource name cached january deadlocked bytes l method timed_waiting crc onebit mode unallocated output fixed decimal unloaded system smaller sharedmode exists sequence enabled sync alive modified approximation zero lowestorder specified duration event acquires instance bigdecimal subsequent since equal current storage waiting classes absolute currently denoted shared blocked occurs available rotating seconds uniformly compilation monitors component succeed cookie compressed key offset represented java estimate remainder monitor obtained sending last floatingpoint thread reversing checksum larger count timer nonnegative length objects pathname def positive thread's uuid's otherwise primitive referenced significant reached float number owned approximate order highestorder right references least ttl_dont_cache owner loaded array total unit size use described suid double measured id truncated bundles negative long next indicate null zeros memory entered type start milliseconds inheritdoc complement started initial acquire occurred argument failure link numeric known actual copy representing ifmodifiedsince must case utc biginteger b threads bits accumulated maximum value descriptor converted limit expiration error already amount property obtain minus acquisition control nearest required associated file stream beginning abstract measurement exceeded updated ids consumed radix scanned exist io difference times parsed string machine binary containing compared monitoring nm check synchronizers get millis range uncompressed occur write field epoch arguments holding lis modification constructed node used generator's object upon uptime collection pseudorandom caching disable eight characters ttl_no_expiration_control date nanostimeout future data class pool recent task attempt undefined succeeded url values age partition spent contention cpu single specifying time far entry allocated object's original left
u2	url object
start	dayofweek saving inclusive wall within searching parsing char daylight index start res appended character subsequence field anywhere location test subarray local used string standard characters offset line month beginning day input case floatingpoint starts clock value range paragraph time starting first
incompatibleclasschangeerror	thrown definition incompatible occurred class change
low	code end value tested range low lowsurrogate
virtualmachineerror	thrown java necessary broken virtual machine indicate continue operating run resources
discardoldestpolicy	code discards execute tasks unless retries request shut rejected task discarded case handler executor unhandled oldest
priorityblockingqueue	operations priorityqueue ordering unbounded class queue rules uses linkplain supplies link retrieval blocking blockingqueue
crc32	used compute stream crc data class
checkedsortedmap	include
arrayindexoutofboundsexception	thrown index illegal indicate accessed array
libname	name library
form	forms java unicode form enum one four link constants provides described normalization hrefhttpwww
linenumberreader	buffered stream track characterinput numbers keeps line
memoryhandler	buffer handler memory requests buffers circular
scheduledthreadpoolexecutor	commands run schedule given delay link execute additionally periodically threadpoolexecutor
delayed	acted interface specified null style delay waiting empty available head elements becomes upon marking objects mixin elapses given expired element queue time
propertyresourcebundle	set locale propertyresourcebundle subclass concrete resourcebundle manages static file using property strings resources
authenticator	represents knows connection object obtain authenticator authentication class network
bundlereference	garbage hard bundles references collected soft
hi	index last subtree element high range end
preferences	associated specified event whose preferences system member node added parent emitted collection hierarchical preference child removed data c package calling root user
checkedentryset	need addition map class checkedset
unixcaret	node unixdot mode line beginning anchor
delta	add value
line	int number start paragraph limit specifying offset new line
with	n spacing around puts entries
invalidpreferencesformatexception	thrown conform complete xml could collection indicate appropriate link per input operation document type specification preferences
characteriteratorfielddelegate	combines format attributedcharacteriterator notifications resulting characteriteratorfielddelegate
pack200	stream format jar transforms file packed pack
count	count use string pattern chars character length value next stop field parsing abuts know directly subarray one true
compilationmxbean	compilationmxbean management java compilation object system virtual machine link interface null
attr	field identifies matched
externalizable	restore stream externalizable instances instance written responsibility contents serialization save class identity
reload	resource true bundle reloading indicate flag false expired otherwise
default	default value
atomicstampedreference	updated code reference stamp maintains object atomically integer along atomicstampedreference
j	index swapped element
maximum	digits maximum converted fractional new total
eventobject	shall derived event state objects root class
abstractlist	random backed implementation skeletal array required list data access minimize link provides interface implement effort class store
record	containing description raw formatted record logrecord published message event log
preferencechangelistener	listener receiving preference change events
limit	preserving number threshold result marker invalidating still described mark start test may characters offset line read bytes maximum range paragraph limit position
mto	maxterorder value
bidi	implements bidirectional algorithm class unicode
serviceconfigurationerror	thrown loading service provider wrong something goes error
timeunit	operations represents given methods perform durations granularity convert delay timing provides time units timeunit across unit utility
z	node code obj component modified value field indexed new
minutes	minutes value
map.entry	map code last greater less removed equal least else snapshot greatest key entry null empty first
impl	implementation version vendor title
ex	may exception null
streamtokenizer	streamtokenizer takes stream read parses one tokens allowing time input class
localenamegetter	locale implementation obtains localenameprovider localized names
ques	quantifier
jarexception	sort jar occurred writing signals file error reading
inclusive	code returned high endpoint low included true view
int	represent code iterator month four so_rcvbuf zone netscape rightmost exit sent division updated returned far connection's floatingpoint entries subprocess matcher's minute rotating level f list vector smaller occurrence sync sign past second insertion estimated port index barrier clock specification selected current waiting version new method hash cookie's never component objects threads compressed groups address represented respect digits search larger ignoring queue amount action suitable composed named tasks tokenizer logical socket's boolean total byte zip remainder two thread's next live handler call associated type milliseconds deque started hashcode flag known cardinality finalization blocking capturing must lowercase locked language hour permits values indicating following arrive def nearest stream process lock substring currency minimum allowed validated occur string information end processors string's holds uncompressed write located timetolive iso absolute map max await variant collection date data response short so_sndbuf succeeded element representation two'scomplement order exclusive rounded interpreted held onebit blocked machine group uuid actually deepcontentbased scopeid weeks might pending skipped return greater titlecase indexing number break day matched represents biginteger's ancestor name always decimal magnitude mode timeout found successful ordinal sharedmode numeric simpledateformat contracting connect year category network content contained get occurs xxffff dictionary differ standard nth base cookie proxy put indicates estimate beginning character's thread starts days times length pathname first reversing already saving primary reaches one countnbspnbsppos reached array loaded size doesn't given checked width ordering top annotation priority needed returns japaneseimperialcalendar ttype bits option staleslot acquire tokens signum copy representing datagramsocket expunging biginteger b target double iteration zero classes minus acquisition function false anotherdouble argument raw null conversion strength mappings trip also internal text's indexed flags added generator's buffer chars object contentbased preset connected position highestorder class unavailable url clear later uri pipe points pattern left came radix text random ending padded so_linger availability slot highest based perthreadrandom distributed written onebits local nanoseconds begins utc compiled cannot so_timeout shared breakiterator pseudorandom runs resource fields bytes rfc float contain arrival hashtable set computed acquired frame packet transferred unbiased close calendar acquires capacity exponent subsequent away currently boundaries state closed subarray boundary available complement succeed bitset key interface monitor received last element's region equal connection illegal otherwise point complies period loader active sequences table statuscode java stamp defined semaphore gregoriancalendar obtained collator's corresponding precision observers bmp observe case unscaled value n invoking error property would nonsystem ip id binary containing delimiter enumeration check member rules week used http keys effect characters stack identity recent kept undefined surrogate without keyvalue components entry preference getparties less deciaml obtain actions underlying unicode integer mathcontext yet captured previous character unsigned source add valid zeros input remaining match gmt resolved read aray anotherfloat traffic typeofservice listening immediately bit execution advanced daemon localport excluding elementdata collation eightbit either output right methods sequence uppercase supplementary connectjava daylight specified matching nonnegative scale bigdecimal two's decomposition leftmost lexicographically minimal core run seconds equivalent enum fromindex expansion host offset comparison actual socket anything package pasttheend datagram range cmpchararray positive considerations primitive within numerically bound negative pair references parties frames compression val truncated approximate long start fraction lowest locks failure link line removed true adler count absent modifiers default maximum signed mtu placed converted limit seuences minutes lowestorder constant scanner inclusive int abstract general char single scanned exist file trace timezone parsed virtual field setting node requested elements preceding uniformly peak remote eof using required mask depth time starting original
m	map mappings synchronized dynamically number unmodifiable stored typesafe wrapped returned modulus milliseconds view
loggingpermission	control code logging methods calls permission securitymanager one running logger check
threaddeath	thrown threadstop code thread deprecated threaddeath instance invoked link victim method
eventlistenerproxy	set additional parameters abstract eventlistener wrapper listener associates class
an	compare code string get object components array copied
char	named representation old file stream truncated text copy obtain interpreted char radix including uppercased passphrase specified reached array null length allocated contents code index containing position console titlecase sequence character two next current field uppercase initialized input copied utf type equivalent empty digit linetermination string reversing typecode read component chars object inapplicable conversion indexed characters new represented end bit password data serializable swapping obtained padded lowercase last whose getendindex newly codepoint's required bytes equal value getbeginindex equivalently range converted contain done primitive otherwise original first
single	matches given optimization character bmp
checkedoutputstream	stream checksum maintains also written output data
connectexception	remote socket attempting address occurred signals connect error port
file	available named code process abstract pathnames set file specified array null builder's roots canonical working filename denoted absolute empty files systemdependent string parent denoting host objects newlycreated name directories determined pathname filesystem directory representation could
missingformatwidthexception	thrown exception format required width unchecked
delegatedscheduledexecutorservice	methods implementation wrapper exposes scheduledexecutorservice class
inf	inetaddress
contenthandler	urlconnection read abstract object contenthandler classes superclass new class urlstreamhandler
numberformatgetter	implementation instance obtains numberformat numberformatprovider
fielddelegate	objects format notified implementations formatting various fielddelegate
privilegedcallable	control established runs settings access callable
monitorinfo	information locked monitor thread monitorinfo object cd objects lock represented array null representing monitors otherwise
nm	code decode property name string
taskqueue	represents task ordered nextexecutiontime timertasks timer queue class priority
synchronizedmap	include
multicastsocket	sending useful socket ip packets datagram multicast receiving class
when	object compared
entryfuture	tables used reflector field process descriptor lookup initialized entry placeholder class
atomiclong	updated code may value atomically long
monitors	locked true monitors dump
field	declared code constant computed object calculation attribute within dynamic sync marked interface single names specified constants calendar parsed alignment string information given keys numberformat attributedcharacteriterator dateformat access field state setting change provides input defines public indicating updated used returned format track time desired objects representation date integer bit cleared representing class specify name fields array mask messageformat value keeps position identifies display
other	compare compared equality string url object timezone array
treeinfo	applied information used graph object subtree optimizations accumulate
branch	branching handles alternations
localeisodata	codes iso language letter
illegalmonitorstateexception	thrown monitor thread attempted indicate waiting without threads notify specified object's owning wait
linkedhashmap	map hash implementation iteration list order predictable interface table linked
node	intervening exchanged singly marker linked doublylinked waiting nodes wait node keys possibly base sorted hold data class condition partially insert list queue classes values order
elements	insert array elements c
formatterclosedexception	thrown exception formatter unchecked closed
worker	control tasks worker maintains mainly running state threads interrupt along bookkeeping class minor
transferstack	stack dual
character.unicodeblock	blockname character identified member instance unicode unicodeblock null representing block
memorymxbean	management java object memorymxbean system virtual machine link memory interface
update	new value
bundle	instance used resource name localizing localization may cache messages bundle put resourcebundle msg localize logger null expired
inputstream	useful stream abstract subprocess reads superclass file specified link null open contents errors java zip output representing normal class localized input reading sent body found inputstream connected entry data response resource socket url could bytes server connection classes error accessed
iterators	create used resulting attributedcharacteriterators
a2	tested array equality
proxy.type	representing type proxy
numberformatexception	thrown convert string application attempted format numeric one indicate appropriate types
navigablemap	code methods less targets whose given inclusive fromkey keys map extended greater closest returning matches link true reverse portion search tokey sortedmap equal range navigation order view
linkageerror	dependency latter changed however class indicate former another compilation incompatibly subclasses linkageerror
pool	even core number maximum idle threads new keep pool size
unknownformatflagsexception	thrown exception unknown given flag unchecked
collatorgetter	implementation instance collator obtains collatorprovider
e	set producer object elements enumeration containment table array null returned compared checked zip attempting transfer appended written handed checking add expandingcharacter tablei match collator's added return nonnull absent initially offered executor search collection insert removed present expandtable comparison execute task equality list value element item vector contain push entry requests providing consumer
mask	computed calculation sync marked calendar use zone field state setting specify calculations indicating used actions offset date bit change fields mask value time
original	range array copied
jumboenumset	implementation enum private enumset jumbo class types
deflaterinputstream	implements compression stream format deflate compressing filter input data
depth	trace dumped maximum number entries stack
debugtraceinfostack	information exception process messages keep state embedding debug serialization stack
u	url object modify connects
abstractqueuedlongsynchronizer	version maintained long abstractqueuedsynchronizer state synchronization link
characteriterator	protocol iterator text iteration bidirectional scanned interface analyzed defines
time	executed saving int within number ending relative daylight loaded given clock since wall epoch expressing modification new local milliseconds gmt importance lastmodified style bundle standard task put measured day wait case short january maximum cache connection formatting time entry starting first
directory	used working created default file directory new null temporaryfile
format.field	field identifier
strings	new strings zone time
blockingqueue	queue java task link
