float	float
hidden	hidden
separator	separator
some	some
swap	swap
abstractstringbuilder	abstractstringbuilder
computed	computed
logger	logger
preferencechangelistener	preferencechangelistener
linkedhashmap	linkedhashmap
implementation	implementation
latest	latest
lng	lng
plus	plus
for	for
primitive	primitive
e4	e4
printf	printf
miss	miss
headindex	headindex
fix	fix
logging	logging
text	text
sync	sync
ret	ret
parent	parent
job	job
abstractexecutorservice	abstractexecutorservice
notify	notify
rejected	rejected
atomicintegerarray	atomicintegerarray
fileoutputstream	fileoutputstream
format	format
comment	comment
public	public
refill	refill
println	println
during	during
square	square
intersects	intersects
rnd	rnd
large	large
resize	resize
surrogate	surrogate
era	era
protectiondomain	protectiondomain
linkedblockingdeque	linkedblockingdeque
abstract	abstract
a2	a2
verify	verify
int	int
delimiter	delimiter
memorymxbean	memorymxbean
sieve	sieve
modified	modified
inflateroutputstream	inflateroutputstream
tree	tree
parse	parse
purpose	purpose
handletable	handletable
supports	supports
state	state
deque	deque
variant	variant
deserialize	deserialize
digit	digit
missing	missing
target	target
interfaces	interfaces
filefilter	filefilter
left	left
deflaterinputstream	deflaterinputstream
connection	connection
atomicinteger	atomicinteger
ambiguous	ambiguous
util	util
tbl	tbl
sequenceinputstream	sequenceinputstream
cookiepolicy	cookiepolicy
exec	exec
propertychangelistener	propertychangelistener
micros	micros
object	object
constant	constant
matchresult	matchresult
fieldreflector	fieldreflector
gaussian	gaussian
month	month
numbytes	numbytes
lport	lport
unscaled	unscaled
reentrantreadwritelock	reentrantreadwritelock
abruptly	abruptly
divisor	divisor
assign	assign
iso3country	iso3country
fraction	fraction
hibyte	hibyte
decimal	decimal
locked	locked
logmanager	logmanager
mxbean	mxbean
i	i
breakiteratorprovider	breakiteratorprovider
resume	resume
index	index
formats	formats
saved	saved
operatingsystemmxbean	operatingsystemmxbean
filename	filename
char2	char2
reflector	reflector
finalize	finalize
serialized	serialized
gc	gc
dateformatsymbols	dateformatsymbols
obey	obey
iterable	iterable
fairsync	fairsync
socketimplfactory	socketimplfactory
gmtstring	gmtstring
flushable	flushable
peer	peer
starts	starts
null	null
declaration	declaration
netif	netif
softreference	softreference
vowel	vowel
locksupport	locksupport
source	source
jacobi	jacobi
read1	read1
mont	mont
subset	subset
running	running
typenotpresentexception	typenotpresentexception
base	base
if	if
lf	lf
pos	pos
reader	reader
timeunit	timeunit
skip	skip
copyonwritearraylist	copyonwritearraylist
bridge	bridge
deadlocked	deadlocked
unstarted	unstarted
o2	o2
socketoutputstream	socketoutputstream
append	append
protection	protection
tz	tz
long	long
transparent	transparent
ceiling	ceiling
privilegedaction	privilegedaction
unresolved	unresolved
double	double
dstpos	dstpos
back	back
fulfilling	fulfilling
library	library
or	or
pipedinputstream	pipedinputstream
uncaught	uncaught
bundle	bundle
eldest	eldest
timestamp	timestamp
datagrampacket	datagrampacket
stringwriter	stringwriter
failed	failed
done	done
open	open
member	member
mill	mill
deleted	deleted
streamhandler	streamhandler
unmodifiablemap	unmodifiablemap
mimetype	mimetype
resolve	resolve
make	make
writeabortedexception	writeabortedexception
accessibleobject	accessibleobject
abstractset	abstractset
prefix	prefix
write	write
import	import
datagramsocket	datagramsocket
initial	initial
priority	priority
atomicmarkablereference	atomicmarkablereference
permissioncollection	permissioncollection
d2	d2
peekinputstream	peekinputstream
iso3language	iso3language
until	until
not	not
urlstream	urlstream
fieldposition	fieldposition
deflateroutputstream	deflateroutputstream
replacetable	replacetable
right	right
toffset	toffset
network	network
tab	tab
into	into
duration	duration
binary	binary
minutes	minutes
negative	negative
white	white
request	request
ins	ins
bdivisor	bdivisor
point	point
affix	affix
suffix	suffix
access	access
classfile	classfile
fd	fd
absent	absent
math	math
threadpoolexecutor	threadpoolexecutor
cws	cws
stop1	stop1
change	change
dir	dir
transfer	transfer
description	description
strength	strength
params	params
optimize	optimize
class	class
inheritable	inheritable
last	last
cbrt	cbrt
enq	enq
reconstitution	reconstitution
sbuf	sbuf
abstractqueuedsynchronizer	abstractqueuedsynchronizer
word	word
blockdataoutputstream	blockdataoutputstream
ch	ch
sort	sort
subtrahend	subtrahend
decimalformatsymbols	decimalformatsymbols
stringbuilder	stringbuilder
stamp	stamp
trim	trim
acos	acos
model	model
illegalformatprecisionexception	illegalformatprecisionexception
meta	meta
dictionarybasedbreakiterator	dictionarybasedbreakiterator
uptime	uptime
sin	sin
may	may
redirect	redirect
def	def
field	field
abort	abort
file	file
little	little
cookiestore	cookiestore
attr	attr
waited	waited
drain	drain
invalidpropertiesformatexception	invalidpropertiesformatexception
in	in
gregoriancalendar	gregoriancalendar
received	received
submit	submit
held	held
tag	tag
static	static
thread	thread
count	count
evt	evt
tail	tail
certificate	certificate
proxy	proxy
throw	throw
objectinput	objectinput
protected	protected
maps	maps
segment	segment
scientific	scientific
intersection	intersection
terminating	terminating
copyonwritearrayset	copyonwritearrayset
character	character
mc	mc
custom	custom
date	date
entering	entering
adler32	adler32
filepermissioncollection	filepermissioncollection
runnable	runnable
tan	tan
inv	inv
embedding	embedding
jarverifier	jarverifier
jaroutputstream	jaroutputstream
annotations	annotations
ndoubles	ndoubles
expect	expect
propertypermission	propertypermission
holds	holds
div	div
collections	collections
exchange	exchange
na	na
k1	k1
within	within
definition	definition
hypot	hypot
signedmutablebiginteger	signedmutablebiginteger
objectinputstream	objectinputstream
getfield	getfield
mclink	mclink
isolanguages	isolanguages
objectstreamfield	objectstreamfield
replace	replace
clear	clear
perm	perm
title	title
pm	pm
synchronizers	synchronizers
med3	med3
execution	execution
strings	strings
signed	signed
helper	helper
any	any
increment	increment
ttl	ttl
e2	e2
socks	socks
nonfairsync	nonfairsync
nodechangelistener	nodechangelistener
short	short
days	days
since	since
snapshot	snapshot
reordered	reordered
symbols	symbols
up	up
cosh	cosh
net	net
heapify	heapify
owner	owner
pack	pack
list	list
checked	checked
idle	idle
alpha	alpha
chunklen	chunklen
head	head
serializable	serializable
adler	adler
itr	itr
owns	owns
print	print
ei	ei
lower	lower
delimiters	delimiters
putfield	putfield
listiterator	listiterator
e1	e1
pkg	pkg
rolled	rolled
hex	hex
abstractplaindatagramsocketimpl	abstractplaindatagramsocketimpl
observable	observable
ip	ip
concurrentlinkedqueue	concurrentlinkedqueue
home	home
generic	generic
filterwriter	filterwriter
extract	extract
simpledateformat	simpledateformat
stamp_a	stamp_a
destroy	destroy
chunked	chunked
stamp_b	stamp_b
align	align
after	after
installed	installed
formatter	formatter
uuid	uuid
loggingmxbean	loggingmxbean
callbacks	callbacks
listen	listen
ref	ref
part	part
invoke	invoke
unconfigurable	unconfigurable
reverse	reverse
disconnect	disconnect
private	private
even	even
addresses	addresses
milliseconds	milliseconds
fatal	fatal
completed	completed
cbuf	cbuf
atomicreferencearray	atomicreferencearray
synthetic	synthetic
classnotfoundexception	classnotfoundexception
hashiterator	hashiterator
bytearrayoutputstream	bytearrayoutputstream
strictmath	strictmath
undeclaredthrowableexception	undeclaredthrowableexception
compilationmxbean	compilationmxbean
idx	idx
written	written
blockingqueue	blockingqueue
sequence	sequence
datagram	datagram
stringcharacteriterator	stringcharacteriterator
form	form
memorypoolmxbean	memorypoolmxbean
anonymous	anonymous
apparently	apparently
under	under
core	core
asciistring	asciistring
style	style
schedule	schedule
eh	eh
previous	previous
age	age
broadcast	broadcast
base64to	base64to
base64	base64
ten	ten
forward	forward
threads	threads
ulp	ulp
writer	writer
c	c
argument	argument
vm	vm
serial	serial
week	week
multiply	multiply
clone	clone
digits	digits
lastnode	lastnode
attributed	attributed
singleton	singleton
linenumberinputstream	linenumberinputstream
abstractsequentiallist	abstractsequentiallist
fac	fac
method	method
nm	nm
arraylist	arraylist
create	create
utflength	utflength
invalidclassexception	invalidclassexception
dooutput	dooutput
memorymanagermxbean	memorymanagermxbean
per	per
invocationhandler	invocationhandler
secondary	secondary
await	await
power	power
recurse	recurse
low	low
cause	cause
verbose	verbose
weekdays	weekdays
trace	trace
more	more
expansion	expansion
op	op
ioexception	ioexception
urlclassloader	urlclassloader
grow	grow
jarurlconnection	jarurlconnection
objectoutputstream	objectoutputstream
mbeanserver	mbeanserver
sockssocketimpl	sockssocketimpl
predecessors	predecessors
dateformatsymbolsprovider	dateformatsymbolsprovider
biginteger	biginteger
advance	advance
uripath	uripath
disable	disable
permission	permission
memory	memory
minus	minus
vals	vals
rounding	rounding
callable	callable
impl	impl
currencies	currencies
networkinterface	networkinterface
quick	quick
pri	pri
complete	complete
condition	condition
getfieldimpl	getfieldimpl
packer	packer
tables	tables
num	num
completionservice	completionservice
bucket	bucket
committed	committed
f2ary	f2ary
msg	msg
greatest	greatest
handler	handler
ldividend	ldividend
elt	elt
breakdictionary	breakdictionary
management	management
cell	cell
lineno	lineno
depth	depth
mkdirs	mkdirs
attributes	attributes
checkedentryset	checkedentryset
clipboard	clipboard
monitor	monitor
transferer	transferer
over	over
attributedcharacteriterator	attributedcharacteriterator
compile	compile
conversion	conversion
listener	listener
defaulted	defaulted
addend	addend
link	link
iport	iport
year	year
timed	timed
octal	octal
red	red
tc	tc
frames	frames
tcp	tcp
inputstream	inputstream
floats	floats
snode	snode
col	col
filterreader	filterreader
unicode	unicode
country	country
buildapi	buildapi
pref	pref
bitsieve	bitsieve
error	error
treemap	treemap
matches	matches
unpacker	unpacker
nano	nano
case	case
hi	hi
initializer	initializer
name0	name0
fixed	fixed
calendar	calendar
characteriteratorfielddelegate	characteriteratorfielddelegate
runnablescheduledfuture	runnablescheduledfuture
weakclasskey	weakclasskey
e	e
delayqueue	delayqueue
cd	cd
environment	environment
universe	universe
weak	weak
atomiclongarray	atomiclongarray
socket	socket
void	void
abortpolicy	abortpolicy
start	start
cmd	cmd
calls	calls
trusted	trusted
native	native
annotate	annotate
bound	bound
annotationtypemismatchexception	annotationtypemismatchexception
signature	signature
following	following
supplementary	supplementary
maximum	maximum
relativize	relativize
patternsyntaxexception	patternsyntaxexception
inet4address	inet4address
doinput	doinput
asin	asin
purge	purge
none	none
throwable	throwable
threadlocalmap	threadlocalmap
s	s
follow	follow
clazz	clazz
cased	cased
backlog	backlog
no	no
inc	inc
volatile	volatile
split	split
contended	contended
exp	exp
suspend	suspend
month1	month1
broken	broken
loaded	loaded
synchronousqueue	synchronousqueue
points	points
decorate	decorate
ordinary	ordinary
used	used
reduce	reduce
aggregate	aggregate
policy	policy
envp	envp
formattable	formattable
sorted	sorted
magnitude	magnitude
timertask	timertask
translate	translate
infinity	infinity
rint	rint
stringtokenizer	stringtokenizer
weakhashmap	weakhashmap
gregorian	gregorian
socketinputstream	socketinputstream
map	map
compose	compose
readlimit	readlimit
urisyntaxexception	urisyntaxexception
ahead	ahead
match	match
scan	scan
element	element
memorytype	memorytype
disjoint	disjoint
zeros	zeros
endpoint	endpoint
join	join
largest	largest
subcl	subcl
study	study
bandwidth	bandwidth
putfieldimpl	putfieldimpl
flag	flag
info	info
requestortype	requestortype
remaining	remaining
decomposition	decomposition
load	load
discardpolicy	discardpolicy
e3	e3
props	props
full	full
type	type
extension	extension
securitymanager	securitymanager
daylight	daylight
length	length
boot	boot
lock	lock
arraycopy	arraycopy
listeners	listeners
preferences	preferences
compute	compute
cos	cos
partially	partially
distance	distance
rhs	rhs
doc	doc
retrieve	retrieve
uri	uri
discardoldestpolicy	discardoldestpolicy
deadline	deadline
subformat	subformat
bufferedwriter	bufferedwriter
loop	loop
initiated	initiated
display	display
processbuilder	processbuilder
rulebasedcollator	rulebasedcollator
exclusive	exclusive
on	on
datainput	datainput
deflate	deflate
typevariable	typevariable
is	is
eventlistenerproxy	eventlistenerproxy
space	space
simple	simple
excess	excess
cast	cast
inverse	inverse
ldivisor	ldivisor
self	self
move	move
pow	pow
readlock	readlock
strategy	strategy
enqueue	enqueue
inputstreamreader	inputstreamreader
it	it
mod	mod
inclusive	inclusive
max	max
transformer	transformer
reschedule	reschedule
priorityqueue	priorityqueue
navigableset	navigableset
xor	xor
nonfair	nonfair
filepermission	filepermission
classes	classes
buffer	buffer
f2	f2
classfiletransformer	classfiletransformer
p	p
attribute	attribute
off	off
okey	okey
expand	expand
charproperty	charproperty
table	table
package	package
memoryusage	memoryusage
c1	c1
identifier	identifier
manager	manager
write0	write0
memoryhandler	memoryhandler
necessary	necessary
regularenumset	regularenumset
acquire	acquire
tasks	tasks
timer	timer
codesigner	codesigner
instance	instance
me	me
post	post
runtime	runtime
abs	abs
contention	contention
config	config
rehash	rehash
blocked	blocked
filenamefilter	filenamefilter
curdata	curdata
threadmxbean	threadmxbean
connected	connected
externalizable	externalizable
interrupt	interrupt
horizon	horizon
filteroutputstream	filteroutputstream
timerthread	timerthread
looking	looking
getenv	getenv
stringreader	stringreader
logrecord	logrecord
mcglobal	mcglobal
f1	f1
begin	begin
single	single
position	position
delay	delay
scheduledfuturetask	scheduledfuturetask
datainputstream	datainputstream
iterator	iterator
percent	percent
y	y
sentence	sentence
h	h
k2	k2
push	push
k	k
preferencesfactory	preferencesfactory
strip	strip
context	context
present	present
localenameprovider	localenameprovider
shuffle	shuffle
formatflagsconversionmismatchexception	formatflagsconversionmismatchexception
composition	composition
replacement	replacement
process	process
accept	accept
fmt	fmt
atan2	atan2
removal	removal
composed	composed
httpurlconnection	httpurlconnection
close	close
arrayblockingqueue	arrayblockingqueue
missingresourceexception	missingresourceexception
add	add
mag	mag
compare	compare
cp	cp
b	b
zip	zip
event	event
filehandler	filehandler
header	header
url	url
choices	choices
comparator	comparator
ob	ob
external	external
command	command
substring	substring
authentication	authentication
fileinputstream	fileinputstream
seed	seed
angdeg	angdeg
wildcardtype	wildcardtype
rbcollationtables	rbcollationtables
hold	hold
concurrentmap	concurrentmap
directionality	directionality
breakiterator	breakiterator
mirrored	mirrored
garbagecollectormxbean	garbagecollectormxbean
numberformatprovider	numberformatprovider
carry	carry
poll	poll
authenticate	authenticate
interruptibly	interruptibly
subtract	subtract
scheduledexecutorservice	scheduledexecutorservice
message	message
same	same
ctry	ctry
modifiable	modifiable
cookiehandler	cookiehandler
should	should
regex	regex
register	register
actual	actual
synchronizer	synchronizer
populated	populated
socketpermissioncollection	socketpermissioncollection
cachekey	cachekey
times	times
consonant	consonant
pre	pre
identityhashmap	identityhashmap
select	select
record	record
before	before
abstractitr	abstractitr
filterinputstream	filterinputstream
quotient	quotient
level	level
lang	lang
enumeration	enumeration
halt	halt
unlink	unlink
allow	allow
collator	collator
indexes	indexes
comments	comments
return	return
t	t
unlock	unlock
th	th
collation	collation
override	override
retain	retain
primary	primary
lazy	lazy
executorservice	executorservice
atomicboolean	atomicboolean
mcnode	mcnode
urlconnection	urlconnection
collationelementiterator	collationelementiterator
changed	changed
node	node
radians	radians
quoted	quoted
idn	idn
rm	rm
symbol	symbol
bindpoint	bindpoint
assertion	assertion
dependent	dependent
pool	pool
reduction	reduction
closed	closed
kkey	kkey
cache	cache
contenthandlerfactory	contenthandlerfactory
zipfile	zipfile
status	status
result	result
resource	resource
temp	temp
priorityblockingqueue	priorityblockingqueue
pending	pending
down	down
authority	authority
updater	updater
fulfill	fulfill
conditionalspecialcasing	conditionalspecialcasing
expunge	expunge
commit	commit
normalizer	normalizer
now	now
propertypermissioncollection	propertypermissioncollection
appendable	appendable
instrumentation	instrumentation
args	args
chararraywriter	chararraywriter
jarinputstream	jarinputstream
decimalformatsymbolsprovider	decimalformatsymbolsprovider
server	server
param1	param1
delta	delta
errormanager	errormanager
utf	utf
atan	atan
ensure	ensure
lookup	lookup
mark	mark
navigablesubmap	navigablesubmap
urlstreamhandler	urlstreamhandler
j	j
scheduledfuture	scheduledfuture
proxyselector	proxyselector
cb	cb
alt	alt
free	free
grouping	grouping
inet	inet
union	union
service	service
submap	submap
clock	clock
d1	d1
lo	lo
by	by
slash	slash
group	group
time	time
properties	properties
finished	finished
src	src
genericdeclaration	genericdeclaration
spin	spin
zipentry	zipentry
executors	executors
comp	comp
release	release
bufferedoutputstream	bufferedoutputstream
day1	day1
outputstream	outputstream
utfspan	utfspan
unknownformatconversionexception	unknownformatconversionexception
unnormalized	unnormalized
specific	specific
resourcebundle	resourcebundle
step	step
bits	bits
divide	divide
urlc	urlc
find	find
pipedoutputstream	pipedoutputstream
added	added
entries	entries
defined	defined
alive	alive
sb	sb
const	const
sqrt	sqrt
exiting	exiting
absolute	absolute
flip	flip
ylen	ylen
sockethandler	sockethandler
configuration	configuration
stacktraceelement	stacktraceelement
normalized	normalized
string	string
current	current
nfloats	nfloats
r	r
retransform	retransform
equals	equals
waiting	waiting
peek	peek
nif	nif
inf	inf
entry	entry
live	live
offsets	offsets
report	report
interaction	interaction
heap	heap
holder	holder
saddr	saddr
day	day
m	m
action	action
thrown	thrown
rqst	rqst
copies	copies
basecalendar	basecalendar
normalize	normalize
bi	bi
stream	stream
socketimpl	socketimpl
rulebasedcollationkey	rulebasedcollationkey
encoding	encoding
child	child
arrays	arrays
redefined	redefined
finest	finest
unshared	unshared
pair	pair
locale	locale
severe	severe
one	one
q	q
send	send
permits	permits
referencequeue	referencequeue
workers	workers
monitors	monitors
io	io
of	of
being	being
language	language
os	os
inet6address	inet6address
embeddings	embeddings
o1	o1
mutablebiginteger	mutablebiginteger
consolehandler	consolehandler
enumconstantnotpresentexception	enumconstantnotpresentexception
number	number
factory	factory
invocation	invocation
offer	offer
nibble	nibble
lowest	lowest
bit	bit
token	token
min	min
mathcontext	mathcontext
terminated	terminated
a	a
response	response
urlencoder	urlencoder
interrupts	interrupts
inthashtable	inthashtable
usage	usage
daemon	daemon
least	least
concurrent	concurrent
cacheentry	cacheentry
eras	eras
ccloverridden	ccloverridden
desc	desc
blockdatainputstream	blockdatainputstream
socketaddress	socketaddress
blocker	blocker
infinite	infinite
queue	queue
transferstack	transferstack
destroyed	destroyed
checksum	checksum
transition	transition
codesource	codesource
enable	enable
block	block
object0	object0
dateformatprovider	dateformatprovider
tertiary	tertiary
differ	differ
threadfactory	threadfactory
prefs	prefs
streamtokenizer	streamtokenizer
arg	arg
acquires	acquires
default	default
define	define
declared	declared
atomicstampedreference	atomicstampedreference
delegate	delegate
limit	limit
rule	rule
enumerate	enumerate
group0	group0
scheme	scheme
candidate	candidate
run	run
o	o
debugtraceinfostack	debugtraceinfostack
mbeanserverconnection	mbeanserverconnection
allowuserinteraction	allowuserinteraction
end	end
higher	higher
scheduled	scheduled
preferred	preferred
get	get
fits	fits
managementfactory	managementfactory
check	check
classdefinition	classdefinition
anchor	anchor
multiplicand	multiplicand
lehmer	lehmer
out	out
dest	dest
use	use
newmode	newmode
bitset	bitset
characteriterator	characteriterator
reachable	reachable
filedescriptor	filedescriptor
opt	opt
padding	padding
order	order
sortedmap	sortedmap
sci	sci
lockinfo	lockinfo
utfchar	utfchar
root	root
marked	marked
collection	collection
xlen	xlen
atomicreference	atomicreference
set	set
rep	rep
take	take
classloadingmxbean	classloadingmxbean
urgent	urgent
traces	traces
successor	successor
clean	clean
transform	transform
baselevel	baselevel
checkedmap	checkedmap
integral	integral
escaped	escaped
methods	methods
declaring	declaring
rotate	rotate
fence	fence
tanh	tanh
principal	principal
abstractqueuedlongsynchronizer	abstractqueuedlongsynchronizer
bytearrayinputstream	bytearrayinputstream
unread	unread
unmodifiable	unmodifiable
instantiable	instantiable
init	init
channel	channel
address	address
jarentry	jarentry
shared	shared
flags	flags
raw	raw
suid	suid
delayed	delayed
using	using
sealed	sealed
d	d
oobinline	oobinline
layout	layout
readable	readable
ox	ox
dataoutput	dataoutput
exception	exception
inetaddr	inetaddr
stringbuilderhelper	stringbuilderhelper
eq	eq
continue	continue
boolean	boolean
x	x
readwritelock	readwritelock
item	item
and	and
direction	direction
queued	queued
old	old
inclass	inclass
period	period
read	read
concurrentnavigablemap	concurrentnavigablemap
hashtable	hashtable
mev	mev
crc	crc
deflater	deflater
executable	executable
char	char
concurrentskiplistmap	concurrentskiplistmap
logrb	logrb
passes	passes
mbean	mbean
arch	arch
validation	validation
build	build
task	task
bidi	bidi
unmodifiablerandomaccesslist	unmodifiablerandomaccesslist
invariants	invariants
receive	receive
subclass	subclass
loggable	loggable
l	l
export	export
treeinfo	treeinfo
cancel	cancel
category	category
srcpos	srcpos
cl	cl
classdataslot	classdataslot
rules	rules
other	other
fallback	fallback
reuse	reuse
parties	parties
serversocket	serversocket
nt	nt
first	first
illegalformatcodepointexception	illegalformatcodepointexception
objectinputvalidation	objectinputvalidation
comparable	comparable
expm1	expm1
rulebasedbreakiterator	rulebasedbreakiterator
annotatedelement	annotatedelement
exponential	exponential
chararrayreader	chararrayreader
control	control
timeout	timeout
upper	upper
limits	limits
numeric	numeric
locales	locales
enumset	enumset
publish	publish
unpark	unpark
high	high
preference	preference
pin	pin
compositedata	compositedata
hashentry	hashentry
unmodifiablelist	unmodifiablelist
half	half
libname	libname
reference	reference
compiler	compiler
sift	sift
constants	constants
socketchannel	socketchannel
attempt	attempt
cached	cached
deep	deep
positive	positive
hybrid	hybrid
loader	loader
filter	filter
unpack	unpack
holdcounter	holdcounter
cancelled	cancelled
parseexception	parseexception
decimalformat	decimalformat
needs	needs
qname	qname
modifiers	modifiers
classloader	classloader
multiplier	multiplier
attributedstring	attributedstring
interface	interface
atomicreferencefieldupdater	atomicreferencefieldupdater
mcsite	mcsite
requires	requires
supported	supported
u	u
propagate	propagate
qnode	qnode
threadinfo	threadinfo
gzipinputstream	gzipinputstream
arguments	arguments
contract	contract
monitorinfo	monitorinfo
securecacheresponse	securecacheresponse
mso	mso
mlen	mlen
cacherequest	cacherequest
crc32	crc32
mcastaddr	mcastaddr
width	width
bind	bind
checkedinputstream	checkedinputstream
superclass	superclass
parameters	parameters
range	range
platform	platform
scale	scale
leave	leave
intern	intern
remainder	remainder
nh	nh
resources	resources
array	array
encode	encode
em	em
roots	roots
termination	termination
leading	leading
row	row
abstractpreferences	abstractpreferences
remote	remote
attrs	attrs
local	local
jar	jar
international	international
executor	executor
writelock	writelock
byte	byte
invocationtargetexception	invocationtargetexception
memorynotificationinfo	memorynotificationinfo
descriptor	descriptor
rest	rest
expected	expected
checkfpx	checkfpx
marker	marker
data	data
save	save
digitlist	digitlist
w	w
latency	latency
signum	signum
amount	amount
stale	stale
letter	letter
subtree	subtree
rbtablebuilder	rbtablebuilder
rejectedexecutionhandler	rejectedexecutionhandler
formatted	formatted
req	req
am	am
modifier	modifier
nanos	nanos
concurrenthashmap	concurrenthashmap
secure	secure
succ	succ
bootstrap	bootstrap
ends	ends
maddr	maddr
tarray	tarray
blockingdeque	blockingdeque
lifo	lifo
do	do
flgs	flgs
decrement	decrement
exceeded	exceeded
empty	empty
random	random
writethroughentry	writethroughentry
obj	obj
dependency	dependency
abstractmap	abstractmap
exponent	exponent
manifestentryverifier	manifestentryverifier
dst	dst
exchanger	exchanger
mtu	mtu
trailing	trailing
unmask	unmask
portlist	portlist
zipoutputstream	zipoutputstream
reset	reset
bufferedinputstream	bufferedinputstream
owned	owned
objectoutput	objectoutput
fields	fields
inheritablethreadlocal	inheritablethreadlocal
authenticator	authenticator
version	version
seq	seq
park	park
files	files
filechannel	filechannel
inetaddress	inetaddress
exceptionininitializererror	exceptionininitializererror
protocol	protocol
abstractownablesynchronizer	abstractownablesynchronizer
arraydeque	arraydeque
pred	pred
hook	hook
new	new
treeset	treeset
zone	zone
timezone	timezone
phantomreference	phantomreference
simpleimmutableentry	simpleimmutableentry
boundary	boundary
urldecoder	urldecoder
shutdown	shutdown
permissions	permissions
mto	mto
insensitive	insensitive
messageformat	messageformat
serialize	serialize
dictionary	dictionary
redefine	redefine
super	super
two	two
transferqueue	transferqueue
inflate	inflate
non	non
final	final
utflen	utflen
line	line
redirects	redirects
compilation	compilation
stack	stack
rel	rel
console	console
filesystem	filesystem
re	re
unit	unit
millis	millis
orig	orig
escape	escape
dateformat	dateformat
semaphore	semaphore
audit	audit
xmlsupport	xmlsupport
emit	emit
prim	prim
mask	mask
abstractplainsocketimpl	abstractplainsocketimpl
cookies	cookies
content	content
merge	merge
rename	rename
value	value
query	query
compatible	compatible
z	z
cyclicbarrier	cyclicbarrier
children	children
abstractqueue	abstractqueue
atomicintegerfieldupdater	atomicintegerfieldupdater
threadgroup	threadgroup
char1	char1
bigdecimal	bigdecimal
vendor	vendor
randomaccessfile	randomaccessfile
incompleteannotationexception	incompleteannotationexception
ex	ex
bytes	bytes
certificates	certificates
put	put
urls	urls
eventlistener	eventlistener
leap	leap
tclass	tclass
canonical	canonical
pipedwriter	pipedwriter
finalizers	finalizers
highest	highest
conditionobject	conditionobject
call	call
only	only
parameter	parameter
input	input
japaneseimperialcalendar	japaneseimperialcalendar
java	java
seconds	seconds
navigablemap	navigablemap
security	security
socketoptions	socketoptions
app	app
n	n
callerrunspolicy	callerrunspolicy
linenumberreader	linenumberreader
observers	observers
the	the
atomiclongfieldupdater	atomiclongfieldupdater
xmlformatter	xmlformatter
slots	slots
concat	concat
observer	observer
isocontrol	isocontrol
locks	locks
slot	slot
entryfuture	entryfuture
past	past
sortedset	sortedset
path	path
uncaughtexceptionhandler	uncaughtexceptionhandler
simpletimezone	simpletimezone
component	component
elements	elements
roundingmode	roundingmode
signal	signal
shift	shift
atom	atom
waiter	waiter
augend	augend
interfaceaddress	interfaceaddress
prio	prio
concurrentskiplistset	concurrentskiplistset
exists	exists
awt	awt
datagramsocketimplfactory	datagramsocketimplfactory
uid	uid
csize	csize
jumboenumset	jumboenumset
sub	sub
caches	caches
canon	canon
listresourcebundle	listresourcebundle
actions	actions
floor	floor
initialize	initialize
ieeeremainder	ieeeremainder
urlstreamhandlerfactory	urlstreamhandlerfactory
nodechangeevent	nodechangeevent
simpleentry	simpleentry
enc	enc
key	key
enclosing	enclosing
to	to
test	test
constructors	constructors
exclusively	exclusively
sz	sz
that	that
compact	compact
at	at
constructor	constructor
illegalformatflagsexception	illegalformatflagsexception
flush	flush
privileged	privileged
threshold	threshold
mulsub	mulsub
internal	internal
average	average
instructions	instructions
host	host
performance	performance
words	words
peak	peak
scalb	scalb
search	search
has	has
yield	yield
bdividend	bdividend
dataoutputstream	dataoutputstream
desired	desired
cas	cas
hash	hash
reentrantlock	reentrantlock
lenient	lenient
closeable	closeable
values	values
u1	u1
cs	cs
collationkey	collationkey
certainty	certainty
capacity	capacity
iterators	iterators
months	months
mergecollation	mergecollation
dstsavings	dstsavings
prev	prev
reflect	reflect
ignorable	ignorable
countdownlatch	countdownlatch
cmdarray	cmdarray
significant	significant
prestart	prestart
predecessor	predecessor
waiters	waiters
doubles	doubles
futuretask	futuretask
enabled	enabled
id	id
engineering	engineering
pcl	pcl
odd	odd
usecaches	usecaches
big	big
keys	keys
coll	coll
pattern	pattern
contains	contains
pushbackinputstream	pushbackinputstream
validationlist	validationlist
fp	fp
code	code
choiceformat	choiceformat
spec	spec
sleep	sleep
color	color
pop	pop
radix	radix
interrupted	interrupted
make72safe	make72safe
while	while
main	main
processors	processors
cl1	cl1
externally	externally
as	as
addr	addr
hashset	hashset
probable	probable
requesting	requesting
prompt	prompt
system	system
decode	decode
misc	misc
unmodifiableentryset	unmodifiableentryset
numberformat	numberformat
enum	enum
fielddelegate	fielddelegate
cacheresponse	cacheresponse
len	len
v	v
domain	domain
c2	c2
user	user
name	name
try	try
navigable	navigable
multicastsocket	multicastsocket
reload	reload
pushbackreader	pushbackreader
near	near
convert	convert
csq	csq
enummap	enummap
next	next
site	site
ascii	ascii
connect	connect
ids	ids
output	output
factor	factor
ordinal	ordinal
abstractcollection	abstractcollection
round	round
outputstreamwriter	outputstreamwriter
charbuffer	charbuffer
cl2	cl2
existing	existing
an	an
lhs	lhs
pack200	pack200
inetsocketaddress	inetsocketaddress
apply	apply
handlers	handlers
serversocketchannel	serversocketchannel
ze	ze
val	val
linkedlist	linkedlist
annotation	annotation
str	str
positions	positions
compressed	compressed
spine	spine
keep	keep
cutover	cutover
scheduledthreadpoolexecutor	scheduledthreadpoolexecutor
finish	finish
occurrence	occurrence
gzipoutputstream	gzipoutputstream
gmtoffset	gmtoffset
document	document
logp	logp
scanner	scanner
future	future
valid	valid
finalization	finalization
when	when
stop	stop
objectstreamclass	objectstreamclass
recalculate	recalculate
pathname	pathname
ready	ready
dispatch	dispatch
log	log
port	port
size	size
iter	iter
laddr	laddr
ignore	ignore
undeclared	undeclared
cmp	cmp
property	property
zero	zero
most	most
prime	prime
update	update
descending	descending
iaddr	iaddr
fully	fully
e5	e5
directory	directory
fair	fair
f	f
buf	buf
headers	headers
filenamemap	filenamemap
mapping	mapping
validate	validate
sort1	sort1
loopback	loopback
signers	signers
unicodeblock	unicodeblock
taskqueue	taskqueue
monitoring	monitoring
expiry	expiry
atomiclong	atomiclong
runnablefuture	runnablefuture
another	another
integer	integer
pcerts	pcerts
deletion	deletion
jarfile	jarfile
synchronized	synchronized
option	option
initargs	initargs
offset	offset
zipinputstream	zipinputstream
fwd	fwd
whitespace	whitespace
streaming	streaming
from	from
unsigned	unsigned
so	so
linkedblockingqueue	linkedblockingqueue
datagramsocketimpl	datagramsocketimpl
inflater	inflater
minimum	minimum
vector	vector
hashmap	hashmap
matcher	matcher
cpu	cpu
removed	removed
sinh	sinh
delete	delete
chain	chain
abstractlist	abstractlist
socketpermission	socketpermission
negate	negate
total	total
vecswap	vecswap
remove	remove
implies	implies
stringbuffer	stringbuffer
certs	certs
parseposition	parseposition
localized	localized
passwordauthentication	passwordauthentication
hours	hours
atomic	atomic
printwriter	printwriter
available	available
mul	mul
julian	julian
g	g
dump	dump
loading	loading
with	with
tokens	tokens
charsequence	charsequence
chars	chars
roll	roll
abbr	abbr
exit	exit
active	active
all	all
serviceloader	serviceloader
sign	sign
anchoring	anchoring
param	param
u2	u2
region	region
currency	currency
ucompactintarray	ucompactintarray
runtimemxbean	runtimemxbean
parameterizedtype	parameterizedtype
cookie	cookie
insert	insert
handle	handle
mode	mode
preferencechangeevent	preferencechangeevent
xml	xml
exact	exact
multicast	multicast
names	names
currencynameprovider	currencynameprovider
responsecache	responsecache
worker	worker
httpcookie	httpcookie
bounds	bounds
pipedreader	pipedreader
original	original
execute	execute
prefixes	prefixes
store	store
stringbufferinputstream	stringbufferinputstream
wait	wait
can	can
threadlocal	threadlocal
password	password
preceding	preceding
ints	ints
quote	quote
contenthandler	contenthandler
types	types
cowiterator	cowiterator
precision	precision
printstream	printstream
utfbody	utfbody
body	body
thai	thai
lucas	lucas
patternentry	patternentry
uninterruptibly	uninterruptibly
bufferedreader	bufferedreader
traffic	traffic
inflaterinputstream	inflaterinputstream
caused	caused
cookiemanager	cookiemanager
instrument	instrument
fill	fill
seal	seal
gcd	gcd
insertion	insertion
manifest	manifest
periodic	periodic
copy	copy
spi	spi
