dist	wheel non-wheel potential useful entry dist-info abstracts distributions style installed sys locator vs actual logic wrap path prepare_files finds w/metadata
aggregating	and/or chain allows list merge locators class
skip	undefined text skipping token found expression matched
results	access multiple means provide list structured - results parse (c{len }) data parsed
manager	google necessary defined app manage socks connections manager via connect poolmanager, extraction proxymanager behaves :class sandbox sends version https method transparently engine track urllib3 applications proxy using packages keeping resource like allows routes connection urls arbitrary pools requests
go	advance useful column text specific token scraping report input tabular
alt	san certificate missing warned host connecting
graph	represents distributions graph dependency
show	installed information one packages show
environment	search used name searchable attempted inside environment exist path snapshot distributions
to	'write()' tty useful text sequences tabular skipping strip character input method outputting ansi report matched implements advance convert undefined column scraping specific windows token found expression
unrewindable	body rewind urllib3 encountered error requests trying
fatal	thrown content exception user-throwable parse inconsistent
codepoint	exception used codepoint valid context unallocated disallowed
string	parse delimited string matches quoting end strings current token characters position beginning matching
locked	raised made attempt unlocked locking unlock file thread/process
level	object writing file reading supports low-level
list	including packages list editables installed
iter	class iterator
defaults	use formatter help configoptionparser custom
enhance	c{parserelement}, abstract post-processing subclass tokens combining parsed
dir	conflicting raised there's build directory previous
dirs	dirs application convenience wrapper getting
zero	expression zero repetition optional given
download	specifiers requirement - pypi indexes download using packages
index	represents index python package pypi compatible class
errors	multiple rolled reporting one instances hasherror
pep440warning	specifier used complying 440 pep version issue
decoding	decode failed content response
importer	submodules six importer meta import path moves
version	raised already up-to-date number unsupported installed already-installed set requirements requires-python unknown pep invalid version rational parameter refer requested users python 440 versionconflict conflicts third package required accepts according found distribution metadata
unpinned	specific requirement hash pinned version specified
new	econnrefused raised usually connection fail new establish
method	keys lists tuples 2 initiation sets dict converted properties special
metadata	pkg-info conflictual number legacy implementation unknown invalid write 0 json version provider usage : metadata files missing read handler uses 2 attempt standalone fields directories required value release egg
body	body fp httplib (have like attribute rewind urllib3 encountered error httpresponse requests trying
completion	completion used command helper
hash	:cvar requirement don't int one instances file specified hash difficulty archive provided needed verify pinned rolled version hasherror local method match multiple version-control-system-based reporting failure hashes hashing absent exception sorting compute package specific classes values known-good distribution order
address	object generic ip error related value address
path	requirement set useful submodules installed locator meta file moves distributions paths six importer provider usage import : metadata sys path removed represents egg directories uninstallation typically finds
search	whose search name contains pypi summary <query> packages
property	replaces computed attribute per instance ordinary property
items	lazy loading moved objects
changed	raised existing request foreign host gets pool
maker	specifications create callable source scripts copy class
buffered	buffering streams
followed	given lookahead parse c{followedby} expression matching
extra	doesn't given name "extra feature" distribution
app	dirs engine manager google getting app connection wrapper application convenience sandbox applications
serialize	serialized tree error
fake	list make object lines wrap readline() happy configparser
marker	users pep invalid 508 marker found refer
regex	given strings token regular expression matching match
tar	exception iterator tar holds tarfile given archive member header base details provides interface informational class block archives
httpadapter	http adapter built-in urllib3
handler	around releases python work bug 3 2 x class
type	represents ext msgpack type exttype
more	given expression one zero repetition optional
mismatch	hash don't values file distribution match
normalized	version rational
socket	python openssl's connection-class wrapper api-compatibility
idnabidi	bidirectional exception requirements satisfied
word	composed preceded set word followed matches sets character given c{wordchars} current token words allowed position end beginning matching
modified	heuristic already last-modified expires back header fall using
install	specifiers requirement - pypi indexes install using packages
my	raised made attempt else unlock someone file locked
sqlite	demonstrate sql-based locking
stream	operations already stream stdout attribute unsupported detection 'r|*') unicode stream-like (mode content wraps compression tarfile class access acting provides tarfiles method 'write()', object htmltokenizer proxy characters interface delegated buffering transparent apart exception adapter serves streams small response enables consumed
lock	raised lock creation period attempts sql-based atomic file fails locking access failed 2 time within creating locked acquire symlink else reason base link using class made attempt user-defined someone classes unlock error directory demonstrate property arising platform-specific
incremental	encoder “push”-based decoder
sslcontext	object pyopenssl responsible wrapper context class
requirements	raised requirements parsing file error line general occurs
recursive	thrown exception grammar recursive could validate} l{parserelement improperly
six	submodules moved urllib_robotparser meta moves loading urllib_error create six namespace importer urllib 3 urllib_parse import lazy python objects path urllib_request urllib_response resembles
sig	registers finish calls signal sigint handler
config	option checking parser custom updates defaults
abstraction	wheel non-wheel abstracts vs logic prepare_files
max	retries raised exceeded maximum number
insecure	available platform certain request ssl https warned making configuration unverified
after	defined cache period time **all** requests
mapping	keys objects mapping file selector
mixin	registers finish publish/subscribe calls simple signal sigint system called handler ensure helper keyboard interrupt finish() gets self
end	parse given set end string followed matches word within character c{wordchars} current position line
hashes	actual requirement used workalike builds missing hashmissing wrapper computes we're multiple hashes checks hash raises
httpheader	field-value headers pairs :param iterable
attempt	function exception attempt target normal may depending value return call end encapsulates
element	level parsed abstract parser post-processing subclass element tokens base combining c{parserelement}, class
callback	fp execute around callback read object tee wrapper everything buffer file small closed
egg	files provided based created *path* filesystem virtual file provider directory egg-info egg metadata
uninstall	paths requirement set file uninstall packages removed uninstallation
jsonlocator	available performant distlib extended basis pypi locator uses dependency resolution special metadata
iresource	access object resources provides package
help	use verbose prettier/less show optparse commands custom configoptionparser formatter help
installed	provided raised already legacy package whether *path* created pep up-to-date installed directory version base dist-info distributions class 376
group	c{l{zeroormore}} return converter returning - c{l{oneormore}} list tokens useful expressions matched
platform	available ssl warned platform certain configuration
python	package python according unsupported requires-python version metadata
safe	even accessible use cache based target may safe writable file directory
auth	given derive http object request auth authentication base implementations basic attaches class digest proxy
not	composed body raised set words attribute requirement parse see fp file c{notany} chunks httpresponse (have matching provided given exclusion unlocked i{not} - listed include satisfy requested someone read needs disallow cannot characters locked else response matched httplib made attempt like lookahead unlock order whitespace token found distribution chunked expression example
day	expires cache day 1 future providing response
httplib	body fp httplib like attribute (have httpresponse
grammar	thrown exception grammar recursive could validate} l{parserelement improperly
name	used name certificate missing attempted inside environment host exist warned connecting san
caseless	case letters string l{keyword} ignoring token version specified caseless match
win32	implements 'write()' tty outputting windows text sequences character convert ansi strip method
token	c{parseexpression}, abstract results subclass parsed patterns c{parserelement} converting defining matching atomic
mode	binary opened text length determined mode file requests
timeout	raised lock creation period connect fails configuration send invalid state connecting allotted receiving occurs within error trying data remote socket request user-defined server amount timeout time timed passing
each	found given requires order c{parseexpression}s
found	satisfy requested raised requirement cannot found distribution
manifests	zip builder zipfile manifests memoized manifest
unlock	errors lock attempts base release arising class
meta	submodules six importer meta import path moves
ex	archive member object reading file-like
httpproxy	given http object request authentication proxy attaches
extract	exception errors extract general
event	simple publish/subscribe system
special	raised e g kind copying operation trying
container	container dict-like keys away maintains throwing maxsize provides least-recently-used beyond thread-safe
network	generic ip object network
req	map requirement extras demanded
content	decode failed content response
ipv4network	represents 32-bit manipulates network + ipv4 class addresses
vcs	provided requirement hash don't version-control-system-based method hashing
eofheader	headers exception end file
base	objects lock abstract implementations installed legacy file distributions transport derive monitored network registering generic pep ipv4 ip supports object auth selector 376 base parsing class exception whether adapter ipv6 classes mother exceptions runtime platform-specific
cookie	cookies cookiejar criteria jar two class exposes cookie specified meet compatibility cookielib dict
proxy	raised stream sends detection 'r|*') connect (mode poolmanager, fails compression proxymanager support behaves :class supplied transparent defined https scheme method occurred proxy interface using class like connection urls error small requests enables
htmlunicode	characters stream htmltokenizer unicode provides
dispatcher	keys lists tuples 2 initiation sets dict converted properties special
filter	inline style sanitization xhtml+mathml+svg attributes
int	registers finish calls signal sigint handler
first	c{parseexpression} found requires least one
already	raised already package locking up-to-date installed version file thread/process
encoding	mini declared associated methods extra chunk parser meta elements encoding character invalid decoding various utf-8 sent used reresents object detecting string-like server position chunked
unsupported	wheel provided requirement requires-python hash don't version-control-system-based package according unsupported python version metadata method hashing
one	given providing cache expires one 1 future repetition expression response day
open	object pyopenssl responsible wrapper context class
script	specifications create callable source scripts copy class
unknown	doesn't given name proxymanager support supplied "extra feature" distribution scheme
mkdir	directory lock creating file
system	warned wrong system suspected time
wrapper	stream stdout attribute tee file wraps wrapper access everything acting closed method 'write()', fp around read object buffer proxy delegated transparent apart execute callback small
response	contains moved supplied chunks addinfourl moves wraps loading container six :class urllib lazy used http <response> read object needs reason objects maxretryerror httpmessage response httplib request server's mimic urllib_response error chunked order
too	many redirects
wrapped	python openssl's connection-class wrapper api-compatibility
white	ignored whitespace class normally matching special
scheme	proxymanager support scheme supplied
schema	http defaults g missing url py see valid https e schemas schema
ipv4address	represent single ipv4 manipulate addresses
option	option checking parser custom updates defaults
selector	monitored registering keys abstract mapping selector objects file supports class
netmask	netmask related value error
updating	use formatter help configoptionparser custom
keyword	l{keyword} followed string keyword exactly character caseless non-keyword token version specified immediately match must
scraping	locate downloads scrapes locator html distribution pages
tree	implementation base treebuilder
and	found given requires order c{parseexpression}s
null	302 pep loaders try arbitrary implement resources metadata
any	given lookahead disallow parse c{notany} expression matching
build	conflicting raised there's build directory previous
httpsconnection	httplib based socket :class wraps https httpsconnection httpconnectionpool,
exec	raised executed command could
chars	composed provided given set words see i{not} - exclusion example token listed characters matched include matching whitespace
expires	defined cache period time **all** requests
evaluator	python limited evaluator expressions
httpwarning	base warning module used
dummy	failed import used detect connectioncls
url	provided requirement used hash don't version-control-system-based somehow invalid return url datastructure value http representing method hashing
consumed	content consumed already response
request	associated preparedrequest moved implement moves unverified wraps loading container parameters data six :class convenience containing https mutable method sent body lazy user-created ~urllib3 urlopen <preparedrequest> object urllib2 occurred bytes objects mixin base exact requests ambiguous exception handling poolerrors urllib_request fully request server mimic classes urls warned making <request> :meth
bz2proxy	"r support object modes "w bz2" proxy file small enables class external
ext	represents ext msgpack type exttype
httpbasic	given http object request authentication basic attaches
incomplete	doesn't content-length subclass length expected http_client response match
pirpclocator	locate locator uses therefore xml-rpc distributions
ipv6address	represent single addresses manipulate ipv6
socksproxy	via defined proxymanager urllib3 socks connections version proxy routes
syntax	thrown l{errorstop<and internally like l{parsefatalexception},
session	requests session
urllib	lazy loading urllib_error urllib_request namespace create six moved urllib_robotparser urllib python 3 objects urllib_response resembles urllib_parse moves
pyparsing	development l{reals<real>}, (l{integers<integer>}, useful may parser - numeric forms notation<sci_real>}) common jump-starting expressions l{scientific low-level
redirect	around releases python work bug 3 2 x class
cache	accessible simple writable see names file need distributions even paths use based cache system response 1 live dist-info resources expires may safe mapping implementing interface class e target installs request cached future directory day wheels providing
jar	cookiejar class exposes dict compatibility cookielib
failed	lock reason creation file failed
only	parse ensure actions wrapper called
dict	pairs object return converter dictionary headers repetitive list order also :param lookup insertion case-insensitive field-value expression remembers iterable dict-like
pretty	optparse formatter verbose prettier/less help
info	tar header file wrap archive provided given holds member potential details dist-info style sys egg-info w/metadata path class actual created *path* directory entry informational block
contextual	set requirements third python zipfile support required accepts versionconflict installed manager supplement context 6 2 distribution parameter class
formatter	use verbose prettier/less optparse custom configoptionparser formatter help
resource	files resource zip in-package data manage system extraction resources file packages representing class finder
cached	replaces computed attribute per instance ordinary property
bytes	associated methods extra object various position string-like
bad	virtualenv found raised command
common	development l{reals<real>}, (l{integers<integer>}, useful may parser - numeric forms notation<sci_real>}) common jump-starting expressions l{scientific low-level
requirement	requirement users pep invalid parse 508 found refer
set	paths requirement set similar list collection sys file active path removed distributions uninstallation
packer	packer usage messagepack
module	lazy loading urllib_error urllib_request namespace create six moved urllib_robotparser urllib python 3 objects urllib_response resembles urllib_parse moves
freeze	output format packages requirements installed
interruptible	helper self finish() keyboard interrupt ensure gets called
legacy	release legacy metadata
close	matches variation mismatching 'n' characters "close" l{literal} strings
htmlpage	url represents along page one
best	raised already package up-to-date installed version
subject	san certificate missing warned host connecting
subsequent	headers exception extended invalid missing
pijsonlocator	limited pypi's it's locator json uses interface functionality
filename	wheel invalid filename
state	raised timeout passing invalid state
closed	raised enters request closed pool
httperror	exception used http occurred module base error
recently	container dict-like keys away maintains throwing maxsize provides least-recently-used beyond thread-safe
missing	absent requirement used hash g missing url required http hashmissing needed computes raises we're https e hashes schema workalike actual metadata
configuration	files loading within handles accessing configuration interface providing data
optional	expression given optional matching
idnaerror	exception base problems related idna-encoding
installation	exception installation general
many	many redirects
adapter	adapter base transport
connection	econnrefused raised detect import :class occurred new failed connection used base error pools connectioncls fail usually establish class
context	exception valid used codepoint context
requests	cookiejar class exposes base dict requests warning compatibility cookielib
expression	abstract post-processing parserelement tokens subclass combining parsed
point	object representing importable advertised
simple	locate downloads scrapes locator html distribution pages
header	provided exception errors missing log headers convert truncated somehow invalid raised header base value statement assert_header_parsing extended warning empty
linux	information distribution provides linux
pidlock	pid unix lockfile implemented file
robotparser	lazy loading six moved urllib_robotparser objects moves
py	locate limited object pypi's it's pyopenssl responsible wrapper locator json uses therefore context interface functionality xml-rpc distributions class
extraction	extracting resource occurred error
literal	case letters string exactly ignoring token specified match
httpconnection	httplib based httpconnection extra host one connection provides constructor thread-safe pool
empty	exception raised runs pool always allowed returns connections headers token empty provider nothing requests match
engine	engine google applications app manager sandbox connection
suppress	parsed expression results converter ignoring
controller	interface cached see request
last	heuristic already last-modified expires back header fall using
case	case-insensitive object dict-like
exception	validate} user-throwable don't supported parsing parse inconsistent expressions improperly l{parsefatalexception}, content match l{errorstop<and occurred base grammar class like thrown ambiguous exception handling internally name recursive could request l{parserelement exceptions attributes runtime
snimissing	available warned request sni without https making
value	raised url error wrong related netmask value address input given something
finder	files locate resource zip system dependencies resources file packages distributions finds finder
error	operations :cvar executed retryerror caused satisfied existing attempts previous loading based specified failed there's assert_header_parsing passing encapsulates sent arguments within read get_host exception poolerrors cannot runs sorting resource fields server timeout known-good release automatic e cookies right methods truncated chunk related connections used stream-like fail operation extract happens fails errors container unavailable command-line giving maxretryerror supplied decoding content state version connecting closed new tarfiles receiving occurs metadata body lazy hash missing difficulty host base cookie proxy address bidirectional log convert chunked last socket g package could reason foreign dependency connection objects urls logic usually requests content-type econnrefused raised already encoding jar conflictual number unsupported parsing header unexpected mid-request/response custom establish given compression unknown exceeded two response decode archives statement criteria empty acquire occurred failure netmask input installation line trying document retries kind tree maximum value headers classes encountered serialized error exceptions meet uninstallation similar consumed extracting associated tar int lock abstract unreadable moved general parse warning something file allowed pip moves archive requirements declared urllib_error verify six invalid parsed write instance build copying rewind gets conflicting extended urllib3 wrong registry end hashes data class pool attempt url resolution archiving required request command enters directory arising order
chunked	declared encoding read chunk needs invalid server order chunks chunked response sent
parse	raised six user-throwable don't abstract supported moved results parsing parse (c{len inconsistent file combining expressions moves }) parsed access fails loading requirements l{parsefatalexception}, provide structured - subclass content urllib_parse input means document occurs match lazy multiple l{errorstop<and get_host post-processing tokens base line general data class like thrown exception internally name c{parserelement}, url list parserelement objects error exceptions attributes runtime similar
ntlmconnection	implements ntlm urllib3 authentication connection version pool
in	composed set characters existing see individual file matching provided given exclusion i{not} - wrapper listed provides include around object part words data matched whitespace token thin example
verified	httpsconnection httplib based wraps socket
unrecognized	unknown version number metadata
conflict	cookies set conflictual installed already-installed specified requirements jar two write version criteria parameter metadata requested read cookie conflicts attempt third fields required accepts versionconflict meet distribution
wheel	wheel files requirements install installs cache pep requirementset unsupported filename future archives invalid file dependencies wheels class 427 build
used	container dict-like keys away maintains throwing maxsize provides least-recently-used beyond thread-safe
httpdigest	given http object request authentication attaches digest
v4	base ipv4 object
v6	base object ipv6
ipaddress	class mother
undefined	doesn't used name attempted support value environment exist invalid operation inside
builder	implementation requirementset treebuilder base build wheels
command	pointing preparedrequest redirection. manager query boolean. provided. whose send environment analogous sent uploaded .dist-info string ca_bundle entries exact list upload defaults cookies :build urllib3.httpresponse codecs.register value pass download append index directive abi specification supplied cookielib.cookiejar version certificates new method metadata body formatcontrol hash still-packed downloaded explore verified. threads path interpret wait search key/values 'foo cert base action add. options extra logical replace names marker apply use cookiejar e.g. handling. contains call archives type foo-2.1 directories. carrying controlling must none constraint install root control compare stream attribute sdist want none. returned information requirements rather verify positional located pathname parent_dir description specifications mapping collection validate. hashes hasher data response short documentation lines specifying allow file-like help .pem installed including still url-based cli actually platform defining return python auth urlretrieve subscribers get/options/post/put/patch/delete/head name pip.index.packagefinder timeout pools found enable/disable identifier constraints unquote domain schemes generation meta connect encodings relates extract event category ' publish content may evaluation (fieldname index. dictionary free hashed dependencies cookie proxy initialize byte generate logging ["33", e.g separator bytestring uploaded. origin encoding number one mvarfmt directly necessarily script proxymanager distributionpath least needed passed metavar configure tuple from. basic/digest/custom cache_dir specify '--format') file-like-objects hashlib sometimes-wanted scraping tree headers to. false (and - indexes instance ideal build provoked added object callable pair proxies :func ('-f', url removed request looked event's uninstall typically came show supported filename completion true, with. implementation cache :class dict passing local ('cert', exports get installrequirement connections pypi ssl user-provided requests.request resource keyword cached fields bytes remove summary default contain release valid requirement set relative see legacy multipart passphrase packed label written editables available <preparedrequest> packages optional commands false, equal connection context wheels header (#md5=...) 1.0 trust iterable described . subscriber json describes .whl enable worker applied look evaluated error pip.index.formatcontrol helper hosts trusted containing verified perhaps check member arguments wheel used http urls keys validate requests recent specifiers *dists* client command components protocol 'name': i/o unicode immediately source_dir pre-release also logged send() add belongs save match opt format read evaluate process. using insert server (or either output xml-rpc export superclass specified virtualenv describing signer's 'key') provider locators requestscookiejar file-tuple}) run seconds {'name': certificate package 'filename': compatible pip.download.pipsession constructor block raised requests-style parsing prepare :test long httplib.httpmessage we're <query> optionparser files form failure link trying true (assumed compute versions whether maximum signed limit signer distribution called associated pathnames file pip distributions archive pipe % prepend interested lookup pip.wheel.wheelcache requested urllib3 update parse. "32"], pool searches command-line algorithm normally extras fieldname .egg-info directory strings
entry	object representing importable advertised
unpacker	streaming unpacker
redirects	many redirects
protocol	happens mid-request/response raised unexpected something
quoted	delimited quoting strings token characters matching
ipv6network	represents manipulates class 128-bit ipv6 networks
previous	conflicting raised there's build directory previous
combine	concatenate converter tokens single matching string
location	raised fails url get_host given parse wrong something input similar
sslerror	fails certificate raised occurred ssl connection https error
input	characters stream htmltokenizer unicode provides
match	one c{parseexpression} least matches never variation mismatching token 'n' characters "close" found l{literal} requires strings match
uninstallation	exception uninstallation general
insensitive	case-insensitive object dict-like
xmlrpc	via provide xmlrpclib implementation pipsession transport
read	raised tar unreadable content-length subclass archive doesn't length send archives allotted expected receiving occurs match read cannot data response exception socket server amount timeout time http_client
memoized	memoized zipfile manifests
manifest	files exploring applying built list patterns various filesystem filtered find
security	warned security reducing actions perfoming
page	represents scraped html class page
specifier	specifier users 440 pep invalid found refer
methods	~urllib3 urlopen :class method convenience classes mixin implement :meth
truncated	headers exception truncated
httpresponse	container http response
transport	via provide xmlrpclib implementation pipsession transport
retry	retries raised right attempt retryerror failed giving exceeded maximum custom instance number retry logic last encapsulates configuration
provider	nothing based support arbitrary pep virtual loaders access returns provides provider eggs resources metadata 302 object zips requests resource package try filesystem implement
object	archive member object reading file-like
symlink	lock symlink access 2 file using
host	raised existing request foreign host gets pool
by	given lookahead parse c{followedby} expression matching
comparison	doesn't attempted support value invalid operation
working	distributions list collection sys active path similar
package	represents package python index pypi class compatible packages finds
column	advance useful column text specific token scraping report input tabular
compatible	body fp httplib like attribute (have httpresponse
dependency	locate represents made attempt missing graph module dependency dependencies optional warned import distributions
or	c{parseexpression} given expression least one zero optional found repetition requires
parsing	raised log convert warning statement assert_header_parsing
locator	useful chain allows scrapes installed locator distributions and/or locates things - class list html locators locate downloads base path pages tree merge directory distribution finds
compression	methods exception unavailable compression
decode	raised based content-type fails decoding automatic
start	parse preceded set word string matches within character given c{wordchars} current position line : beginning example
low	object writing file reading supports low-level
forward	used recursive notation defined later - algebraic grammars declaration forward infix expression
urlrequired	url make valid request required
zip	files resource zip python builder support zipfile manifest eggs zips manager supplement finder context 6 memoized 2 manifests class resources
htmlbinary	characters stream htmltokenizer unicode provides
encoder	“push”-based encoder
htmltokenizer	tokenizing care html class takes
link	lock access 2 link atomic file using property
decoder	“push”-based decoder
line	parse end string matches within current position line : beginning example
socksconnection	via http connects socks connection proxy plain-text
converter	c{parseexpression}, abstract results subclass converting parsed
default	access filesystem resources provides package
distribution	raised set requirement installed legacy file linux wrap distributions information style pep indexes potential provides dist-info w/metadata satisfy requested provided sys egg-info cannot entry path class represents actual created whether *path* base directory found distribution typically 376
connect	raised remote socket request server connecting connect timeout timed trying occurs
ordered	insertion remembers dictionary order
trie	tries abstract base class
parser	mini elements option level checking abstract parser character custom encoding base meta updates defaults detecting element class
moved	lazy loading moved objects
warning	san perfoming text actions warning file reducing unverified binary opened certificate system platform without connecting https certain import available missing sni ssl host base module suspected configuration optional security dependencies made attempt warned request wrong length determined mode time making requests
file	text existing manager supplement atomic low-level based cache writing usage around python safe zipfile using execute list mode small accessible tee writable individual operation implemented even opened tarfile access everything determined closed reading supports occurs metadata creating symlink provides interface lockfile g standalone length context requests raised parsing unix wrap use support wrapper 2 archives 6 readline() : happy files handler part link line trying kind target sql-based thin error demonstrate property tar pkg-info lock pid general file archive configparser binary requirements make locking member read copying fp may buffer object data class e lines callback directory file-like
pip	exception via provide xmlrpclib implementation base pip pipsession transport
moves	lazy loading urllib_error urllib_request namespace create six moved urllib_robotparser urllib python 3 objects urllib_response resembles urllib_parse moves
check	compatible verify packages dependencies installed
no	token never match
invalid	specifier requirement version somehow header see marker schemas provided py pep invalid filename valid 508 disallowed refer wheel codepoint used users 440 exception context url value headers defaults unallocated found metadata
field	body container data request parameters
lookup	object lookup dictionary
mock	wraps request httplib urllib urllib2 mimic httpmessage requests addinfourl
prepared	containing fully object :class server bytes preparedrequest <preparedrequest> mutable exact sent
ansi	implements 'write()' tty outputting windows text sequences character convert ansi strip method
registry	archiving raised registry operation
pool	raised caused within keeping one connections allowed errors :class authentication version allows closed thread-safe transparently https track urllib3 runs host enters httpconnectionpool, class pool implements exception necessary ntlm request connection base arbitrary pools requests
extras	map requirement extras demanded
htmlparser	generates stream (possibly parser tree html structure
time	warned wrong system suspected time
directory	provided requirement hash locates don't version-control-system-based tree class directory distributions method hashing
resolution	dependency abstract base resolution errors
once	parse ensure actions wrapper called
