simplexmlelement	simplexmlelement false ser etiqueta iterado cuyas hijos xml objeto tipo retorna documento nodo object contienen puede devuelve elemento través caso si datos error propiedades atributos
$condition_type	condición tipo
$cascade_candidate_limit	límite candidatas
bool|array	inserción establecida w contiene si devuelve array opción
$output	depurada ésto cada array salida presente contendrá éxito pem local línea llenado entonces variable ficheros resource si especificado comando argumento output gestor
$identifier	llamada identificador gnupg_init() gnupg
$height	plantilla imagen recorte escalada página zona arco devuelto devuelta objetivo caja filas número patrón descripción región exportada ancho ventana local área superficie píxeles nueva alto rectángulo elipse extraída original p miniatura tamaño cortada borde altura
$dither	aproximación ser indica color - debería mejor píxeles usará imagen entramado zona correspondiente establezca distinto true resultará entramada valor diferencia inmediata mapeada integer imágen entramar hilbert algoritmo moteada curva cero distribuye si reducción largo original
$def_value	dado devolver name caso clase valor propiedades declare estáticas predeterminado
$option	stream_option_write_buffer ejecución ser indica conexión cubrid_include_oid ir tidy nombre operaciones condiciones consulta stream_set_blocking() configurar sentencia tipo añadir admiten respuesta parámetro establecer stream_set_write_buffer() método compartido buscar curlshopt_share descripción válidas red llamado stream_option_blocking cubrid_exec_query_all tiempo usado soportadas option opciones ftp pueden debe ftp_timeout_sec stream_option_read_timeout segundos cubrid_async comparación devuelve búsqueda actualmente opciones: espera funciones todas opción stream_set_timeout() memcached::opt_* datos utiliza especifica constantes cambia siguientes
$agent	received agente udm_alloc_agent() recibido after llamar agent to después enlace call link
$column_name	nombre columna usada consulta
$buf	lob enviada especifivada objeto contiene buffer fuente escribir remoto variable host traida datos necesitan recibida información especificada buf recuperada
$isname	pdf cadena usado fdf antiguas (= valor campo parámetro conjunto versiones si 0) nota determinada último 1) nombre : convertido herramientas
$xml_file	xml fichero dump rrd base datos archivo nombre original
$replace_by	reemplaza smiley string
$item	nombre ser va constante describe puede escritura item escapado valor integer array operación string elemento
$exit_struct	componente devolver usado después formulario información array ejecutar
$parameters_array	orden sustituidoss parameter_array parámetros declaración preparada sustitución
$path_to	url path_from renombrada debería ser
$ascii	ascii código
$table-name	nombre vista tabla
domnode	encuentra false ser espacio índice nombres añadido null hijo index objeto tipo podido nombre local posición nodename nodo válido puede eliminado marcada especificados cualquier devuelve función ocurrió ningún clonado copiado domnodelist uri insertado si especificado error antiguo
$sql_param	sentencia string debería vinculado valor variable identifica ser
$imgtype	truecolortype bileveltype colorseparationtype tipo optimizetype palettemattetype undefinedtype grayscalemattetype grayscaletype imagen: palettetype colorseparationmattetype truecolormattetype
$untrustedfile	vienen verificar ser contiene pueden usar debería ayudar aunque pone pem si confianza archivo especifica nombre certificados certificado codificado
$new_min	entradas entrenamiento nuevo datos escalar salidas después mínimo
$appname	conexión registro aplicación appname cadena sybase razones especifica identifica
$revision	listado obtendrá revisión número entero
$country_code	país letras vea dos código geoip_country_code_by_name()
$charlist	cuales adicionales caracteres palabra considerados lista
$new_output_max	superior salida seguido límite estrictamente después escalar datos deseado
$bordercolor	objeto color imagickpixel cadena contiene representa borde
$errornum	curl curlm códigos error constantes código
$full_status	salida activos true devolver niveles búferes
$jday	va manejar día fecha juliana 2465342 número 2440588 juliano
$srcy	coordenada origen punto
$srcx	coordenada x origen punto
$domlist	dominios combinación
$wantsink	lugar mostrará absorción interfaz si true establece
$disposetype	disposición tipo imagen
$dest_width	destino imagen ancho
$serialized	string serializado representación formato serializada almacenamiento arrayobject objeto
$cache_limiter	nuevo actual valor cache_limiter limitador si caché especifica nombre cambia
$using_exceptions	descativarlo false ser defecto debe lanzamiento valor activar true excepciones
$div	resultado usado convolución divisor normalización
$dir	deben extraídos fichero directorio temporal archivos creado ruta nombre ser
$msgtype	almacenará mensaje parámetro tipo recibido
$icon	mostrado estilo si nota icono plegada
$client_identifier	usuario elegida bytes cadena 64 longitud
mongocursor	cursor this devuelve
$extr_prefix_all	nombres variables prefija prefix
$configuration_file	ruta fichero configuración
$cache	caché, file user tipo
$seed	semilla opcional valor
$dirent	directorio entrada
$db2_autocommit_off	autocommit desactiva
$field_index	ordinal conjunto columna número resultados
$rows	alto dentro ser table_name separados terminal delimiter campos datos número copiados nueva filas array escalada strings región imagen
reflectionfunctionabstract	reflectionfunction objeto
$max_bytes	copiar bytes número
$ca_path	ruta ca establecida ser
$left	opuesto coordenadas izquierdas pantalla página superior botón negativo columna parámetro caja nota número : ventana inferior posición lado ubicación opcional coordenada columna) mide izquierda si esquina x operando izquierdo
$row_number	específica odbc_fetch_row() éste recorrido fila intentará bloque indexada cursores conjunto deseada número solicita row_number puede nuevo especifica traer deseado resultado siguiente extrae solicitar partir si resultados puntero
$method_name	nombre método
$assertion	the assertion
$old_mbox	véase buzón información antiguo nombre imap_open()
sammessage	método false caso devuelve error
$array_or_countable	countable array objeto
$text_domain	actual cambiarlo obtener nuevo dominio valor null mensaje
$timelimit	tiempo pasa larga número búsqueda segundos establece cuánto cuan
$gupnp_signal_service_proxy_unavailable	servicio siempre disponible emitido dejado
$newvalue	nuevo opción valor
$desired_output	array salidas deseadas
$bid	objeto identificador válido char blob slob id
$imageinfo	fichero getimagesize() ampliada alguna parámetro permite opcional véase información extraer imagen
$rights	derechos dar usuario
recursivefilteriterator	conntiene recursivefilteriterator interno iterador hijos devuelve
$savepath	creará ser directorio usando puede bien nombre existente original fichero
$neuron	neurona número
$userdata	userdata tercer éste parámetro callback si opcional pasado define
sqlitedatabase	objeto caso éxito devuelve error null sqlitedatabase
$queryfield	consulta campo
$progid	word objeto quiere ejemplo puede progid clsid acceder ser
$+o(	formato estilo números negativos especifica positivos
$namespaceuri	crear atributo buscar espacio nombres nodo namespace uri dentro especificado buscara recuperar nombre elemento elementos
$to_encoding	va string tipo convertir str codificación
$param	vincular php string 0: valor 1: dada columna char contenido mode option archivo variable nombre opción = puntero if
$msgs_in_queue	todavía mensajes número cola
$afmfile	afm ruta fichero
$what	configuración descripción assert inicial valor opción options assert_active predeterminado
$nbytes	ser bytes rango especifica sincronizado longitud
$year	cuatro depende ser inclusive seleccionado 32767 9999 calendar 1 positivo mapeados 1970-2000 2037 número dígitos valor calendario 0-69 -4714 -4713 válido puede 2000-2069 año 70-100 14 valores 1970 rango dos
$iter	forma cualquier splfileinfo asociativa mapee clase tar/zip devuelva iterador ubiciación objetos fichero
$passwd_len	contraseña longitud mysql
$type	harupage::ts_glitter_right clob text sqlvarchar sqlchar imagen son: sombreado stream_sock_raw forma atributo base64 harupage::ts_barn_doors_horizontal_in predeterminada harupage::ts_blinds_vertical oci_dtype_lob comprobar arrary establecer cubrid_lob compresión líneas opcional phar::gz solrclient::terms_servlet_type datetime harupage::ts_wipe_left función sqltext trartará vincular zlib representa sericio radial especifica stream_sock_dgram estadísticas ser sqlflt8 valores: siguientes: recibir tipo solrclient::search_servlet_type input_post stream_sock_stream axial input_get notación rpn solrclient::threads_servlet_type acción debe puede extremo usar byte oci_dtype_rowid únicamente sqlfltn sqlint2 sqlint1 sqlint4 ahora harupage::ts_wipe_up tipos siguientes harupage::ts_wipe_right comunicación or harupage::ts_replace nominada: stream_sock_seqpacket unir obtenido: array capturar cubrid_object sqlflt4 tercer usa 0 oci_dtype_file harupage::ts_box_in solamente harupage::ts_wipe_down algoritmo type blob línea harupage::ts_box_out an php_binary_read input_cookie incluir img_gd2_raw soportado actualmente harupage::ts_dissolve lista vt_xxx harupage::ts_barn_doors_vertical_in harupage::ts_glitter_down caso cuyo valores img_gd2_compressed datos parámetros stream_sock_rdm elementos pdo::param_* input_server solrclient::ping_servlet_type va attribute debería específico usarse cubrid_num phar::bz2 tipos: solrclient::update_servlet_type recursos consulta distingue entre: consulte válidos bzip2 harupage::ts_blinds_horizontal argumento harupage::ts_glitter_top_left_to_bottom_right sqlbit - parámetro pl/sql 1 input_env cubrid_assoc = prefijo cubrid_both constante devolver recv() type-1 dato sistema variable mayúsculas/minúsculas resultado posible recurso recibido usar: recibida harupage::ts_barn_doors_vertical_out harupage::ts_barn_doors_horizontal_out si especificado oracle constantes sólo
$wildcard	comodín nombre patrón tabla comprobar
$fontid	devuelto fuente identificador ps_findfont() usar función
$blocking	lea sufieciente espacio script mensajes libere esperará demasiado va si proceso caber largo mensaje enviar cola
$action_name	usuario 32 elegida bytes cadena longitud
$clientoptions	conectarse secure indica p port matriz hostname - servidor ruta número valor nombre claves: respuesta autor host puerto) path booleano solr seguro contiene si wt siguientes modo
$qualifiedname	crear atributo elo tipo etiqueta prefijo:nombre_etiqueta documente cualificado nombre prefijo elemento prefix:tagname
$batch_size	buffer registros número
$result_type	msql_both ser defecto valores: debería pdo::fetch_* determina fbsql_assoc array acepta msql_num tipo argumento ingres_both parámetro devueto conjunto fbsql_both fbsql_num msql_assoc tomar cómo ingres_assoc constante puede opcional ingres_num resultado devuelto indexará formato or representado resultados result_type siguientes
$node_name	xml nombre nodo
$purpose	¿el ser netscape? bits x509_purpose_smime_encrypt cualquier/todos propósitos inglés)? - especificar servidor firmar x509_purpose_any descripción x509_purpose_ssl_client x509_purpose_smime_sign propósitos? conexión opciones constante lado usado ssl? puede x509_purpose_ns_ssl_server ssl encriptar x509_purpose_crl_sign usar lista ¡sólo revocación x509_purpose_ssl_server openssl_x509_checkpurpose() ¿se s/mime? email campos una! certificado cliente crl
$message_type	dónde ir debería indica error
$rprop_decrease_factor	disminución factor
$field_value	campo valor
$max_epochs	continuar entrenamiento debería número máximo épocas
$fieldboostvalue	índice tiempo boost
$preg_split_delim_capture	expresiones paréntesis capturadas bandera delimitador si aplica patrón devueltas
$hebrew	establecido salida usa true formato parámetro hebreo cadena si hebrew fl basado
imagickkernel	generado objeto imagickkernel
$stroke_width	contorno ancho
$userid	representa servidor conecta usuario identificador db2_connect() - enviado cadena base datos apuntador nombre usando cliente sql_attr_info_userid
$crop	geometría string recorte
cairomatrix	éxito si falló descripción devuelto
$pixels	píxeles matriz
$pharpath	montada ubicación phar dentro ruta archivo usar interna
$max_chars_per_line	línea indica devuelta parámetro devueltos caracteres opcional máximo número
$except	observados banda llegada matriz except alta sockets listados prioridad información flujos excepciones excepcional
$table_name	siendo tipos table tabla esquema rows quiere conocer nombre patrón comprobar string copia provenga coincide convertir copiará consultada comodín contiene si datos
$new_input_min	seguido límite estrictamente después inferior escalar datos deseado entrada
$jargon	distinguir ortografía extra palabras mismo parámetro contiene diferentes parámetros información dos jargon lenguaje listas
$with_comments	conservar comentarios salida
$nowait	debería semáforo si proceso adquirido especifica esperar
$numeric_prefix	aquellos sólo usan índices éste añadido parámetro si base numéricos encontrados comienzo array elementos provee
$num_args	intérprete sqlite analizador alusión llamada si número sugerencia retorno argumentos acepta función predeterminado
$buffer	buffer bytes número
$preferredmessagesize	registros objetivo devolverán recuperación especifica tamaño byte máximo entero
$oauth_auth_type_form	http cuerpo petición parámetros oauth post anexa
$fd2	fichero recurso objetivo numérico descriptor flujo socket
$syntax	puntos objeto identificador oid tratar sintaxis 1 especificarse notación debe
$event_handler	evento proporcionándola recurso vez emita cada base datos especificado enlace nombre argumentos invoca función
$blob_handle	handle devuelto ibase_blob_create() mediante blob ibase_blob_open() manejador fbsql_create_blob() abierto
$user_string	string proporcionado usuario
$pass	pkcs#12 contraseña encriptación desbloquear archivo
$variable-name	parameter-number string vinculará variabel parámetro nombre php especificado
$max_memory	memoria cantidad temporal bytes omisión 2 máxima fichero usar mb)
$broker	agente broker recurso
$attr	nodo atributo
$typelib_name	fichero siguientes: puede typelib_name nombre ser
$bind_index	tipo índice vincular ubicación vinculación parámetros valor
$section	número parte
$artifact	artefacto nombre borrar
$linefeed	rfc línea) varias línea término líneas marca linefeed eol pliegue dividir cierta mb_encode_mimeheader() acto especifica realiza fin mayor longitud
$dump_directory	escrito análisis volcado directorio archivo
$measureerror	imagen distinto cero mide cuantificada valor diferencia original
$nth_index	vuelto indice enésimo ser
$mustunderstand	atributo encabezado mustunderstand valor soap elemento
$sourcedoc	fuente documento
$cascade_max_out_epochs	máximo épocas salida
$servicename	servicio nombre corto
$i5_naming	udb cli habilita db2_i5_naming_on iseries sistema nombrado db2 modo
$num_data	datos número entrenamiento
$language	país después usa electrónico subrayado 639 mensajes parámetro lenguaje correo language letras guión iso consiste codificar 3166 dos código opcional
$body	consistir asociativo encoding cuero frame charset puede cuerpo indexado cuerpos array type claves: siguientes
$days	cuál generado válido days duración días especifica certificado
$soap_request	petición soap
$timeperiod	periodo inestable valor
solrparams	false objeto caso error éxito an solrparams devuelve instancia solrparam
$radius	operación zona central borrosidad inmediata gaussiano elige contar píxel efecto circular extensión aleatorio círculo radio píxeles implosión
$binary_string	convertir string binario
$user_agent	analizado agente ser usuario
$contents	hash serializado contiene formato texto cadena caracteres nota
$src_im	original enlace tipo recurso imagen
$certs	almacén éxito ésto si información contentrá certificado
$x0, x1, y0, y1	sombreado coordenadas punto inicio y1 y0 x0 x1 final
$sig	constantes pcntl señales
$mimemail	mailparse_msg_create() mailparse_msg_parse_file() recurso válido creado mime reservado
$limited	false segmento cada detallada devolverá apc_sma_info() información establece predeterminado
$sourcefp	válido gestor archivo
$dbx_result_index	dimensiones indexada siempre propiedad devuelto matriz establecida numéricamente 2 decir data objeto
$limiter	limitador
$rev1	primera ruta acceso número revisión
$rev2	segunda ruta acceso número revisión
$store_result	particularmente resultado false ser cargado parámetro uso memoria deberá interesante grandes puede conjunto conjuntos opcional minimizar resultados modo store_result indicar
quickhashstringinthash	nuevo objeto devuelve quickhashstringinthash
$separator	nombre string espacio analizador separator cuenta separado diferentes etiqueta etiquetas especificado gestoras nombres parámetros pasados espacios funciones consistirán
$dataoffset	compatibilidad uso pear php_archive aquí variable
$cainfo	ac verificación ser matriz contener véase - debería parámetro archivos/directorios información si confianza usarla descrito especifica proceso cainfo acerca certificados
$a	va ser revisado calcular lineales 0) singulares raíz restado matriz parámetro cuadrado 5 número gmp dividido cuadrada > escanear ubicación perfecto ecuacioines gammaa multiplicado php b resource agregado primo valores propios distribución sera invertir
gearmantask	añadida false objeto gearmantask añadir caso puede si error puedo tarea ser
$size_correction	tamaño corrección
$writecb	invocar descripor descriptor escribir si llamada listo desea background null
$bestfit	ajustar intenta fuerzan imagen valores parámetro ajustarse dentro si caja origen opcional destino redimensionar máximos deformada ajuste limitada
$seconds	tiempo ejecución ser negativo debe segundos máximo entero
$req	recurso rescurso puede usarse petición opcional funciones eio_get_last_error()
$res	udm_find() resultado recibido identificador llamar después enlace
$ord	codificación glifo vector posición fuentes
$cacert	cacert firmado certificado generado
$session_mode	disponible versión parámetro 1 5 oci8 php pecl
$red	componente rojo color valor descripción borde
$ref	ser debería servidor especificación u descrita normalmente array comprobar ref imap_open() objeto
$colorize	cadena contiene imagickpixel objeto color
$new_width	redimensionar ancho imagen
sdo_das_xml	objeto sdo_das_xml excepción caso describe éxito abajo lanza devuelve tal modo
$wordwrap	actual parte éste incluye llegado parámetro establece si envolver área palabra final emula true función
$from_encoding	from-coding detectar comas from_encoding nombres previos conversión intenta caracteres mediante códigos especifica codificación array separado string
$workload	ser retornados datos arbitrarios serializados procesados
$nameooptions	array ser puede string
$pathto	files dados ruta extraer ficheros
$pipeline	marco tubería acumulación ejecutar
$pathname	crear fichero directorio cargar archivo fifo ruta accedible nombre observar
object	visto harupage momento fetched bloque return-path: row instacia personal haruencoder fecha columna to estructura filas traída adl sujeto string devuelve codificador función haruannotation vienen propiedades: representa banderas infomación obtenida ccaddress cuyos caracteres are información n subject página devuelto quedan message_id clase followup_to mailbox host rows mime interna reply_toaddress corriente establecido sender phardata envoltura senderaddress contiene return_pathaddress imap_header() mismo tamaño bcc: cabeceras encuentra there toaddress reciente cc corresponds cada references array corresponde or from excepto adjunto existen éxito conteniendo nueva bccaddress solicitada more línea usada that instancia corresponden sender: newsgroups actualmente in_reply_to imap from: to: 1024 incluye caso ciertas return_path remail r error propiedades similar siguientes tipo false return-path an fila proceso in null haruimage if objeto ocurrió cc: - servidor documento además reply-to: object resultset cuerpo resultados date reply-to objetos recuperada recent especificada siguiente completo: campo uri extraída bcc si siguienets reply_to the fromaddress mensaje atributos
$handle(resource)	p recurso flujo
$note_value	nota valor
$fieldlength	longitud campo
$lib_dir	puede encuentra directorio modos contener módulo ubicación parámetro dentro ubicados opcional sistema especifica algoritmos lib_dir
$slant	nivel inclinación
$param_name	nombre string parámetro
$driverdata	controlador parámetro/s opcional/es
sqlite3result	sentencia ejecución objeto sqlite3result caso clase éxito si fallo devuelve preparada resultados consulta false
$session_data	información sesión codificada
$angle	grados múltiplo angle borrosidad aplica debe polaroid texto ángulo escribe efecto rotación 90 largo ser
$tiebreaker	specifies be use less float value should 1 to as much something which in tiebreaker tie the queries parameter than dismax
$bytes_transferred	bytes_transferred parámetro si aplicar puede rellenado
$part_number	número parte
$schema_type	esquema tipo saber quiere conocer información
$max_neurons	estándar informes salida añadir neuronas número neuronal impresiones máximo red
$from_neuron	neurona posición empiza conexión número inicial
$string	string entrecomillada comprobada examinar decodificar escribir imprimible longitud cadena recodificar evaluado caracter 8bit escapado convertir búsquda estring medir comprobar entrada ser
$from_root	hijo lugar raíz xml nombres nodo permite bajo recursivamente espacios comprobar documento
pdostatement	false objeto caso pdostatement devuelve error
$color_space	color imagen espacio
$hint_metrics	descripción
$pct	cambios grises 0 imágenes escala cuyo src_im pct fusionadas según puede valor cambiado dos 100 totalmente
$ndocs	completará secuencia ndocs texto si número encontrados documentos facilita
$shmid	memoria identificador creado segmento compartida shmop_open()
$preview	previsualización tipo
$bmax	alto limite mas azul
$in	recipiente ser recurso va contienen cadena contiene filtrada recipientes in información apunta objetos
$case	case_lower defecto case_upper
$max_item_length	array elementos establece longitud máxima
$id	retornado derechos id esquema asociado objeto devuelto devuelta valor document declarado eliminar conexión uniquekey cambiar string ususario dar configuraciones resultado yaz_connect() enlazar tipo recurso campo identificador cursor _id
$hconn	connection handle
$part	porción determina haystack devuelve función
$iv	ofb cbc null stream modos utilizado cfb vector inicialización algoritmos modo
$x509	ver listado valores key/certificate parámetros válidos
$calendar	hacer va cal_julian convertir cal_jewish formatear cálculo procesar cal_french cal_gregorian conversión mes nombre calendario usar tomar
$cascade_activation_functions	candidatas array cascada funciones activación
$access_token_url	url token api acceso
$startpos	empezar subirlo posición remoto archivo
$dictionary	va acceso utilizar ruta diccionario cerrarse cracklib
$set_element	contenido quiere borrar insertar elemento
$major	kernel necesario s_ifblk identificador pasarlo usar s_ifchr dispositivo mayor
$open_entity_names	entidad análisis segundo estan nombres entidades incluyendo open_entity_names separada parámetro nombre abiertas espacios lista referenciada
$learning_rate	índice aprendizaje
$cost_ins	costo inserción define
$rrd_file	restaurada rrd base datos archivo nombre
$database_name	crear va ser siendo consultada msql base datos nombre seleccionada
$unescaped_string	cadena va escapar escapada ser
mongocursorinterface	cursor this devuelve
$resolution	pixelsperinchresolution unidades resolución imagen: pixelspercentimeterresolution undefinedresolution
$gupnp_signal_device_proxy_unavailable	siempre dispositivo disponible emitido dejado
$piggyback	booleano
$oldnode	hijo antiguo nodo atributo eliminado
$attribute	attribute nombre atributo name an
$val	chequear valor
$data_type	cuál tipo puede restringir datos información usar único
$memcache_connection	conexión daemon complemento mysql memcache instancia memcached
$consumed	referencia ser debe siempre debería filtro incrementado información altera declarado consumed longitud lee
$extr_refs	referencias variables extrae
$base_dir	completa directorio añadir contiene ruta relativa archivo ficheros
$elevation	dirección luz fuente define
$font	harufont ser encoding fuente built-in fuentes 3 1 registrados 2 5 4 instancia nombre imageloadfont() valida identificadores puede corresponden cualquier altos fonts) latin2 números large propios
$fam_monitor	fam_monitor_xxx devuelto recurso funciones
$token_secret	oauth secreto
$brightness	-100 cambio +100 brillo porcentaje
$is_output	output si parámetro valor
$mysql_connection	extensiones cuales pdo_mysql empleando servidor api mysql mysqli php gestor ext/mysql
$reference	va referencia imagen contiene imagick comparar objeto
$zip_entry	directorio devuelto devuelta devuelva zip_read() entrada
solrdocumentfield	false objeto campo caso error éxito fallo devuelve instancia solrdocumentfield
$num_neurons2	segunda neuronas número capa
$priv_key_id	resource string devuelta formato - openssl_get_privatekey() pem clave
$num_neurons1	neuronas número capa primera
$sandbox	runkit_sandbox establecer objeto salida clase instancia gestor
$batchsize	resultados devolver número lote
$form	componente va añadirán componentes formulario destruido ser
$client_info	usuario elegida bytes cadena 64 longitud
$i5_date_fmt	estandar utiliza formato - iso fechas db2_i5_fmt_iso yyyy-mm-dd
$white_point	negro punto
$descriptorspec	hijo indexado descriptor representa clave número pasará valor proceso array php
$column_key	devolver columna valores
$server_hash	servidor cursor hash posee
$component	php_url_scheme php_url_port específico recibir tipo excepto cuyo php_url_pass valor retorno especifique solo string da php_url_host integer componente php_url_fragment url caso php_url_path php_url_query php_url_user
$glyphs	descripción
$regs	tercer paréntesis matriz pattern regs almacenadas encontraron llamada si coincidencias argumento sub-cadenas función elementos
$imageid	ps_open_image_file() ps_open_image() imagen devuelto identificador recursos funciones
$functions	pasa parámetro cadena nombre función exportar
$top	opuesto coordenadas pantalla página superior botón negativo derecha nota número : ventana inferior línea posición lado ubicación coordenada superiores mide fila) si esquina
$inc_by	variable incrementada asociada key valor
$cmp_function	pares usada devolución cmp_function ordenado entradas llamada comparación parámetros llenados 2 acepta función
$pxdoc	the paradox returned devuelto database of identificador by devueltos as base datos recursos resource px_new() identifier función
$end_element_handler	intérprete xml referencia parser end_element_handlerresource string $name debe parámetros: parámetro primer llamada mediante llama hace manejador dos aceptar end_element_handler función $parser
$i5_query_optimize	página rápido posible - db2_first_io devolver objetivo primera todas consultas resultados optimazadas
exception	anterior exception disponible si devuelve null
$gearman_return_t	retorno gearman válido valor
$columns	imagen ancho número columnas escalada región
$step_func	cada resultados conjunto llamada fila retorno función
$is_associative	defindo false devuelto proporciona numéricamente indexado si array
$value_cb	resultados retrollamada null
$relation	abierta relación mediante copiada dbplus_open()
$brigade	recipiente recurso bucjet bucket cadena contiene recipientes apunta objetos brigade
$text	va ser show probada text escapar texto mostrarse definido ayuda prueba cadena botón mostrar sección to caja 5 utf-7 descripción dibujar string ancho mostrado debe usado calcular nuevo escrito imprimir medir marcapáginas modificado dada desencriptado rfc codificada 2060 the mensaje cifrado
$original	clase original
$req_identifier	resultado éste identificador petición cubrid_prepare() solicitud
$rownumber	recuperar fila opcionalmente número escoger
$how	ser valores dejar leer transmisiones how 1 0 2 cerra valor stream_shut_rdwr deshabilita stream_shut_wr puede recepciones stream_shut_rd posibles constantes: socket escribir siguientes: siguientes
$max_table_length	entrantes arrays establece máxima resultantes longitud
$parse_mode	use solrresponse::parse_solr_obj solrresponse::parse_solr_doc
$method	ser bell véase calcular valores filtro establece imagen distorsión potenciales permite 1582 - método openssl_get_cipher_methods() fechas : 1752 puede calendario pascua basadas lista años siguientes: cal_easter_roman gregoriano interpolación cipher capas constantes img_bell cifrado
$gupnp_type_float	tipo of is float variable the type
$close_path	parámetros opcional parámetro opcionales
$encoding_list	comas encoding_list separadas codificaciones caracteres array lista
$max_acquire	establecido procesos simultáneamente adquirir puede max_acquire número semáforo
$cut	siempre cut string width si especificado ajustado true establece
$result_identifier	devueltos resultado dbx_query() identificador conjunto interbase ldap resultados interno
$timestamp	hora va día defecto sol unix tipo temporal parámetro valor local puesta tomar tiempo timestamp proporciona marca opcional integer ningún si fecha
mongocommandcursor	cursor mongocommandcursor objeto devuelve
$timeoutms	límite tiempo milisegundos
$argument_count	argumentos sql número función toma
$magic_file	fichero mágica base datos normalmente nombre /path/to/magic
$config	arreglo configuración
$at_front	principio buffer cambios desactivar permite final
$border	color borde
$faultname	apropiada ser fault usado puede codificación selecionar wsdl
$img_effect_overlay	plano gris fondo color tomarán blanco negro primer píxel negros efecto revestimieto blancos permanecerán píxeles capa
$offset	iniciara búsquda fuente comenzar hace leerse ítem comenzando asignar quiere reemplazo 0 desea número buscar valor normalmente haystack comprobar grafema string opcional bytes eliminar partir separación especifica ser índice empezará caracteres see relativa comienza contar información operation sqlsrv_scroll_absolute flujo dónde arbitrario desplazamiento accedida inicio recuperar lectura principio punto puede offset asigna byte fichero empezando cero cadena unidades periodic rango tamaño color señalar insertará accederá iconv_substr() usar podría array iniciará van tar zip negativo elimina objetivo ïndice descripción define configura posición modificar acceder sqlsrv_scroll_relative destruir porción cursor permite datos str específica va empieza cantidad éste iniciar caracter incrementar watcher comienzo fila inicial archivo mover buscado leer objeto empezar parámetro especificar ruta nombre grande secuencia comparación búsqueda dado modes campo $offset medio phar dentro si especificado sincronizado original contados
$local_path	ser directorio alojado ruta archivo local
$accuracy	presición
$fk_qualifier	cualificador clave extranjera
imagickpixel	establecido objeto fondo color caso imagickpixel éxito coordenadas si dadas devuelve instancia true imagen
$x3	aquí actual mueve corriente punto
$x2	control segundo segunda bezier derecha curva coordenada x punto inferior
$x1	control superior primera curva bezier punto izquierda coordenada x primer descripción
$x0	descripción
gearmanclient	false caso éxito gearmanclient si fallo
$frame	ornamental rodea imagen p borde
$cookie	servidorldap_control_paged_result_response() enviada yaz opaca sesión estructura cookie proxy
$alias	completa abreviada propiedad url vez clase phar:// phar puede usarse cadena alias ruta acceso archivo comparar nombre envoltura referirse flujo
$source_string	analizar origen string
$url	analizar ser tener clic absoluta solicitud dirección vínculo petición destino valor curlopt_url scheme:// hipervínculo debe proporciona abrir haga url opción formato repositorio p si estabecerá
$out	dentro recurso segunda ubicar cadena deberían recipientes apunta modificados out
$uri	ruta escribir uri salida codificar
$i5_decimal_sep	( utiliza - db2_i5_sep_period punto
$cascade_min_out_epochs	mínimo salida épocas
$ury	coordenada superior derecha esquina
$urx	coordenada x derecha superior esquina
$module	lugar forma ser parámetro constante módulo usado puede cadena segunda si module prefiere mongolog especifica constantes aunque
$msgdesc	descriptor message mqmd
$connection_rate	conexión índice conexiones controla cuántas red
$full_info	información mostración resultado activa/desactiva completa
$key	claves anteponer numérico apc_define_constants() clave cola segmento valor entrada establecer llave función eliminar actualizar actualizado resultante ser existe cifrados información array asociada disminuido decrementar recuperar mensajes eliminada hash debe puede pública file://ruta/al/archivo key usar insertada guardará fichero identificador cadena contiene encriptar almacenar llaves obtener devolverá, capturar representación conjunto caché compartida bloqueo usada reemplazada almacenado formato siguientes: apc_store() datos comprobar usuario va siendo incrementar liberar id correspondiente añadir utiliza parámetro ítem ruta nombre opción memoria sistema variable chequeo constantes aumentado recurso campo utilizará dada si cambio quedará especificado privada hmac
$connection_string	oracle contiene conectarse instancia
$port(optional)	socket usa escuchar af_inet parámetro designa vincula puerto sólo port conexiones
$low	bajo punto
$oid	trabajar poner leer objeto glo quiere identificador oid porner grande instancia información escritura bloqueo lectura comprobar existencia
$replace	search valor valores reemplazo sustituye encontrados
$resource	resource recurso devuelto db2_connect() pasado válido mayoría errores db2_pconnect() db2_prepare() falló gestor función
$rpmr	rpm_open() abierto fichero puntero correctamente
$log	commit string log
$xsd_file	ruta fichero xsd esquema
$bbcode_initial_tags	analizar requeridos parámetros asociativo correctamente contiene etiqueta clave valor nombre array bbcode
$quota_limit	tamaño máximo quota_root kb
$defaulthost	nombre host predeterminado
$headerfault	ser respuesta encabezado usado controlador puede informar soap rror
$extendedclass	nombre clase extendida
$layers	tamaños array capas
$layer	número capa
$extr_skip	variable existente si colisión sobrescribe
$normalized	color valores normalizar
$database_password	password string database
$auth_session_handle	1 oauth sesión parámetro existe especificación manejador autorización
$sharpen	agudización valor
$json	decodificar json string
$field_number	posición numérico número columna campo
$spelling	lenguajes parámetro inglés ortografía spelling solicitada
$zurl	toma forma host[:port][/database] string
$preg_offset_capture	añadida pasa devulto índice producida bandera cadena cada si coincidencia devuelto
$jd	entero día juliano
$cost_del	eliminación costo define
$fk_owner	propietario extranjera clave
$neurons_between_reports	neuronas informes número impresiones
float	opacidad espaciada doble salida parámetro fuente espaciado produce radianes calculada menor menos excepción / mayor deducción parece seno candidate decay hiperbólico textura elevado -i equivalente 0 caracter número flotante entrada conexión codepoint numérico gmagickdraw texto letra devuelve 2 bit trazo logaritmo relleno disminución -- empleado bytes radians p -1 neuronal x ninguno altura ser ek índice paso sarprop arc escala arg definida carácter grados tipo + puntos asociada multiplicador inglete desplazamiento pseudo-aleatorio 3 densidad potencia imagickpixelexception lanzando boost aumento red ancho ecm punto base coma change log alto on actual of indicando cadena contiene dibuja resto rango tamaño or gamma métrica color float number total imagen canal temperatura épocas éxito cosine fraction candidatas utilizando produjo transcurrido línea usada hipotenusa factor correctamente completo tinta tangente gmagickpixelexception bajo true activación contorno 10 double caso value peso mu error -123456789 categoría cuadrático crear neurona false definido fracción describe parámetros mejor in estancamiento máximo q distorsión null objeto medio cálculo 1 disponibles misma) pendiente status página tiempo respuesta normalizado fallo búsqueda estableció horizontal arco longitud i límite cascade si cambio cascada the sigma mínimo valor
$scanner_mode	defecto ini_scanner_normal ser puede ini_scanner_raw
$iptcdata	información va ser escrita
$attribs	attribs tercer alguno asociativo parámetro contiene si array atributos elemento
$painttype	1 ó debe 2 ser
$locale	entorno locale nombres variables formatear procesar localismos ini configuración null categorías establecerán valor ajuste mismos string regional intl anteriores usar lang vacío valores partir si especificado
$zip	devuelto fichero zip recurso válido controlador zip_open() previamente abierto
$order	ordenación dirección
$saturation	-100 cambio +100 saturación porcentaje
$indent	xml línea primera argumento especificar caracteres formateado número str cabecera indentación opcional
$newdir	nuevo archivos directorio relaciones
$conn	conexión cerrar va
$window_handle	hwnd ventana id
$usec	microsegundos
$is_xhtml	saltos línea utilizar si compatibles xhtml
splfileinfo	objeto splfileinfo padre creado ruta devuelve fichero
$db2_autocommit_on	autocommit activa
$num_layers	incluyendo salida capas número total capa entrada
$user	autenticación usuario nómbre nuevo opcional mysql nombre número
$reps	10 probable superior defecto siendo probabilidad reps valores rasonables 5 número disminuye valor varían ; pasar primo
$group	autenticación nombre grupo especificado número
$client_flags	load constantes: manejo ser mysql_client_compress local habilita combinación puede mysql_client_ignore_space parámetro 128 mysql_client_ssl data client_flags siguientes mysql_client_interactive
$num_output	datos salidas número entrenamiento
$start	predeterminadas empieza ser indica valor búsqueda empezando comenzar menor registro $haystack primer byte subject grados positivo leer devuelto negativo devuelta dónde parámetro igual start inicio exportar grafema secuencia posición string debe proporciona ángulo punto recuperado rotación offset bit arco longitud especifíca -ésima cero bytes cadena unidades si comenzará enumeración -si rango código
$numerator	completado expresado numerador fracción porcentaje
$cipherid	cipher constants
$tablename	almacenado encabezado base datos almacenará cabecera nombre tabla
$ignore	caracteres ignorar escapado
oci-lob	lob false devuelve caso éxito nuevo descriptor file error
$bottom	bottom of coordinates izquierda caja esquina coordenada the page inferior
$error_message	establecido referencia ocurriera ocurrió explicando contener mensaje pudo abrirse descriptivo si base datos error abrir pasado
$nanoseconds	positivo mil 1000000000 debe menor millones entero ser
$interlace	imagen planeinterlace cero partitioninterlace desactivado combinación entrelazada si imagen: nointerlace entrelazamiento bit lineinterlace entrelazado
$host_name	conexión recibe host nuevo si establecerá nombre
$nodns	ip establezca dominio resolverlo dirección empleará evitar si dns address nombre nodns true comportamiento
$values	xml to overridden that of maps valores ids values contiene datos attribute usar array document
$cfg	eventconfig opcional objeto
iterator	actual filteriterator clase limititerator::__construct() si interno iterador recursivecachingiterator the null pasado ninguno sub
$pad_type	ser argumento puede str_pad_right pad_type opcional str_pad_both str_pad_left
$expect	expect_popen() abierto anteriormente expect flujo
$column-name	nombre columna campo
$callbacks	contenido controlador yaml emitir retorno llamadas array nodos manejadores
$train_data	datos neuronal resource red entrenamiento
dateinterval	dateinterval nueva devuelve instancia
$signal	puede solo kill útil sistema operativos sistemas parámetro especificar llamada 2 posix opcional valor proceso ; enviar utilizando señal
$database	va performing ser defecto mysql seleccionada provided tipo to vez default when nombre if entero be used cambiar base cambiado db2 specify usuario catálogo database álias will alias si datos aplicará queries especifica the cliente
$docs	colección contiene array instancias solrinputdocument
$frompath	repositorio ruta actual
$draw	objeto color fuente obtienen tamaño nombre
$streams_context	resource stream_context_create() tipo creado contexto función flujo
$statement	sentencias ejecutado contener ejecutada creado parámetros oci8 marcadores oci_execute() oci sentencia opcionalmente sentecia mediante oci_parse() preparadas ref válido puede preparar sql identificador mysqlnd cursor comando gestor ejecutar
$value2	comparable ser segundo nodo comparado cualquier valor
$value1	comparable ser añadir nodo valor comparado cualquier inicio primer
string	predeterminadas code ejecutado iterator excepción global tratar correo simplexmlelement informix query -_ primer rellenado zona atributo salida base64 fallidas funciones to fuente codepoint string reflexión sqlcode=cccc] traducciones devuelve previa ip_address codificados arrayiterator motor $needle consitne p vector devolverá especifica radio largo error_code banderas mensaje1 funcionar mensaje2 almacenada parametros definido originales definida imagetype_tiff_mm sentencia raíz habilitado sub tipo firma application/x-shockwave-flash acceso habilitada msql anuncio método seguros inicialización calendario expresión ; memcached [sqlstate región hash versión mensajes ubicación conversión acuerdo activo interno revolución mes apache ver algoritmo establecido reflectionclass 32 image/vnd cliente resulting miniatura manejador tamaño resta conexión) código sesión reciente application/octet-stream texto creado color api corto serializados apc encontró siempre from cantidad 0 uso pudiera retiradas francesa referenciada descripción image/tiff trabajo descomprimidos $start vacia pudo clave-valor apuntado occurred representado ecuentra celda visual según particular imagetype_gif amigable organización extension this valores permite codificada reflectionfunction::export() codificado absoluto invertida sqlite empieza mayúsculas directorio funcionalidad ajustado debería usarse escaped spl_autoload() etiqueta proceso imagetype_tiff_ii tal abiertas absoluta almacenar information objeto colocar imagetype_swf imagetype_swc ítem 1 comprimida retorna retorno nombre image/bmp opción mas exportada deveulve implementada rango produce fd sistema recodificación data response image/psd parte orden representando padre vacío vacía diferencias definió dentro primera si grande minúsculas único opcional escapados include_path executed deveuleve wddx over seteado $extract_type clave iso-8859-1 phpe9568f34-d428-11d2-a769-00aa001acf42 arcivo forma salvarse codificador temporal operandos rot13 mediante valor aceptar entrada happened conexión return imagetype_bmp rutina timestamp getname camino combinación sqlite3 fallido especificados arrayobject encabezados name cubrid unicode (último representa mode sido parcheada ordinal domain nombres escapar retornará recursivedirectoryiterator namespaceuri secuencia funcionamiento información almacenamiento convertidos asociado item cargada req asociada documentación stub internet sqlcode) plural descodificados devolver correcta correcto mes/día/año sha-256 cabecera base mime vieja byte pasado asn text/plain additional realizar minúscula evprepare fichero ficher bruto contiene length dobles iso comando resultados hexadecimal búfer transacciones propiedad variables number cada país-región $haystack array volcado leído desencriptada start excepto leída image/gif imagetype_psd statement bits final elementos decodificación fbsql advertencias extensón segundo that needle resultado siguiente representing incorrecto abstracto enviada 13 conteo serialización módulo database léido cifrada str letras tres garantiza and false file_name tidy específico parámetros nulo dados null imagetype_wbmp devueltos dirección - image/iff comprimidos servidor internal nota codificación modulus soap licencia documento trace buffer copia gmagick clase limitador most directoryiterator fallo cualquier iterate class usuario url imágenes uri repositorio artefacto dos instancia emitió salt hmac rpmreader serializado apciterator serializada text personalizada juliana inválidos resultó aleatorios calculado xml operación referencia copyright lista fecha columna detalles interoperabilidad version número 8 local advertencia firmado handle identificada stomp identificado cerró da traza imagetype_png falló abreviado posibles país digest) bytes exportación rfc crc grafemas 2060 x resultante binaria ser convertido índice convertida binario plataforma existe caracteres relativa cifrados último última calendar carácter gtid interoperabildad devuelto contenido errores desplazamiento llamada biblioteca destino ascii-compatible llamado solo no-alfanuméricos recently existieran debe punto después abreviación column_number solr categoría regular insertada c last necesario barras identificador identificados frase etc connection escapado escapada segundos uniconde ocurre instante key empleando simbólico mágica códigos configuración localname tarea guid diff tabla contrario existiera representación cabeceras éxito bbb conteniendo conjunto json describes fichoer tablas produjo repetido hilos protocolo desafío usada with usado correctamente comprimir actualmente cargadora ficheros note_name case exception image/jp2 dispositivo caso formato fila value n cursor encontrar contexto dominio error antiguo property abierto incluyendo velocidad espacio ip is archivo gzeof() imagetype_iff alfabéticos normalmente enlace redistribuible consulta sprintf() ascii id if evento containing decodificado argumento delimitada hostname ruta sucedido diferencia 3986 status tiempo used http phpversion() definidas oid deflate descodificado vacía) vuelve embebida php recodificado stack dado descrito comillas recurso campo i dada phar límite especificado soapfault unescaped gzip the especificada gregoriana proporcionada almacenameinto clob image/png imagickpixel intervalo momento parámetro cadenas mysql auto:increment glue imagetype gmagickpixel analizadas fc_nfkc_closure character pila comas formateado blob perfil haystack formateada rfc2822 predeterminado finaliza marco válida envia format decodificada válido marca edición desconocido password función suma insert graphicsmagick motorola intel = callbackfunc server ninguna árbol imagetype_jpeg rerpesenta descomprimida ninguno criptográficamente imagen leídos consultas asignado magickwand canonizados extensión división phpe9568f35-d428-11d2-a769-00aa001acf42 ob_start() nodos horaria página adicional producido resuelto describing quoted-printable recién sqlstate creada inicio ajusta extensiones object especificó puede nuevo host offset alterado nueva invertidas about actual key_file: ningún generado generada & rararchive comentarios cadena varita misma sección mismo judía or anterior encriptado encuentra ejecución género entendible cambiarlo paquete encriptada termina lob localismo pares right_operand diferente errno textual falla petición solicitado etiquetas satisfactoria caché requerimiento), solicitada function completa línea posición modificar clases recientemente ultima continente encoded true alfabéticoas porción ejecutar comandos type consisite $size describiendo datos empty key_file similar siguientes encontrarse aa image/jpeg describe zend an as extraída caracter entero namechoice intento encontrada correspondiente imagemagick pdo::lastinsertid() ocurrió imagetype_jp2 traducido mensaje encontrado entrecomillado analizado 5 utf-8 utf-7 flujo /expresión/banderas difiere respuesta nodo update cuerpo imagetype_jb2 sql inglés estableció grupo ocurrido imagetype_jpc longitud elemento recortada imagetype_jpx blenc eof modificado modificada remoto constantes metaphone
$y0	descripción
$y1	control superior imagen 0 curva bezier punto izquierda primera esquina coordenada primer descripción
$y2	control segundo segunda bezier derecha primera curva coordenada punto inferior
$mask_image	haruimage valida instancia
$rprop_increase_factor	aumento disminución
datetime	objeto fecha datetime devuelve instancia nueva
$mincount	mínimo
$ctm	descripción
$compcode	completion code
$signature	firma éxito llamada si signature devuelta
$event	evento buferizado recurso ibase_set_event_handler() válido creado boolean
$gmtoffset	índice horas especificado gmt
$autoload	autocarga va encuentra través __autoload() defecto llamar clase método mágico establece __autoload si permitir cargue automáticamente realiza original
$handle	dba_popen() fclose() ser exitosa cerrado creado archivo apunta usando almacenar popen() devuelto éxito llamada evaluado apuntador todavía local dba_open() sitema debe válido correctamente base normalmente fsockopen() resource fichero recurso apuntar haber datos sido fopen() gestor puntero abierto
$oauth_auth_type_none	ninguno
$query_string	sentencia sql
$tagnum	encabezado rpm etiquta número obtener
$signature_alg	int firma algoritmos -
$pmo	put message mqpmo options
recursivearrayiterator	actual object si iterador array entrada
$longitude	defecto oeste negativo longitud valor
$baseclass	quiere clase extender dom
$personal	nombre cuenta propietario
$input	analizar ser texto entradas array extraer objeto matriz columna ficheros yaml input local entrada repetido secuencia string buffer nuevo resource multidimensional objetos intercambiado actual convertir formato valores u gestor
$newscope	ámbito clausura mantener clase static actual asociar
$entry	completa fichero recuperar url dentro información ruta archivo especifica array acerca borrar entrada
$gestor	dba_popen() devuelto base datos gestor dba_open()
$off	rayas hueco longitud
$functionname	cadena nombre función
$new_include_path	nuevo include_path valor
$interval	see periodic operation modes watcher
$verbose	imprime detallada si reconocidas información acerca clases
$trans_args	ibase_write ibase_rec_no_version ser ibase_consistency ibase_rec_version combinación puede ibase_read trans_args ibase_nowait ibase_concurrency ibase_wait ibase_committed
$tv_usec	véase tv_sec descripción
$optlist	r0 usa tipo contener argumento debe parámetro optlist círculo si parámetros inicial radial actualmente radio sombreado final r1
$encoding_mode	codificación modo
$flags	evloop_nonblock máscaras indicadores compuesta claves casos out-of-band msgrcv w intentar filtros cadenas abrir manera son: primer junto forma banda atributo presente llamada svn_no_ignore preg_pattern_order glob_nosort utilizado función 0 preg_split_no_empty aplicar segmento valor cómo patrón extendido entrada procesar tomar cuales soportadas campo habitual ldap_escape_filter posibles mayoría escritura opcional devuelve operación bbcode_container arrayobject arrayiterator en: get validación colisiones çvos opción matriz partir svn_discover_changed_paths creación evloop_once determinar bandera | modo the set banderas ser capturadas índice véase svn_stop_on_copy valores: binario valores existe niformación xattr_create combinaciones información máscara array flujo adicional preg_set_order: apc_bin_verify_crc32 devuelto afectan devuelta pattern manejar producida filename así determinda proporcionados datos inválidas ficheros) lectura coincidencia or| stream_oob xattr_dontfollow juntamente var_dump sucesivamente debe ordena bandera: puede nuevo base coincidencias usar preg_split() establecido seguido c (|) operador shm_rdonly válidas: utilizar etc bitmask operar modificación), escapado resultados trata or bits): añadida opcionales pasadas simbólico preg_offset_capture combinación apc_bin_verify_md5 cada ipc_create) svn_all no-válidas/numéricas estan establece pasa desactualizados), métodos directorio usa to coincidentes subpatrón falla solicitud barra verifica dns compartida bits indica: proporcionar elementos escaneo aplica opciones oob pueden perfiles completo flag observe esquemas añade bajo actualmente siguiente acceder lista escritas obtención entradas escribir afectar poder permite independientemente contexto indicar acuerdo propiedades siguientes crear sqlite añadirán cantidad conexión tratadas describe filesystemiterator ldap_escape_dn establecidas libxml ambos proceso enlace vacíos xattr cadena $matches leer objeto glob_mark añadir comportamiento svn:ignore - indicador parámetro especificar 1 especifican pasar foreach utilice svn_non_recursive preg_grep_invert codificación combinadas = pkcs7 documento shmat) nivel además svn_show_updates memoria normal unidas nuevos clase busquen aparecen sigue ordenar ignorar cualquier paréntesis obtenidas unidad svn_omit_messages ldap_search() eio_o_* comillas tipo controlar utilizará secuencias coinciden necesite código devueltos firma si flags svn_ignore_externals constantes sólo
$capath	ac ssl directoria formato contiene ruta pem confianza nombre certificados
$zoom	aumento factor
domprocessinginstruction	false domprocessinginstruction ocurrido nuevo si error
$other	descripción
$level	nivel descripción desean compresión mongolog niveles nuevo registrar error_reporting constantes comprensión
$autocommit	conexión transacciones pasa db2_autocommit_on confirmarán si valor automáticamente
$index	va indice dónde empieza ser contener $values índice fuente archivo apropiados texto obtener phar ejectuar actualizar hacia establecer array null borrar imagen colección mapa saber destruido empezar quiere escala columna colores conjunto color ruta accede número buscar valor ïndice descripción basado entero línea posición string comprobado index indicé nodo ubicación limpiar puede nuevo paleta búsqueda corresponde integer bit precisión correspondiente longitud elemento establecido resultado tipo insertar campo comandos probar valores dentro contiene si 1 apuntadores iterador relativa
$param_value	nivel tiempo bloqueo 1-6 aislamiento valor segundos espera
$sigma	estándar gaussiana desviación efecto valor píxeles sigma
$args	ser asociativo defecto parámetros pasarán comienza argumentos información bloqueada array acepta solicitud van objeto area pasan llamada - creación clase start pasar número retorno cómo bloqueo claves: elementos funciona f_setllw enviados posición debe args variable lista función call_user_func_array() cmd opcionales length constructor tamaño pasados similar siguientes f_setlk
sdo_dataobject	sdo_dataobject raíz devuelve
$success	opcionalmente false pasa caso error éxito variable boolean establecerá valor fracaso referenciada true establece
$directory	raíz mapa cambiar partición directorio archivos disco ruta destino sistema examinado borrar
$matrix	matriz descripción float valores 3x3: afín contiene colores tres matrices
$col_name	quiere esquema columna conocer
$ctor_args	array constructor pasados elementos
$resumepos	empieza fichero descarga remoto empezar archivo comienzo posición descargar
$cache_cb	retrollamada previa null lectura caché
$reason	qualifying reason code compcode the
$return_float	float vez devuelve array true establece
$proxy	servicio conexión yaz identificador proxy idendificador
$arg4	canal : img_filter_colorize alfa
$arg1	stream_option_blocking nivel option significa 0 1 img_filter_brightness si solicitado brillo : bloqueo modo
$arg3	componente : azul img_filter_colorize valor
$arg2	componente stream_option_blocking img_filter_colorize option establecida si verde valor : opción
$link_or_trans_identifier	cabo lleva deshace transacción omisión si enlace argumentos invoca función
$character_mask	parámetro especificados manera ser medio pueden desean eliminados retirar especificar caracteres puede character_mask usando opcional
$right	página derecho derechas parámetro coordenadas operando opcional
$escape_char	carácter solamente) parámetro opcional escape escape_char establece
$array1_sort_order	anterior orden argumento usado ordenar array
reflectionmethod	prototipo objeto tipo instancia clase método si devuelve constructor reflectionmethod null refleja
solrqueryresponse	solrqueryresponse
$facetsort	use índice cuenta ordenar solrquery::facet_sort_count solrquery::facet_sort_index
$i5_time_sep	tiempo separador db2_i5_sep_colon signo - utiliza dos puntos:
$base_directory	porción tar/zip iteradores fichero splfileinfo completa clase objetos cada ruta archivo eliminar devuelven añada
$read	manera - caracteres socket_read() archivo precisa listados flujo ver matriz precisamente cero) cuyo sockets llamada disponibles flujos lectura comprobar observados read listo particular longitud socket recurso caso bloqueará final cadena fread() si devolverá
$real	array valores reales
$registernodens	registernodens deshabilitar automático registro ser parámetro nodo puede contexto especificado opcional
$fieldvalue	campo valor
$x509cert	examinado certificado
$server_socket	servidor conexión aceptar socket
$gid	grupo id
$token	oauth token
$newthis	clausura ser dada debería vinculado desvinculada null función anónima objeto
$opened	false significa - cerrado true abierto
$xresolution	x resolución imagen nueva
$more_entropy	establecido uniqid() añadirá retornado combinado adicional posibilidad usando entropía resultado único si generador valor lineal true final congruente incrementará
$output_vector	vector desescalar escalar salida
$softcommit	vista garantizar índice on-disk refresca rendimiento si mayor
$old_file	ruta primer archivo
$i5_commit	db2_pconnect() i5_commit establecer recomienda parámetro
$bbcode_container	retornado resource recurso devuelto bbcode_container bbcode_create()
$str	va binaria ser fuente escapar lógico texto frase realizarle mayúsculas codificar consulta extraer secundario lucene parte unescaped to deseada comparar entrada be hash string decodificada descodificado escapda recortada cortar url convertir decodificar codificado cadena codificada datos the original
$extract_type	tipo grupos extraer - parámetro mencionadas unidades $size grafemas número $size: predeterminado grapheme_extr_count define
$step	usado proporciona step secuencia intervalo disminuir si aumentar valor incremento elementos
$record	indexada asociado devuelto matriz campo valores ejemplo px_retrieve_record() contiene información ina función
$auth_type	auth_type orden banderas ser puede 1 preferencia según in oauth descendente siguientes
$cwd	comando trabajo inicial directorio
$fetch_type	constantes: fetch_type sql_fetch_first puede tipos parámetro dos sql_fetch_next ser
$img_effect_alphablend	normal true equivalente píxel pasar unsar mezcla imagealphablending()
$y-step	vertical distancia dirección ubicación patrón píxeles
$archive	ruta archivo phar disco
$iterator_class	objeto clase iterador usar nombre array itera
$script_code	código script
$data-type	vincula: tipo constante db2_char db2_double db2_binary variable dato sql especifica db2_long php
$dest_height	alto destino imagen
$remote_file	tiempo remoto ruta archivo última extraer modificación
$pad_string	ser uniformemente relleno necesario pueden divididos puede caracteres si nota número truncar : longitud pad_string
domnodelist	xpath clase objeto dada domnodelist coincidentes nuevo contiene expresión expression devuelve instancia nodos función nueva elementos
$sortdirection	ordenación dirección
$stroke_opacity	opacidad contorno
$revno	svn_revision_head actualziar omisión número revisión
reflectionextension	objeto usuario definidas clase definió representa reflectionextension extensión null clases
$index_start	índice empieza especificado contar
$error_msg	si rellenada error variable especificada ocurre
$hmode	right ser centrado completamete center puede derecha izquierda parámetro justificado left hmode fulljustify justify
$preferences	preferences controlarse especificando parámetro comportamiento asociativo puede iconv_mime_decode() configuración array elementos opcional contenga
$zp	archivo gz apuntador
$array2	extraerán segundo claves keys comparar array primer elementos
$array1	primer claves maestras reemplazados verificar cuyos arrays ordenar comparación inicial unir comparar array elementos combinar
$gupnp_type_int	variable integer tipo
$main_str	comparar string principal
$applname	servidor utilizada identificar db2_connect() conecta - enviado cadena host sql_attr_info_applname apuntador nombre usando cliente aplicación
$event_name2	15 permiten eventos
$event_name1	nombre evento
$value	serializado frases anteponer menos clave value/expression atributo asignar to número buscar valor reemplazado match comprobar gris establecer string opcional px_field_time servlet validez bytes actualizar cookies set depende ser véase escapar facetas db2_autocommit_off remarcados información curl_lock_data_cookie autocommit sentencia directiva insertar tipo matriz contenido inglete decrementar términos body ancho acción px_field_date debe puede nuevo base usar alterado fichero necesario insertado cadena notificación generador propiedad color añadido frase agregar px_field_timestamp intrucción size 0 type línea proporción caracteres option deshabilita apropiados facet selector tokens según colexxión guardar desactiva true establece vincular parámatro almacenado recibir descripción habilita value datos entrada spanscorer codificado siguientes generar analizar false tidy incrementar quantum minimum proceso máxima in consulta máximo contiguos trozos alor paradox añadir parámetro 1 fragmentos elige colapsar nombre opción documento constante aparecen comparte comparado variable longitud elemento constantes: dado sólo fragmento campo dada si artefacto the especificada único enviar remarcar
$noise_type	ruido tipo
$ok_packet	paquete ok tipo
$params	ser claves class_name añadido usarse $valor disable_authenticator parámetros operaciones último filtro consulta array flujo configurar asociativo lista - usarlos autenticación pasar inicio params = final llamado deshabilitar conexión establecer pueden debe opcional usar propieades objetos $matriz[parámetro] conexión: formato valores cadena constructor primero siguientes especificados
$geometry	geometría string imagen
$request	xml tipo petición deseada recodificación soap solicitud
$gmax	alto limite mas verde
$n_retries	intentos conexión conexion máximo número
$maxlen	preasingnación sugerida leídos utilizado valores char/varchar datos máxima longitud
$dbx_result_unbuffered	creará rows propiedad inicialmente 0 bandera data
$timezone_identifier	utc zona europe/lisbon indentificador horaria
$patch	cadena parche binaria
$initial_value	establecer ítem existe si valor actualmente
array	predeterminadas code día detallando fuente consiste completado simplexmlelement excepción kurtosis son: primer row atributo salida inverso sub-cadena including igual 0 estructura filas detalle vea solicitado cuadrada string componentes encoded_headers sujeta lanza tratar devuelve fam coordenada matrices codificados arrayiterator rspuesta lstat() level php_output_handler_user mayúsculas-minúsculas presentes p similares devolverá recuperados relation petición dir banderas repositorio: rrd pendientes cuyos valores bandera canal/es definido definida argumentos port blue raíz disponible tipo firma acceso 4 quedan casillas sobra calendario expresión eventos hash versión mensajes ubicación antiguo activo hsl mes solrclient apache path interna numerador establecido reflectionclass inotify todsa cero k colección regulares delimiter resto tamaño árbol código sesión localizar reciente declaradas texto coordenadas unix api semana ancho/alto gestores total encontró bloques métodos to uso pudiera deracha coincidentes oauthprovider handler todas numéricos 6 msg delimitador descripción start more funciona skewness cuantía pudo núcleo contienen perfiles sucedió celda según formada porcentaje asociativos funciones servidores guarda almacenado representing extraida buzón columns generada spl lanzó invertida salto espacio mostrando cantidad indexados contexto dimensión apropiados etiqueta proceso adjuntado abiertas tal php_output_handler_end soportados objeto propios actuales 1 url-rewriter mediante retorna flujo nombre xhprof dividido recipiente: blocks gopher_xxx max resultset rango dato nsapi devuleta sistema date end horizontal delimitadores recuperada dependencias mimetype orden representando vacío vacía converitdas h:i consistente alias si green cascada obtiene minúsculas entradas: único linea primero numérica principio oci_error() asociativo asociativa numérico metadatos clave proporcionó mayor antiguedad superior forma trazo separados mysqlnd_memcache fichero/directorio detallada estadísticas valor nombre_archivo extendido entrada conexión geometría timestamp recipiente nlink muestras encontrados cargados multidimensional conflictivo name relleno rellena cubrid descrito adicionales numéricamente representa mode each nombre_constante modo transformación weight ej obtenida nombres mysqlnd_ms resutaldos iformación device_type información array opcional clases category sqlerrd5 internamente asociado matriz cargada dónde rev asociada content constante 7 red anidamiento canal ámbito dependiendo ordenados asimetría archivos mes/día/año base mime acuses conflicts allá pairs fichero g hilados el/los impresion contiene length produce iso resultados asociativas existen fetched propiedad variables ítems cada elementos: ficheros/directorios valor_constante arrego message full_status imap_errors() cuántas size php reflectionfunction existentes script [last_author] basada recopiladas miembros 2 clave/valor histograma compartida final elementos decodificación hue 8601 segundo that caché resultado tokens corresponden asociadas dio_stat() parciales copy lista activación apropiada : 15 keyword estructura: cambios desencriptado uris r tres and false colecciones plaintext siendo arreglo width parámetros recursos dados null msg_perm any devueltos [time_t] min dirección internas única parámetro servidor disponibles borrado new coincide = soap documento nivel copia getdocnamespaces clase directiva numero fallo númerica device alpha array[created_rev] quantumrangelong falla comienza mínimo métricas usuario url fallar __autoload m cambio dos denominador mensaje direcciones establecidos cuyas claves d) text campos: dimensiones errstr máquina hace usando php_output_handler_cont indexada referencia combinado udn fecha original columna método indexado detalles asignación bases curtosis número traída folder restantes claves: inferior ningno abreviados modos there da autor b php_output_handler_start traza llave certificados falló imap posibles aún uids luminosity gráfico bytes ordenado partir sqlerrd4 sqlerrd1 sqlerrd0 sqlerrd3 sqlerrd2 x nodo-i resultante insensible set ser rojo índice aplicada gmagick caracteres are último dividir última carácter subject prototipo vertical devuelto contenido pattern marcador filename llamada 3 quantumrangestring notificaciones creados visibles 0) significado: lote llamado enlaces ancho existieran interfaces incluidas agrupados sola estadística) ubicaciones punto suscritos c propiedades identificador codigo revisión pdo categorías indicados asignados ocurra ocurre falló, retornado author color corresponds height (últimos códigos configuración corresponde inode definidos solución contrario opcionalmente getimagesize() grupos optional cabeceras inclusive éxito normalizados msg_stat_queue conteniendo conjunto detallan miembro conexiones fracción columnas enteros produjo > alto opciones namespaces actualmente píxeles ficheros case acerca formateada caso formato incluya números n cursor encontrar substrings públicas error acuerdo entero ini real incluyendo ésta binaria éste guía mtime saturation verificación deliberadamente mayúsculas in consulta devueltas filtrado cromaticidad id if facet par máximo parte nombre_modulo hostname ruta unión calculados status éxito: http memoria singulares keys definidas devolver characters registradas especificadas límites id_recurso dado espacios siguiente recurso profundidad blanco dada completos límite izquierda especificado primario the especificada result_id svn true - unicode imagickpixel targetreference tipos not operaciones cadenas bloque gmagickpixel comenzando analizadas función pila class_name circundante blob input patrón gmp dispositivo predeterminado recolectada cuales mismos válida (0 identificadores retornada edición campos resolver bloqueo integer capa d ctime neuronas solicitaron imagick minutos) ninguna inclued msgno output gestor ninguno palabras imagen leídos manual asignado documentada entradas respuestas extensión división ob_start() clave-valor página esquema id3 / resolución tener estáticas utilizando actualización comparación object puede mapea estructuras versiones host offset simples integers línea) actual socket ningún generado column of mysqlnd protegidos ids [n/d] acl cadena representación regular generados mismo or ejecución lanzado references índices factor propósitos imagickexception lob rows pares log encontro errno array1 * objetos registrando gid etiquetas ipv4 véase todavía modificación solicitada fase desempaquetados completa línea posición inotify_instance ob_get_status() completo distintos controladores oauth line atime volteado y/o produzca fdf arrays type buzones lisata extendidos describiendo datos arrayn división) etc) display siguientes agrupamiento uid stat() blocksize describe pid an fila extraída file archivo php_output_handler_internal muestreo obligatorio operación muestra correspondiente imagemagick default terminating 5 indexeado alerta convertidos servicio registro respuesta mongodb flujos: concernientes multi-dimensional búsqueda año estableció grupo duros elemento configuraciones reflectionparameter añadidas modificado required mismas consultada parejas demás atributos iterador time constantes módulos cpu identifica
$delimiter	éste delimitador cada serpara parámetro array carácter establece rows si símbolo filename string separa sólamente) campos opcional elemento fichero campo empleado valores delimiter especificado escapado especifica sólo carácter)
$dbase_identifier	devuelto identificador dbase_create() base datos enlace dbase_open()
$n_priorities	evento prioridades número base
$encoding	salida encoding palabras yaml_any_encoding texto valores caracteres xsd_ entrada/salida establece codificadores xml utilizar ver parte lista argumento parámetro id yaml_utf16le_encoding mb_http_output() mbstring php4 codificación comprobar define carácteres http soportadas yaml_utf16be_encoding opcional constentes nombre integrados usar documentos espera permitidos empleada módulo codificaciones cadena si seleccionando entrada declaración convertir especifica yaml_utf8_encoding constantes documento zlib_encoding_*
$host	apunta ftp parte correo cubrid cas ip esperando sql job puede server servidor host memcache conexiones dirección nombre memcached ser
$outer_bevel	bisel exterior ancho
$exception_handler	excepción llamar capturada nombre ocurra función
$dy	descripción
$dx	descripción
$envelope	array campos cabecers asociativo
$value_compare_func	véase considera menor primer mayor usort() argumento igual debe entero segundo definidas devolver respectivamente comparación funciones función ejemplos usuario cero uksort() si
$protocoloptions	message_length mensaje: espacio nombres clave total 42 petición valor protocolo mongodb usado dbname cable identificador bytes codificado request_id tamaño namespace mensaje enviar
$dn	entidad nombre distinguido ldap
$db	base datos
$deep	recursiva forma indica nodos subárbol importednode método copiar si bajo importará descendientes true establece
$req_params	requeridos parámetros
$description	be fails description ds that definición archivo - assertion rra an will failure origen in included datos the optional message if
$preg_set_order	1 forma primer segundo sucesivamente ordena conjunto 0 coincidencias resultados array $matches así
$new_size	nuevo tamaño
$c1, c2, c3, c4	véase ps_setcolor() significados función
$increment	incremento cambio prioridad valor
$process	proc_open() evaluado resource cerrado recurso
$reverse	1 ordenación establezca inversa
$raw_request	cadena xml formato servidor solicitud
$base_group_id	normalmente grupo contraseñas número fichero
$#n	decimal ejemplo punto n izquierda número dígitos caracter máximo espera
$liveforever	cursor inmortal si debería ser
$cols	terminal columnas número nueva imagen
$index_key	usar índices/claves columna array devuelto
$mysqlnd_stmt	sentencias mysqlnd gestor
$page_per_pages	puede albergar número páginas objeto
$only_names	perfiles propiedades nombres si devuelve sólo
$gamma	gamma corrección cantidad valor
$key_compare_func	claves considera menor hace primer mayor argumento key_compare_func igual llamada mediante retorno entero segundo debe devolver respectivamente comparación función (índices) cero si
$character	convertir carácter código unicode
$unserialize	establecido serializado true módulo sesión tratado usando mecanismo si mismo mensaje
$cascade_candidate_stagnation_epochs	estancamiento candidatas cascada número épocas
$messageheaders	operación opcode response_id respuesta identificador réplica bytes request_id servidor petición length clave valor integer mensaje código longitud
$flag	personalizada omisión clave usando característica valor fin frases inferior remarcación \answered \deleted establecer cerrarlo remarcar función memcache_compressed cabecera estadísticas banderas ser bandera definido legales argumentos comprimidos página estaá marcados eliminando términos cl_expunge excluye limpiará mensajes puede liberados \seen usar activa habilitar utilizar indicador resultados deshabilitarlo palabras explícitamente frase determina rfc2060 volcado use usa array_filter_use_both \draft aunque conjunto : define componente \flagged pueden compuestos depuración incluir flag guardar desactiva true créditos habilita zlib buzón datos silenciosamente spanscorer false término tratadas implícito generar oci_lob_buffer_free consulta recursos array_filter_use_key límite deberían argumento - parámetro pasar envían documento lugar unidas información aparecen hacer deshabilita resultado mostrar dentro callback si sólo único
$sec	enero 00:00:00 1970 1 decir número segundos época
$set	establecerse false bandera debería si true
$result	serializado traído ejecutada clave query pg_query() cubrid_query() referencia evaluado número valor pg_query_params() conexión returned number fbsql_query() función básicamente resource large ser paso entradas caracteres result información mysql_list_dbs() convertidos adicional cubrid_list_dbs() tipo devuelta llamada proporciona valida dbx_query() by postgresql of identificador contiene manejador tamaño fetched indica contener sistema fbsql_db_query() evaluando array rpn lob representación éxito textual conteniendo conjunto petición type cubrid_prepare() decodificación posición resultado stepsize servidores formato valores cubrid_execute() scan: puntero va sqlite proviene término siendo específico cubrid_num arreglo enlace consulta devueltas odbc_exec() devueltos correspondiente - interbase codificación cubrid_assoc status cubrid_both viene respuesta pg_lo_open() object resultados búsqueda variable pg_execute() tomada escaneo ldap_search() devuelto recurso modificado dentro si position the
$filesize	bytes número reservar
$events	y/o ev_write indicadores ser ev_read pueden combinación conjunto evento cualquier deseado
$return_array	establecido object vez si devolverá array true función
$bytes	requeridos leer contenga bytes parámetro menos especifica aunque flujo
$container_bbcode	retornado bbcode_create() bbcode_container resource
$key_len	bytes clave cifrado longitud
$dest	contiene dest modificada determina parámetro visualizar ruta destino cómo new_file1 new_file2 archivo unión parche resultante documento
$unique	atributo identificar particular tarea unique único id
$fieldname	forma string fdf campo cadena nombre
$encoded_headers	cabeceras indicarlas decodificar string
$i5_lib	referencias bibliotecas evaluadas indica default utilizará archivos cadena resolver lista
$message_code	evento disponible pasado descriptivo si mensaje código
closure	closure creado false objeto recién caso nuevo devuelve error
resource	almacenados cuyas zip_close() show tener ejecutada cerrado prceso imagen zip_entry_ escriba diccionario pty hacia bloque primer usando compartida podrá xml cubrid_query() forma bbcode_container ibase_blob_add() referencie true explain utilizado parseado relación filas blob segmento valor normalmente dispositivo entrada conexión válido dejara handle válida formulario rpm_open() apuntador luego (únicamente campos especificados devuelve fam resultaod registros función devuelto intérprete ldap_first_entry() resource ejecutó obtenga bytes lectura filename descomprimido representa -1 devolverá stderr clave gestor modo usarlo ssl-ftp ser leídos lea índice odbc mysql entradas hija fuente result imap información ldap producen flujo servicio sentencia raíz persistente proc_close() disponible tipo errores msql mysql_unbuffered_query() x509 bien primarias monitoreo cola mensajes red llamado eventos neuronal idéntico debe sera puede nuevo base después redimensionada zip_read() usar ocasionó botón fichero subsiguiente ibase_blob_get() similar regresa transparente imgane utilizar contiene fallo archivo comando frontbase resultados interno abierto idenrificador devuelven ocurre exitoso llaves liberado mssql_bind() rotada búsqueda leídas mágica creado cursor transacción procedimiento semáforo propósitos igual permisos tabla select solicitud lob contrario positivo cosa excepto almacena stdout éxito system describen conjunto petición solicitado procedimientos statement analizador criterio columnas resultadosa poder produjo número request_identifier posteriormente interpretar entrenamiento preparado estilo memoria usado contienen correctamente subyacente falló representando ingres aceptado abrir acceder an lista funciones socket case existe multi almacenado fdf caso cifrado entregados mysqlnd exitosamente descriptor manipulador datos ms error fopen() parámetros certificado identificador puntero ejecutar sentencias v false directorio funciona contexto procedimientos) describe share debería usarse pclose() comienzo proceso bzopen() enlace conn_identifier recursos consulta curl envoltura intento if evento mssql_execute() callback argumento deberá - parámetro fué sybase fbsql_field_xxx foraneas retorna preparada msql_fetch_array() uni-direccional comprimido documento modificar!) secuencia terminado buffer copia nuevos devolver representan occurred manejador conjuntos produce ido cualquier sql devuleto llamadas especificadas falla componente resultado sólo siguiente través recurso stdio acaba or coinciden si criterios producirse ¡no especificada mensaje escritura) subsiguientes
$http_headers	http ejemplo accept user-agent etc cliente encabezados
$responsewriter	xml json autores: siguientes phps
$numcolors	colores número
$multiline	multilínea parámetro
$link_identifier	dbx_connect() dbx transacción enlace mysql última correspondiente objeto devuelto msql interbase ldap fbsql_pconnect() conexión ldap_connect() sql fbsql_connect() función mssql_connect() mssql_pconnect() identificador abierta si asumirá contexto ms frontbase especifica
$dbx_result_assoc	devuelto puedan claves consigue valores campos propiedad objeto nombres acceder data columnas respectivos usados
$to_neuron	neurona finaliza posición conexión terminal número
$details	actual recupera detalles cada configuración valor sólo
$setting	configurar p propiedad parámetro nombre
$isid	establecer name tipo quiere si false true id
$preg_pattern_order	así forma primer paréntesis sucesivamente ordena coincidentes subpatrón completo 1 0 coincidencias cadenas resultados array $matches patrón
$peername	seleccionado disponible transporte dirección) incluido si establecerá nombre cliente conectó,
$fetch_flag	fetch_flag unidas lógico combinación ibase_text operador ibase_unixtime constantes or
$exception	and excepción is second in throwable if fails lanzar assertion 7 which instead parameter be descriptive that object assert descripción php thrown string case this of will can generador the
$query_data	contenga objeto puede u array propiedades ser
$threshold	comprimir intentar inclusive color controla vuelve umbral negro 0 solarización debajo extensión valor automáticamente 8 define detorción mínimo longitud 255
$exclusive	xpath análisis coincidan espacio nombres habilita exclusivo prefijos proporcionados nodos únicamente
$yray	raya elipse dirección
$delay	ítems retardo imagen segundo 1/100avo retraso número segundos esperar invalidar
$ignore_transparent	establecido cero transparentes colores ignorados si conservan modo
$targets	hacer ser único archivos parámetro target rutas advertencia commit array aceptada locales string
$local_socket	socket tipo url transporte formato transporte://objetivo creado estándar: determina especificado usando
$schema	ser debería tratar creado tabla esquema objeto tipo puntos 1 procedimientos notación tablas indicada debe oid nombre propietariio apuntar identificador contiene especificado
$ex	coordenada x circundante rectángulo final
$ey	coordenada circundante rectángulo final
$constantname	constante nombre definida cadena
$font_index	letra devuelto tipo imagepsloadfont() fuente recurso
$row	dentro resultado accedida traído índice utiliza cursor siendo conjunto especifica fila recuperado número resultados accederá acceder scroll recuperada
$rot	grados rotación ángulo
$compose	operador composción
$lob1	lob identificador
$lob2	lob identificador
$observer	splobserver separar
$radix	10 base predeterminado: valor
$priv_key	corresponde cacert privada priv_key clave
$encoded_string	url datos codificado
$configargs	y/o ajustar opciones especificando firma archivo exportación puede openssl mediante proceso configuración configargs sobrescribiendo usar csr
$count	carácteres hechas reemplazar leer realizados éste reemplazos bytes parámetro variable si rellenada número especifica sustituciones pasado establece
$preg_split_no_empty	aplica bandera devueltos si vacíos preg_split() sólo elementos
solrquery	usó actual objeto usa si devuelve valor retorno solrquery
$field	ser obtenido traído índice siendo tabla 1 columna desplazamiento field número nombre basado seguridad copia puede punto recuperado seguido dado campo nombretabla nombre-de-tabla
$subjectlength	caracteres fetchsubject número propiedad
$mask	eventos string cada nombres observar caracter mask restringir contiene archivo permitido máscara
$new_link	mysql_connect() enlace cubrid_connect_with_url() establecerá hace argumentos devuelto vez llamada lugar conexión mismos segunda nuevo sino realiza función nueva establecido mssql_connect() mssql_pconnect() identificador abierta si devolverá cubrid_connect() abierto
$nseconds	segundos número
$country	país clase constante gender identificado id
domcdatasection	false ocurrido nuevo si domcdatasection error
$activation_steepness	pendiente activación
$idna_info	variant puede si intl_idna_variant_uts46 parámetro usar sólo utilizó
$session_id	leer ser destruido sesión información id
$class_method	nombre método clase delimitados ::
domdocumentfragment	false ocurrido nuevo si error domdocumentfragment
$which	va cuál indica valores calcular cuatro argumentos siguientes entero
$imagecontents	contenido imagen
$trustedcontext	conexión pasa db2_trusted_context_enable si confianza valor establece
$search_criteria	cadena criterios formato imap2 búsqueda
$user_vars	copiadas variables van ser usuario
$externalpath	fichero directorio url ruta phar dentro externo archivo montar
$limit	volcar logs limite obtener substring cada límite colocado último rango) limit array máximo establece string página devueltos positivo devuelto matriz devuelta contendrá substrings parámetro conteniendo conjunto 5 número valor sustituciones patrón subject type elementos peticiones cachedump usado inglete máximas completo rango limitar después grupo punto posibles únicamente elemento entradas actual recurso cadena si resto enumeración especifica define código primero
quickhashintstringhash	nuevo quickhashintstringhash deveulve objeto devuelve
$port	bajos servicios pasa job address siendo mayoría $cubrid/conf/cubrid_broker alternativo obligatoria mysql información apunta broker_port port usados mejores desgina asociado tcp/ip usa contendrá esperando af_inet parámetro sockets servidor todas número hacerse puerto memcached interfaces conexiones af_inet6 conexión aplica recibida pueden debe solicitudes puede debería configurado mecached host base cualquier sistema usar altos da escuchando dado socket cas cubrid conectarse números remoto server si memcache datos escuchar argumento especifica sólo 418 intentar
$shm_identifier	shm_attach() memoria obtenido recurso identificador segmento compartida gestor devuelto
$new_value	assigned will encuentra indicado key get valor value nuevo to si coincidencia which new variable asigna
$working_copy	copia si cometidos exportará true ficheros trabajo
$anything	variable serializar
$edition	database create edición edition anteriormente comando sql oracle nombre creada
$fam	servicio conexión recurso devuelto representa fam_open() fam
$gravity	propiedad gravedad
returntype	false devuelve recurso caso paso éxito neuronal error tamaño inicial red
sqlite3stmt	false objeto caso clase éxito devuelve error sqlite3stmt
$type_name	nombre tipo
$code_page	exactamente forma clase actúa misma hace com
$word	añadir verificar comprobar palabra
$next	establecido referencia siguiente valor inicio posición
$ber_identifier	memoria mantenido identificador ubicación ber_identifier parámetro interno hacia interna puntero
$connection	pdo_mysql pecl/mysqlnd_ms ser obtenido cloudscape obtenida hacia variable api momento connect enlace mysql cualesquiera php resource functions inició oci_connect() tipo devuelta controlador servidor empleando interbase cualquiera ext/mysql extensiones conexión válida dejó mysqlnd correctamente oci_pconnect() oracle base cuales oci_new_connect() apache mysqli db2 activa funciones devuelto postgresql ibm recurso db2_connect() of identificador database algún connection datos db2_pconnect() derby especifica the > gestor cliente
$index_or_name	índice nombre columna obtener
$multiplier	repetido veces ser debe número input string
$pos	solo analizar secuencia posición 0 etc texto primer yaml -1 inicio documentos extraer nueva documento
$minor	kernel identificador dispositivo menor
$pk_owner	propietario clave primaria
$parameter	cierre llamda matriz cero reuniendo parámetro adicionales método pasar nombre retorno parámetros pasados posible función pasando ser
$digit	convertir carácter número
$month	vendémiaire) depende inclusive periodo seleccionado cada calendar diciembre diecienbre 1 días año) final número válido calendario 5-6 previo mes año 13 12 enero relativo rango
$variable	va establecer ser devuelta contendrá columna asociada desea entorno valor variable php bv_name
$data	salida parámetro text arbitrarios importar claves uuencode comentario xml quieren asociativo personalizados codifica función to mediante alamcenada valor reemplazado instrucción entrada observador gzcompress() filtrar campo neceditan codificados resource mode neuronal bytea modo escribir ser binario almacenada caracteres cifrador cifrados información comprimidos flujo arbitraria asociado devuelto matriz contenido procesamiento codificada asociados red estableciendo be object insertar correcto debe especifican requieren pasada encriptar postgresql sqlite_udf_encode_binary() identificador cadena contiene base testigo aplicaron añadirá into empaquetados codificar serializados array imagen decodificados tercer van indexada custom petición firmar passed pi descripción final lob dados entrenamiento ejemplo gzdeflate() cdata comprimir guardar with anexar enviada decodificar formato attached valores px_retrieve_record() converted datos pasados codificado va associated debería watcher escaped subyacente gzencode() recursos px_new() string binary containing paradox segundo añadir iso-8859-1 comprimida pasar soap buffer devolver rango cipher user variable php data través usuario encabezado callback sqlite_escape_string() the strings
$parameter-number	sentencia posición preparada parámetro 1 primera especifica utilizando
$date	cadena fecha representa
$doc	domxpath asociado domdocument objeto
$extr_overwrite	variable existente si colisión sobrescribe
$gupnp_type_string	variable string tipo
$chunk_size	nuevo tamaño deseado trozo
$perm	semáforo bits permiso permisos opcionales
$embed	embargo solo encrustados matriz fuente glifo dentro incluida datos archivo pdf true establece
$dirname	crear zip tar directorio vacío ruta monitorizar archivo nombre
$faultactor	cadena causó identificando actor error
$param_type	base datos parámetro tipo
$right_operand	cadena operand right right_operand
$updateoptions	ser debería creado clave array permite criterios coincidentes valor actualización documento nuevo/s objeto/modificaciones búsqueda booleano true multi q coinciden si u actualizar upsert
$debug_level	agregando lado xxx_trace constantes formado entero
$new_height	alto redimensionar imagen
$lob_identifier_array	lob array identificadores cubrid_lob_get devuelto
$dash_on	guión estilo
$inputencoding	va base datos guardar codificación entrada
$subject	asunto correo busca sustituye cadenas array splsubject objeto buscar examinar actualización entrada observador reemplazar string electrónico notificando título pajar conocido cadena sustituir enviar
$raw_output	devuelto 16 primitivo resumen formato binario tratar si opcional devuelve raw_output true establece longitud md5
$callbackfunc	válida devuelva ser sección debe pasada parámetro llamada si extraída retorno null función asegurarse define
hw_api_attribute	clase hw_api_attribute devuelve instancia
$publicid	externo identificador público subconjunto
$ncolors	retener deberían colores paleta número máximo establece
$new_output_min	seguido salida límite estrictamente después escalar datos deseado inferior
$new_max	entradas entrenamiento nuevo después escalar salidas datos máximo
$atime	dado presente valor acceso si momento archivo nombre atime establece
$blur	borroso nítido < 1 menor factor dondo > mayor borrosidad
$treedepth	normalmente cero integer tipo valor
$quota_root	forma establecer ususario cuota debería buzón decir inbox normalmente quota_root
$file_name	ser fichero entrenamiento glo recién quiere creado datos archivo información nombre comprobado guardar delfichero
$clut	contiene imagick paleta objeto hald
$blue	componente color azul valor descripción borde
$new_location	url conexión nueva
$wbmpname	ruta destino wbmp archivo
$i5_dbcs_alloc	traducción db2_i5_dbcs_alloc_on alojamiento habilita dbcs esquema incremento 6x tamaño columnas db2
$pad_length	relleno longitud
$jpegname	ruta jpeg archivo
$activation_function	constante funciones activación
mixed	indicadores día considerado excepción independiente ca_info menor menos primer row atributo marcos igual 0 relación filas resources codepoint string lanza spool características contenidos registros posiblemente arrayiterator erróneo semada -1 devolverá especifica hora cookies atraviesa ejemplo valores produjeron definido argumentos index habilitado tipo firma canales método simple_case_folding potencia ; asociados hash versión interferido devielve interno establecido contrairo resto resta árbol options texto unix verificada concatenación descendientes select previamente to uso contains coincidentes aplicar cualquiera referenciado éxitos more sustituto apuntado impreso según soportado funciones almacenado almacenada exclusión ms codificado nonce lógica etiqueta proceso microtime() information objeto 1 retorna retorno nombre opción éxtio onoff resultset produce data estándar vacío vacía definió si numérica manera devuelve asociativo opuesta basename numérico jpeg clave hacia mayor substchar cola forma booleano valor entrada conexión auto array_rand() aleatoria january domnodelist pedido win32 mode sido count_chars() disp_e_divbyzero modo distinto nombres información dirname almacenamiento flujo matriz tales lectura elementos correcta casillas variant devolvieron base pasado pasaron definition fichero language omite contiene w resultados existen fetched propiedad encoding defecto variables cada elementos: podría array establece correspondencia excepto win32_no_error $this índice 2 retornan invocada dbplus_err_unknown solamente transcurrido option that needle corresponden lista seg (0:00:00 simple_titlecase_mapping aguja siguientes: apropiado seriamente puntero result and sentencias false banderaa inválido analizados msec parámetros requerida verificación 1970 dirección - parámetro which codificación = soap ca_path lugar warnings gmagick clase contendrán llamar fallo delante cualquier imágenes alguna negación dos left mensaje establecidos asignó estática salida show serializada tener seleccionado inválidos xml dbx_query() explain columna específicado número sustituciones varios da fecha falló resource binarios ampliado dependiendo segundos set ser nombre_valor) simplexmliterator existe caracteres pdoexception sec are último com_exception última carácter subject expresiones devuelto devuelta key() errores bidi_mirrored filename implosionado llamada satisfactoriamente available javascript punto sustracción simple_uppercase_mapping c array(0 identificador etc connection urls deserializado expression devuelven escritura auth_type simplemente indica color corresponds considerados corresponde contrario éxito normalizados conteniendo conjunto mseg json columnas produjo > opciones pueden instancia correctamente apuntando actualmente exception byte-value tagnum caso formato números value expresión gmt), error servir certificado incluyendo ésta is establecidas erróneos in consulta id if null parte unión mb_http_output() timestamp envío http devolver entonces php resultado siguiente reflejada recurso campo dada phar código devueltos especificado the especificada gregoriana abstractos proporcionado omisión tipos unicode db2_autocommit() expresado ambas mysql_query() entera blob input haystack puesta entero opt cuales accesibles variantes format válido variante posee integer bit función ninguna gestor ninguno válido), right imagen serializados rowid división numéricas nodos autocommit quizá producido fragmento obtuvo / inicio object pueda puede offset época actual extension generado of negativo sqlsrv cadena misma mismo or anterior encuentra float sol sustituidos lob rows microsegundos there solicitado satisfactoria caché parse_url() solicitada xpath línea posición json_encode() múltiples true y/o seleccionar arrays simple_lowercase_mapping datos escrito propiedades similar siguientes describe navegador an quantum fila file archivo condierado quitar operación correspondiente ocurrió reglas cuyo redondeado field frecuencia nodo proporciona connection_id representan comparación sql variable grupo problema elemento malformadas posible metainformación u iterador vacías sólo original
$escape_string	cadena escapar
$len	lob enviados quieren obtendrán buffer remoto escribir bytes longitud len host datos número leer buf eliminar búfer
$errormode	error modo
$waitsearcher	bloquo registrado haciendo consultas cambios buscador nuevo visibles principal bloqueo abierto
$input_headers	enviados ser petición array soap encabezados
$to	reemplaza envío from string dirección correo destinatario/s
$result_id	ibase_execute() indentificador obtenido consultas único!) odbc_exec() evaluando (¡consultas select ifx_prepare() ifx_query() devuelto recurso interbase solamente identificación selección solo valido válido resultid resultado resource tipo select) identificador odbc_prepare() odbc selección) ibase_query() resultados sólo result_id
$learning_momentum	aprendizaje momento
$td	descriptor cifrado
$ty	descripción
$tx	descripción
$bv_name	sentencia usado puntos (:) parámetro prefijado dos variable sustitución vinculada
$qualifier	os/390 indice ejecutan índice cualificador z/os bases datos calificador ejecutándose db2 servidores
$recursive	establece directorio desactivar hijos artículo array nodos targets recursiva forma declarados añadir true recursivo desea retorna -r flag emitido namespaces contenidos directorios hacer padre cambios list si comando especifica commit opcional
$soapheaders	definir encabezados
$conn_url	servidor conexión cadena caracteres información contiene
imagickpixeliterator	imagickpixeliterator objeto sección éxito si devuelve imagen
$force	recorrerá true archivos subversion si recursivamente agregar versionados directorios ocultos pueden fin
$ed	grados finales rotación
$prefix	generar xpath simultáneamente nombrar ser espacio nombres variables global ejemplo hosts prefix colocado requerido extr_prefix_if_exists temporal namespace petición todas nombre ns podrían varios ámbito casualidad útil identificadores puede generan microsegundo observe variable usar extr_prefix_same dado sólo fichero generado importadas extr_prefix_invalid cadena si flags mismo prefijo extr_prefix_all identificador
$new_path	ruta destino fichero
$max_len	línea longitud
$context	indica refiere añadido creado diff tarea consulte flujo aplicación devuelto sección parámetro filename desea 5 número líneas nota : descripción válido incluir ficheros php pasado funciones dirígase resultado flujos resource stream_context_create() recurso contexts identificador manual gupnp_context_new() contexto context asociar soporte
$handler	mysqlnd_qc_handler_default ser parser información almacenamiento objeto tipo contiene errores handler xml_parse() nombre existir llamado string debe usado puede interno path acceder true función enviar cadena establecerlo representa gestor cliente
$components	componentes píxel añadir cada número formulario array
$min	ser debe devolver php_int_min mayor valor mínimo
$reschedule_cb	callback reschedule
$minimal	tomar resultado establezca reducir tiempo parámetro si desea puede tamaño true
$xpath	xpath array nodos s filtrar
$hour	hora día year month relativa número inicio determinado day
$bevent	evento almacenado buferizado recurso buffer válido enviado
string|array	recupera línea actual fichero
$.p	seguido decimal punto p después número dígitos carácter
$still_running	referencia dice bandera operaciones siguen hace ejecutándose
$stmt	sentencias sqlsrv_prepare() ejecución contenga obtenido creado metadatos mssql_init() consulta bloque solicitud lob sentencia correspondiente devuelto devuelta sqlsrv_query() db2_prepare() obtendrá db2_execute() preparada sqlsrv_execute() válido stmt especifica función resultado sqlsrv_prepare recurso db2_exec() contiene datos resurso resultados sqlsrv_query
$system_id	entidad identificador parámetro cuarto especifica system_id declaración sistema tal notación externa
$end_revision	log último número obtener revisión
$gupnp_signal_subscription_lost	servicio siempre pierda suscripción condición emitido error
$min_saving	ratio cantidad compresión mínima valor especifica guardar
$ignore_upsert_status	insert si ignorar update /
$filter	ser documentación simple filtro información filtros) consulte imagen ver directorio avanzado ldap descripción utilizando completa booleanos puede búsqueda usar lista netscape sdk vacío formato permite operadores constantes descrito
$rmin	limite rojo mas bajo
$error_code	ser obtenido pasado error puede sqlite_last_error() fdf_errno() usando código
$stringparam	utiliza
$maxsegments	segmentos optimiza máximo número
$region_code	geoip_region_by_name() letras vea dos dígitos) código región
$numprimkeys	número claves primarias
$dash_off	guión estilo
$cmd	ser - ejecutado quita operaciones: puede comando asigna ejecutar bloqueo siguientes f_setlk
$fq	filtro consulta eliminar
$fp	descriptor archivo objetivo flujo
$fl	cal_jewish_add_alafim_geresh cal_jewish_add_gereshayim cal_jewish_add_alafim son: formatos disponibles
$blob_data	datos blob
$foreground	imagecolorallocate() establecer obtenido color identificador parámetro puede plano primer estableciendo
$fd	php resource fichero recurso p válido numérico descriptor abierto socket origen sistema dio_open() prevee flujo integer ficheros devuelto
$codepoint	tipo punto p valor integer código
$owner	propietario
$hostname	va ser obtenida ip obtener obtenerse usando port web cuya sitio consultamos quiere hostname comprobarse localización servidor consultar 2 número nombre equipo región queremos debe ubicación puede incluir activo base puerto host ejemplo: si openldap datos dirección
$restrict	xpath use ciertas parámetro permitir solamente llamadas funciones
$types	deben secuencia string contiene variables importarse valores puede especificar tipos petición parámetros parámetro proporcionados pasados cuáles usando types
scalar	contrario actual válida caso éxito scalar si clave devuelve error null
$filtername	filtro nombre registrado ser va
$expresión	expresión ser impresa
$threshold_map	entramado va mapa string umbral contiene usar nombre
$object	va estática propiedad añadido tidy datetime ser xml van objeto devuelto cuyo método evaluado solamente invocado nombre calculado comprobar removido object procedimientos: peticiones comprobado deberá estilo pertenece clase objecto cualquier usar invoca date_create() intérprete controlar encabezado identificador si datos proporcionar cambiará instancia asociar
$nombre_a_llamar	nombre llamado puede recibe ser
number	tipo hex_string binary_string decimal float valores octal_string representación devuelve valor integer suma
$colnum	resultado recurso válido columna stmt número
$length	onda copiar retornado momento dentendrá extraer bzread() número segmento valor grafema string 1024 da suceda aleatoria bytes dependiendo especifica imagen examinar caracteres comienza información subject devuelta desplazamiento lectura exportar bloques proporciona stmt después offset usar nueva espeicificado cadena unidades length leidos rango tamaño escritura tantos indica lob obtener dependiedo termina ser leído positivo desada positiva start final elementos descomprimidos línea buscar controlado retorno), porción decodificar escribir datos str escrito va cantidad alcance debería leerá substring máxima indique máximo leer contendrá - parámetro 1 secuencia devolver comparación php data longitud eof recurso dada devueltos si incluida especificado primero
$index_end	índice dejar llegar contar
$new_input_max	superior seguido límite estrictamente después escalar datos deseado entrada
$content	content verificada eliminada contenido escribir texto puede especificar cadena firma buscada archivo información nombre descripción rellenado nueva
$regex	/expresión/banderas pcre forma filtrar usa texto regular expresión opcional lista ficheros
domattr	false objeto ocurrió nodo sido si ocurrido nuevo domattr reemplazado devuelve error antiguo atributo
$tile_geometry	página p fila teselas número
$=f	único) seguido relleno f utilizará numérico caracter byte =
$on_off	false desactivarlo true activarlo
$dbhandle	sqlite sqlite_open() recurso devuelto resucrso usa base datos procedimentalmente
$green	componente color verde valor descripción borde
$needle	ser convertida substring caracteres convierte caracter buscado carácter utiliza interpreta buscar valor haystack ordinal aplica string needle puede observe integer aguja cadena contiene si sólo primero
$high	alto punto
$storage	actual tipo mantener almacenamiento remover importar contiene método quiere constantes píxeles lista consulte elementos
$src_y	coordenada origen punto
$src_x	coordenada x origen punto
$levels	directorios número subir padre
recursiveregexiterator	actual iterar puede si interno iterador entrada
$src_w	original ancho
$src_h	original altura
$matches	ordenadas éste matches proporciona multi-dimensional entonces si según coincidencias búsqueda flags resultados todas array llena
$solo_sintaxis	solo ser pueda método si verifica nombre true función
$webindex	servidor accede ejectuar web phar dentro si ruta relativa archivo
$okay	resultados si parciales acepta recepción
$fontfile	colección truetype archivo
$fontoptions	descripción
$hint_style	descripción
$function_args	cadena argumentos comas separada función
$bytes_max	parámetro si aplicar puede bytes_max rellenado
$modifier	necesario recurso identificador parámetro p si valor especifica solicita modifier recuperar
$minute	minutos relativos número hour inicio
$datefield	nombre fecha campo
$hebrew_text	cadena hebrea entrada hebreo
solrdismaxquery	solrdismaxquery
$tdo	ser tipo válido debería mayúsculas) nombre
$pieces	array usados strings implode ser
$operationheaders	indicadores índice creado clave máscara id creó inicio servidor start cursor_id cúantos protocolo returned (0 valor integer bit documentos expirado) devuelven cursor si flags ninguno
$substrchar	entidad s: none carácter string salida ȁ) jis+7e7e) ejemplo: long entity producir u+3000 unicode valor especifica integer : código siguientes
$arr	lugar arr segundo presente variables almacenadas parámetro si variable array elementos
$severity	stream_notify_severity_* severidad mensajes errores notificación constantes nueva
$arg	radianes cada pasará argumentos data argumento parámetro custom llamada valor entrada comando dato opcional background llamadas pasado usuario procesar opcionales callback datos escapado com
$ftp_stream	conexión identificador enlace ftp
$auto_release	ser liberado automáticamente cierre debería semáforo si especifica petición
$sql	sentencia ejecutada ejecutado ser sql
$is_prefix	false considerado defecto uri si prefijo ns true is_prefix
$var_array	array
$server_path	web alojado diretorio servidor ruta local_path archivo
$mensaje_error	generado contendrá usado parámetro si error mensaje_error chequeo mensaje sintaxis
$frame_name	nombre forma string contenedor
$msg_number	mensaje número
$notext	adicional false salida parámetro entendible afecta verbosidad si seres opcional humanos información incluirá notext
$displace	mapa imagen cantidad color desplazar desplazamiento
$convmap	convertir área convmap especifica array código
$encodingfile	exacto fichero documentación formato descrito t1lib
$line_pos	cero base interno número apuntador mover
$public_id	public_id espacio habia requerido tal especificaciones xml blanco parámetro quinto mediante notación entidad normalizado público vacia identificador cadena si especificado declaración especifica externa
$pid	conexión estadísticas van hilo identificador obtener proceso matar eñ ide id
$label	añadir etiqueta
$max	ser debe devolver php_int_max igual menor valor máximo
$update	criterios actualización
cairosurface	cairocontext objeto devuelto éxito si falló
$oauth_auth_type_authorization	http pasa cabecera parámetros oauth authorization
$gupnp_signal_device_proxy_available	nuevo siempre dispositivo disponible emitido
$modulus	cadena modulus
$username	conexión asignará recibe usuario alfanumérico conecta autenticación nuevo oracle si base datos user sybase ingres nombre
$condition	establecida condition_type condición parámetro
mongocollection	nuevo objeto mongoupdatebatch colección devuelve mongoinsertbatch
variant	vt_date objeto devuelto script variante igual si solicitado devuelve ejecutándose com
$query	lucene cadena delete) documentación guía véase búsqueda debería coma estandard parámetros textual mysql información consulta find string sentencia referencia ejectuar representación tal adecuadamente terminar petición interbase buscar rpn válida preparada update punto manejador conjuntos campos preparar sql ingres) aql definida documentos identificar insert típicamente type-1 z39 opcionales dentro ccl criterios escapada ejecutar
$document_or_id	referencia usado objeto campo proporciona si array _id id
$contextnode	hacer xpath parámetro consultas contextnode puede especificar opcional relativas
$class	objeto pertenece clase interfaz método u instancia nombre string
$intstep	rrd intervalo introducen base datos segundos
domdocumenttype	establecido null nodo nuevo domdocumenttype ownerdocument
$fromlength	caracteres fetchfrom número propiedad
$passwd	contraseña usuario
$base	associated comienza event string hex sistemasystem_id 0 nota var 8 ; : tomará usada object conversión octal base resolver notación identificador the 10 16 0x formato incuye si determinada declaración toma prefijo decimal
$variant	#46 objeto uts variante intl_idna_variant_2003 2003 intl_idna_variant_uts46 idna
$connection_id	ver identificador odbc conector odbc_connect() información
$replace_pairs	lugar forma from caso cuyo parámetro replace_pairs to usar podría array = >
$number	específica ser number radianes entradas 32-bit negativo argumento 1 0 formateado 2 número valor retorno entero protocolo &nbsp recuperar positivo registros 10 máquinas convertir decimal procesar cadena rango
$dict_type	enchant_ispell diccionario tipo enchant_myspell
$type_namespace	nombres tipo espacio
$black_point	blanco punto
$ip_address	servidor dirección huésped ip
$uid	uid mensaje id usuario
$params_array	sapi opcionales limita configuración parámetros cli
$old	anterior tupla antigua valor actualmente guardado
$detail	información causó error
$files	van ser directorio nombres array colección ficheros/directorios opcional copiados nombre prefijo extraer ficheros fichero
$inner_bevel	interior bisel ancho
$precision	debe vincular base datos especifica precisión
$scaledfont	descripción
$str2	ser segundo distancia segunda evaluados levenshtein cadena strings string
$str1	ser distancia evaluados levenshtein cadena primera primer strings string
$fdf_document	fdf_open() devuelto fdf_create() fdf manejador documentos gestor fdf_open_string() documento
traversable	objeto iterator traversable implementa interno iterador instancia tal iteratoriterator::__construct() pasó
$request_identifier	identificador cubrid_prepare()
$yresolution	x resolución imagen nueva
$gmpnumber	php resource 5 número gmp exportar
$rectangle	coordenadas arreglo 4 anotación clickeable área
event	on object event success
$new_file	ruta segundo archivo
$old_data	cadena primera información binaria
$signed_text	firmado texto
$bbcode_arg_parser	retornado bbcode_create() bbcode_container resource
$tv_sec	tv_usec mientras microsegundos parámetro segundos parámetros número timeout especifica juntos tv_sec forman
sdo_das_xml_document	caso éxito objeto devuelve sdo_xml_das_document
$effect	constantes: img_effect_normal img_effect_alphablend normal mezcla equivalente img_effect_replace píxel pasar unsar usar mismo sustitución true siguientes imagealphablending()
$nombre	llamada devolución función revisar
$day	1 dado 30 depende día final 31 válido month dentro número mes rango calendar relativo previo días
$version	xml siempre parte versión numero omisión 1 declaración valor oauth descripción soap documento
evprepare	caso evprepare éxito objeto devuelve
$desiredmsgtype	frente desiredmsgtype 0 si devolverá mensaje cola
phardata	objeto phardata caso error éxito lanza método devuelve excepción
$layout	página muestra - valores aceptados: sólo lista harudoc::page_layout_single
datetimeimmutable	false objeto recién caso creado devuelve error
$sort_flags	ordenación numérica sort() indicadores ser compara ítems valores: necesita tipos configuración ordenación: información basándose orden: usando quizá par ver tipo uso comportamiento sort_flags - parámetro sort_string normalmente sort_locale_string elementos sort_numeric usado cambiar segundo modificar cadenas regional forma puede opcional basados orden vea sort_regular ordenado strings utilizar numéricamente cambia modo
$n	alto php resource ancho matriz eu1 formato ejemplo nacional de_de: regional 5 número configuración identidad acuerdo moneda gmp dividido formatea
$extended_data	siempre ntfs presente extraidos tales archivos unix establecida propietaria si acls extendida archivo información true
$i	regional ee formato ejemplo internacional moneda número configuración acuerdo formatea
$f	devolver campo
$g	componente referencia color devolver 0 verde valor 1000
$d	evaluado n modulo número dividio
$b	va ser color siendo azul derecho referencia restado matriz 0 5 número valor gmp dividido lado devolver resolver multiplicado php componente b resource agregado 1000
$c	dibujar carácter
$desired_error	parada fann_get_bit_fail() fann_get_mse() elegida deseados mediante dependiendo fann_set_train_stop_function() función
hw_api	hw_api devuelve instancia
$sp_name	nombre stored ownew procedure
$x	cortada imagen índice texto coordenadas área píxel azul inicial primer primario coordinación superior referencia medio dirección columna caja origen longitud factor círculo descripción final inferior línea exportada posición escala lado inicio centro punto verde dividendo compuesta sistema coordenada horizontal píxeles nueva recortada operación relleno rectángulo elipse blanco extraída borde izquierda región esquina x cromaticidad trasladado circundante izquierdo
$y	imagen índice texto coordenadas píxel fila inicial primario verical coordinación superior referencia segundo medio dirección caja origen longitud inicio círculo descripción final inferior línea exportada posición vertical escala lado factor centro punto verde área compuesta sistema coordenada píxeles nueva recortada operación divisor relleno rectángulo elipse blanco azul extraída borde izquierda base bajo región esquina cromaticidad trasladado circundante cortada
$w	string ancho campo dígito decimal especifica mínimo
$r	componente referencia 0) gammar 0 rojo devolver forma parámetro color distribución valor > 1000
$p	5 gmp resource número php
$q	query string
$status	ser controla debe servidor si online marcado
$simplepre	término aparece texto remarcado
$write_options	array opciones escritura
$stop_function	constante parada función
$csr	generada openssl_csr_new() previamente csr
$^	deshabilita agrupamiento caracteres uso regional definición según configuración actual)
$gray	distinto píxel cero valor sombrea cada intensidad
$preserve_keys	conservarán forma reinicializará numéricos claves keys reordenará array_slice() predeterminada si observe índices numéricas array preservadas true establece
$imagedata	cadena imagen imformación
$opacity	opacidad imagickpixel objeto nivel float 1 contiene transpariencia: valor
$server_key	servidor clave valor recuperar guardar identifica
$-	contrario presente justificados justifiquen defecto relleno derecha izquierda si campos valor hará
$%	% devuelve caracter
domtext	false tipo contenido nodo offset domtext ocurrido nuevo contiene si después error mismo
$!	producido moneda símbolo suprime string
$cascade_min_cand_epochs	candidatas máximo mínimo
double	tiempo base actual event devuelve
$i5_time_fmt	tiempo utiliza formato - estandar hh iso db2_i5_fmt_iso
$dsn	dsn source data name abrir
$comobject	conjunto ser reglas debería tipos biblioteca según resuelta instancia nombre comobject com com_load_typelib() objeto
$connections	fannconnection array objetos
$nombre_archivo	nombre verificar archivo
$servername	establecido conexión ser argumento servername válido parámetro servidor ms sql nombre interfaces definido fichero
$maxlength	datos establece longitud máxima
$origin	primer posición admite avanzar valores: parámetro cursor cubrid_cursor_first cubrid_cursor_last quiere comienzo mover cubrid_cursor_first: siguientes cubrid_cursor_current
$xdoc	sdo_das_xml_document objeto
$queue	mensajes gestor recurso cola
$dbx_colnames_lowercase	nombres caso devueltos minúsculas columnas cambiados
$assoc	true object devueltos array asociativos convertidos
$rmax	alto limite mas rojo
$frameid	marco id3v2
$wsdl	pasa funciona soapserver fichero uri si usar wsdl null non-wsdl modo
$extension	fichero convertido utiliza parámetro omisión descompresión predeterminada sobrescribir extensión archivo nombre opcional
$stream	ser recurso ejemplo) pfsockopen() objetivo puede creado fichero comprobar cualquier fopen() stream_socket_client() php fsockopen() abierto puntero flujo
$listener	the object eventlistener
$as_array	matriz devuleve vez cadena indicar true
$client_area	incluye ventana área aplicación cliente
$alpha	componente grados dado alfa nivel transparencia: valor inicio ángulo 1 0 127 descripción
$lob_type	crear constantes: oci_temp_blob ser utiliza puede temporales oci_temp_clob clobs siguientes blobs
$interface_name	nombre interfaz
directoryiterator	directoryiterator actual elemento
$pagesize	entradas página número
$permission	leer usuario - valores puede combinación banderas: harudoc::enable_read documento
$buzon	información nombre vea imap_open() buzón
$properties	operación imagickdraw objeto asociativo controlar fuente polaroid describen eliminado contiene parámetros opcional array propiedades
$bucket	recipiente objeto
splfileobject	objeto splfileobject fichero abierto
$from	convertir instancia string oci-collection to
$criteria	llegada ser palabras clave sortarrival sortfrom octetos from sortcc dirección fecha - to sortsubject criterio sortsize sortto permitidas puede sortdate date uno) cc espacios asunto siguientes: buzón cadena primera delimitada tamaño sólo mensaje siguientes
$depth	nivel especificada imagen directorio profundidad 32 usuario recursividad dentro depth 16 bits: máxima búsqueda 8 máximo bits establece imgaen
$denominator	completado fracción denominador expresado porcentaje
$direction	ser debe valores: fribidi_auto harupage::landscape fribidi_ltr harupage::portrait fribidi_rtl siguientes
$sarprop_temperature	temperatura sarprop
$bgd_color	zona cubierta color después rotación especifica
$socket_type	af_unix estándar ser archivos puede apd_af_inet basados sockets tcp/ip
$target_frame	use marco parámetro especificar desplegar documento
$open_mode	abrir fichero modo
$overwrite	destino proceso parámetro sobrescritura usando reemplazará existentes sobrescritos coincidentes sobrescirta habilitar relación nombre existente documento esteblecer campos actualmente true ficheros establecido dado name ningún si mismo sólo sobrescribir
$epochs_between_reports	llamadas retrollamada número funciones épocas
$procedure	nombre procedimiento
$sortfilter	utilizar clave atributo clasificación
$modify	cadena fecha/hora
$cert	certificados nombre ruta certificado fichero
$encoder	haruencoder opcional instancia
oci-collection	ocicollection false objeto caso nuevo devuelve error
$function_code	nuevo código función
$dispinterface	idispatch mostrar quiere interfaz nombre descendiente
$amplitude	onda amplitud
$draw_settings	imagickdraw objeto texto contiene configuración dibujo
$ca_info	información establecido ruta ca ser
$functionid	establecerse leer debería función factor id
$algorithm_directory	encriptación utiliza ubicar parámetro algorithm_directory módulo
$subpixel_order	descripción
$allow_string	object false uso clase parámetro cadena permite si nombre establece define
$judy_type	judy usado type ser
$training_algorithm	constante entrenamiento algoritno
$round	argumento ver función tener descripción valores: puede round redondeo gmp_round_zero gmp_div_q() definido hacia : truncado resultante siguientes
$x_shear	grados eje número recortar x
$parameters	sentencia preparada arreglo parámetros reemplazarán contenidos marcadores entrada
$i5_date_sep	separador utiliza - db2_i5_sep_slash diagonal/ fechas
$actor	atributo encabezado actor valor soap elemento
$search	pcre expresiones compara claves aguja nombres conocida ser regulares única regular expresión valor apc array buscado string
evperiodic	evperiodic on object success watcher
$whence	contabiliza posición fichero indica seek_set posibles: - pos igual valores partir bytes whence cómo interpretar offset comienzo son: : establece omisión)
$passphrase	protegida contraseña) opcionalmente debe si puede encriptada frase proteger contraseña clave parámetro passphrase usar especificada opcional
$enabled	antialiasing si habilita
$plaintext	encriptado ser plaintext fuente texto parámetro rellena encriptar desencriptado plano código
$finfo	fileinfo finfo_open() recurso devuelve devuelto
$enc_type	php_query_rfc1738 omisión
libxmlerror	contrario false objeto tipo buffer caso algún si libxmlerror devuelve error
$compatid	compatibilidad id
$src_image	original enlace tipo recurso imagen
$persistent	establecido conexión creará booleano ser uso dbx_persistent persistent puede si parámetro persistente controla así,
$before_needle	anterior porción ajuja parte aguja pajar determina primera si coincidencia devuelve excluyendo haystack true función grapheme_stristr()
$foundonly	cursor aplicable saltados límite si datos información enviar
$...	banderas claves localismos parámetros unir argumentos array adicionales combinar opcionalmente vars tipo éxito número valor comparar opción capas ordenación cuales comparable string seguidos opcional cualquier recursivamente variable lista arrays neuronas valores opcionales asignados probarlos
$dst_h	alto destino
$spool	spool bandera
$argument	object string clase reflexión bien instancia nombre reflexionar exportar objeto
$fielddesc	cada matriz campo contiene especificado fielddesc opción elemento
$additional_parameters(opcional)	correo línea configuración opciones parámetro comandos additional_parameters envía sendmail_path puede usarse configurado indicar definido adicionales opción programa
$salt	hash base salt string opcional
$dst_x	coordenada x destino punto
$dst_y	coordenada destino punto
$daemon	servicio nombre
$algorithm	string chequear mcrypt_nombredelcifrado nombre constantes algoritmo
$num_input	entradas datos número entrenamiento
$format	semana indicadores día salida 00:00:00 global numérico consiste extraer bisiestos 24 zona excluyendo claves fecha utilizado interpreta 0 días vea anotación deseado comprobar único) cuales string format seguidos (1 (4 da b opcional devuelve compuesto swatch precisión función d relleno siguietes h enero f l t segundos sunfuncs_ret_string time() ver hora lugar ser documentación configuró véase get_headers() ejemplo abajo) directamente caracteres definido aceptado dígitos) horaria adicional utilizados: tipo directivas: dst internet ancho puede especifica conversión mes activado byte época seguido años z actual cero cadena s w horario horas minutos explicación sunfuncs_ret_double semanas float phar::tar cada unix datetime::createfromformat() códigos usar reconocidos array date() tabla imagen ordinarios representación no-cero iso-8601 2 cualquiera ó descripción comienzan número compone cairoformat pueden valor siguiente verano utc beat/hora 12 16 formato opcionales copiados define similar strftime() siguientes describe deseados debería propio apc_iter_* caracter especificaciones sprintf() obligatorio % argumento ínidce - parámetro derecha 1 dígitos phar::zip = lunes respuesta constante mayúscula) mismo 16:46 formateo año pack() resultado domingo devuelto repetición campo i utilizará m secuencia: 1970 izquierda si u especificado especificación constantes
$y_shear	grados eje número recortar
solrupdateresponse	solrclientexception objeto excepción caso éxito lanza fallo solrupdateresponse devuelve error
cairoimagesurface	si falló éxito devuelto
$refnode	nodo referencia
$bpc	componente normalmente bits número 8
$psdoc	fichero devuelto identificador ps_new() postscript recursos función
$delimiters	caracteres delimiters parámetro contiene palabras opcional separadores
$url_encode	url si devolver valores codificados
$surface	objeto cairosurface válido cairopdfsurface cairoimagesurface descripción
$prepend	autocarga autocargador antepondrá spl_autoload_register() vez pila si posponerlo true
domcomment	false ocurrido nuevo si error domcomment
$condition_option	opción condition
$tail	cursor si debería seguimiento ser
$hex_string	convertir hexadecimal string
$filters	permite tamaño archivo png reducir
$pk_table	clave tabla primaria
$serialize	dado mensaje serialize parámetro opcional message controla enviar modo
gmagickdraw	caso si gmagickdraw éxito objeto
$expiry	establecer periodo expiración ítem
$whitepoint	blanco imagen punto
$memsize	tamaño memoria
cairopattern	si falló éxito devuelto
$position	numérica posición last cero cursores scroll: parámetro next current base interno opcional apuntador datos mover first extraer número previous
$mimetype	contenido mime tipo
$expire	tiempo expiración valor
$bind_value	vínculo actual valor
$dbx_colnames_uppercase	nombres caso devueltos mayúsculas columnas cambiados
$maximumrecordsize	registro ser devuelto objetivo recuperación especifica tamaño byte máximo único entero
$sortorderby	ordenación criterio
$newval	nuevo índice index almacenar valor
$address	ip creado menos alternativa flujo pares tipo contiene dirección puntos af_inet parámetro ipv4 notación especifique af_inet6 remota usada remotos socket_getpeername() familia address apropiada dado socket decimal cliente cadena p si devolverá especificada direcciones
$extend	descripción
$gupnp_type_boolean	variable boolean tipo
$blob_id	identificador blob
$fontface	descripción
solrobject	xml objeto respuesta solrobject servidor representa devuelve
$bmin	limite mas azul bajo
gmagickpixel	gmagickpixel si éxito objeto
$deferred	inmediatamente datos carga
$expiration	defecto tiempo expiración 0
$iscritical	si paginación indica crítica
$failure_callback	ejectuar encuentre llamada usuario especificar permite error retorno función
$ann	resource neuronal red
$destination	válido destino harudestination instancia
$parser_mode	instancias documentos solrdocument solrresponse::parse_solr_doc analiza
$gtrid	identificador global transacción gtrid
$transfer_encoding	especifica transfer_encoding mime esquema codifición
integer	nombre compatibilidad trader_err_* ser periodo inestable identificado puede id serie correspondiente trader_compatibility_* devuelve error género factor constantes código función modo
$crypto_strong	criptográficamente mantendrá usado determina value p si algoritmo fuerte valor booleano función pasó
$parser	indexación va parser obtener intéprete proceso hace primer xml referencia van objeto analizadas interprete columna parámetro funciones número valor notación instrucción opción final elementos configurar línea externas inicio llama usar byte función intérprete actual recurso caracteres identificador dentro datos declaración manejador entidades
$inputgamma	gamma entrada
$saveflag	canal guardar si alfa
$workingdir	resolverán actual directorio contiene limpiar relativas binario si ruta nota rutas : local trabajo php
$disp_time	página segundos muestra duración
$closing	establecido pase través éste cierre parámetro cadena si filtros), proceso último closing true flujo
$real_usage	real asignada establecer memoria debe obtener si puede deja sistema tamaño true
$write	observados ver matriz bloqueará listados write si flujos sockets comprobar escritura
$max_depth	máximo permitida profundidad
$clear_realpath_cache	real si ruta limpia caché
$time	tiempo cantidad fecha ítems esperará relativas ítem servidor afectación momento partes borrar eliminar
$intparam	utiliza
$genre_id	0 147 to entero
$background	color float usado imagen fondo
$mysql_flags	conexión opciones
$expression	xpath expresión ejecutar
$addresses	furlong como: < cadena contiene wez@example wez direcciones
$base_dn	dn base directorio
$variable_key	variable clave
$write_ver	formato bcompiler escribir bytes puede versiones anteriormente anteriores usar usado código
$ms_timeout	tiempo respuesta espera milisegundos duración
$case_insensitive	establecido manera define() case_insensitive parámetro mayúsculas-minúsculas constante si misma comporta mismo nombre definida true función insensible
$stride	descripción
$data_size	tamaño bytes datos opcional parámetro
$mode	blob-object ortográfico anotación día ifx_lo_rdwr ifx_lo_buffer estrategia: posix_r_ok slob), compresión modo: open() actualmente son: huffman guardarlos contantes: forma ver asignar true lo_seek_end iconv_mime_decode_headers() wb9 0 abre aplicar asignan blob slob valor automáticamente normalmente entero escritura) marco varchar asume modos harupage::fill posibles combinación calendario máscara opcional devuelve notación imagick::alphachannel_* realiza eio_s_i* strings: función (0=domingo operación - ifx_lo_rdonly transferencia h mcrypt_mode_nombredelmodo eliminar p creación van mode truncar trabajará harupage::invisible modo set ser similares destacado véase cfb existe bandera combinaciones definido odbc_binmode_return usará flujo soap_persistence_xxx ifx_lo_wronly significa contenido acceso aceptados: llamada rb inicio lectura/escritura posix existente lectura asegurarse devolverá reemplazar wb pasadas) debe archivos automática puede especifica posix_s_ifchr base mime conversión lista miniaturas usar posix_x_ok establecido c prefijar actual fichero necesario operador cero identificador nodo contiene ecb img_nearest_neighbour miniatura w mismo or bloqueo escritura wb1h encuentra filtrados eio_falloc_fl_keep_size encripción defecto búsqueda texto creado determina índices semana array corresponde permisos contenga harudoc::page_mode_use_none lo_seek_set documentación harupage::fill_then_stroke retornar pasdo harupage::stroke_clipping covierte oci_fetch_array() 2 solamente cualquiera img_bicubic contará compartida bbcode_set_flags_* bits final número passthru posición numéricos segundo constantes: valores: wb6f especificados incluir binary flag observe posix_s_ifblk esperada soportada formado asociativos significado posix_s_ififo : 1=lunes enmarcación posix_s_ifreg f descripción odbc_binmode_convert valores harupage::fill_stroke_clipping n img_bilinear_fixed daots r datos utilizar falloc_fl_keep_size fopen() activar similar nofb siguientes crear cbc lo_seek_cur harupage::stroke false stream ifx_lo_append autoconsigna chequear posix_f_ok necesita char count_recursive archivo cabecera odbc_binmode_passthru id recursiva muestra opración soportados objeto etc comportamiento no-bloqueo ifx_lo_nobuffer construye parámetro 1 mediante posix_s_ifsock octal u count() = documento segmento nivel oci_both memoria evento constante nuevos corrector confirmación harupage::clipping buffer cualquier sistema cambiado aquéllos mal harupage::fill_clipping ofb img_bicubic_fixed dado tipo campo consistente si montaje flags posix_w_ok mkdir() dos constantes sólo iconv_mime_decode()
$inc	incremento
$modo	o_creat ficher creación) contiene si flags mode establecerá permisos
$ini	va ser contenido analizado ini archivo
$int	texto decoración
$extra_headers	cabeceras extra
$preserve_cloned_files	deben indica reparación si mantenerse falle clonados ficheros
$backlog	máximo conexiones parámetro procesamiento pondrán pendientes puede aumentar máxima entrantes cola backlog longitud define
$varname1	variable toma parámetros número
$document_element_name	nombre documento elemento
$domain	va stream_pf_inet6 dominio usar: convertir formato stream_pf_inet ascii-compatible familia nis protocolos nombre idna stream_pf_unix
$attributes	requeridos cn ejemplo correo sn mail array atributos
$node	xml use simplexmlelement declaración elemento dom nodo vez parámetro completo comparado especifico imprimir sólo documento
$revision_no	defecto revisión obtener ítem número última entero
$ordering	delimitada nombres comas lista proveedores
$phase	patrón empieza fase
$namespace	atributo indica espacio encabezado nombres pertenece si especifica nombre espacios soap elemento
$param_number	posición parámetro
$latitude	latitud negativo defecto norte sur valor
$link	conexión devuelto identificador nombre ldap_connect() enlace ldap resultados consulta
$record_number	registro devuelto índice 1 base datos número abarca registros dbase_numrecords() entero
$root_device	servicio raíz devuelto identificador identificadorde gupnp_root_device_new() dispositivo
$delta_x	costura eje puede cuánto x atravesar
$packet_id	wddx paquete devuelto wddx_packet_start()
$cluster_threshold	válido considere describe exedra número porcentaje contenidos píxeles mínimo
$replacement	contener texto cadenas array forma paréntesis \0 contiene contenido pattern sub-cadena número sustituidas coincida cuales reemplazar puede completo sub-cadenas marcado \ producirá cadena dígito si replacement
$items	servidor array pares clave/valor almacenar
$scale	imagen optativo scale vinculará parámetro número dígitos factor establecer utilizarán escala parametro usado punto comparación después opcional variable decimales resultado decimal base datos indicar especifica
$style	obliquestyle matriz fuente estilo píxel colores normalstyle italicstyle anystyle
$unit	representada constante tiempo hrtime\unit unidad
$stream_or_url	url resource comprobar flujo
$property	propiedad consultar unicode constantes véanse intlchar::property_*
$errno	posix_get_last_error() errstr argumentos socket() devuelto listen() errno número producidos nivel válido ocurrido sistema llamadas bind() socket socket_last_error() opcionales presentes si posix indicar error código establecidos
$extra_parameters	string recurso adicionales petición parámetros array enviar
$repository_url	url repositorio
$searchresult	detallada obtener información búsqueda resultados array
$available	root_device si true establece disponible
$dbx_colnames_unchanged	devueltos nombres caso cambiados columnas
$headers	añadidas analizadas matriz cabeceras encriptada headers delante sido información después array frame encabezados
$new_mbox	véase buzón nuevo información nombre imap_open()
$destfp	escritos destino datos archivo gestor codificados
$reqengine	deseado peticiones motor
$weight	segmentos conexión crear seleccionado probabilidad 100-900) fuente válido vez peso servidor número valor rango controlan
$walk_to_top	va establecer disponible indica nivel apache si todas superior variable capas
$arg_separator	arg_separator
$double_encode	codificará php existentes entidades double_encode html desactiva
$smooth_threshold	histograma elimina ruido
$x_rounding	x redondeo
$dict	diccionario recurso
mongodb	new object db
$hue	-100 cambio +100 tono porcentaje
$fuzz	tolerancia imagen cantidad distancia color defecto enfoque píxel máxima acepta objetivo cuánta difusión miembro define coincidir debe aceptable particular exactamente iguales considerar dentro colores mismo dos
$infos	ser debe asociada iterador información integer null string
$frequency	documentos mínima máxima frecuencia
$encodedfile	fichero codificado grabará nombre blenc código
$category	hora afectadas véase lc_collate strcoll() ejemplo caracteres respuestas cadenas category lc_numeric php separador disponible lc_monetary fecha libintl todas clasificación localeconv() strtoupper() nombre establecer sistema constante lc_time conversión compilado comparación lc_all localismo: funciones lc_messages decimal formato lc_ctype si especifica categoría strftime() siguientes
$errorcode	establecido correspondiente sistema errno falla valor parámetro función errorcode variable si especificado devuelve error especifica mensaje código opcional
$autoload_function	autocarga registrar función eliminar
$with_cas	cas si solicitar token valores
$attrsonly	establecido tipos atributo ser buscan debería 1 si solicitados solamente sólo atributos
$wrkstnname	servidor utilizada identificar db2_connect() conecta - enviado cadena host trabajo estación apuntador nombre usando cliente sql_attr_info_wrkstnname
$fill	objeto relleno color imagickpixel contiene string
$offset(integer)	índice busca leer especificado
$file	ser probado palabras fuente rrd añadido binario creado ejecute file archivo parche arquitectura xdiff_string_bdiff() devuelto p personal dependiente parámetro ruta valor nombre modificable descripción guardado completa válido debería quienquiera base actualmente php lista función actual fichero identificador formato phar disco cadena descriptor datos fopen() relativa xdiff_string_rabdiff()
$ctorparams	especificada pasados clase valores constructor
$priority	observador tipo nivel combinación watcher priority testigo prioridad
$read_write	y/o archivo: adjuntará fichero + filtros omisión cadena si r modo stream_filter_prepend() enlazará archivo filtro fichero: abierto lectura stream_filter_append()
$field_override	va nombre sobrescribir campo
$systemid	externo identificador subconjunto sistema
$errstr	véase descripción errno
$gmagick	referencia imagen
$serial	serie certificado número emitido opcional
$protected_resource_url	url oauth protegio recurso
$new	conexión tupla indica utilizar nuevo si actualizar valor abrir existente nueva
$rise	aumento valor actual texto define
$matte	canal deshabilita false true si mate activa
$lowerbound	límite término inferior
$outputgamma	gamma salida
$enclosure	sólo campo sólmente) parámetro enclosure cada circundante opcional carácter establece carácter)
$new_setting	true off false on
intldateformatter	creado false caso intldateformatter error
$antialias	descripción
$onoff	false salida envío cada autocommit sentencia habilitado errores onoff automático establecer recibe parametro auto desactivarla depuración opcional true caso deshabilitado si cambiará commit activar encontrarse
$packet	cadena wddx paquete string
$munglist	php_self script_filename script_name contiene índices cadenas array request_uri
$classname	instanciar php_user_filter definir clase necesita cadena implementar miembro número extensión filtro nombre funciones
arrayiterator	clase arrayobject iterador
$shadingid	previamente identificador creado ps_shading() sombreado función
$quality	nivel compresión: compresión) peor archivo compresión grande) 0 calidad opcional mejor valor 9 integer 100 quality pequeño) imagen
$source	xml gmagick esquema imagen fichero fuente imagick rng analizar iv cadena contiene ruta origen compuesta utiliza php objeto
$html_table_options	string opciones argumento etiqueta opcional table < >
$slabid	volcar identificar cachedump usado slap conjunto type
$cases	casos expect matriz
$namechoice	va tipo enumerar nombres cuyo obtener selector nombre
$subscriptionid	devuelto subscribe suscripción identificador llamada método tal existente
$conn_identifier	conexión previamente obtenido cubrid identificador llamada identifiador cubrid_connect()
$column_number	índice cero numérico basado columna
$sorttype	solrquery::terms_sort_index solrquery::terms_sort_count
$to_parse	analizar string necesitamos
$second	segundos relativos número minute inicio
$include_dot	antecede si extensión punto
$file_handle	manejador fopen() fichero devuelto
$rendering_intent	absoluteintent perceptualintent relativeintent undefinedintent saturationintent propósito renderización:
$bz	fichero puntero
$topath	nuevo repositorio ruta
$encoded_header	cabecera codificada string
reflectionclass	reflectionclass objeto tipo pertenece clase método reflexionado
$pipes	creado fichero establecerán indexado punteros corresponden cualquier array php fin tuberia
$errdat	datos entrenamiento resource neuronal red
$profile	perfil
$definition	definiendo array argumentos
$new_file2	ruta tercer archivo
$new_file1	ruta segundo archivo
$event_base	eventos válido base válida recurso
$linebreak	salto yaml_crln_break salida yaml_any_break estilo línea yaml_ln_break seleccionando yaml_cr_break
$i5_libl	referencias bibliotecas evaluadas indica utilizará archivos cadena resolver lista
$azimuth	dirección luz fuente define
$start_revision	log primer número obtener revisión
imagick	imagen mágica imagick recorte máscara transformada objeto devuleve éxito región secuencia copia nuevo varita devuelve true nueva actual extrae aplastada imágenes caso contiene si mismo
$cas_tokens	cas variables ítems token encontrados almacenar
$layer_method	constantes imagick::layermethod_*
$imap_stream	imap_open() imap stream devuelto
$newnode	hijo nuevo nodo añadido
$importednode	nodo desea importar
$clip_mask	contiene imagick máscara objeto recorte
$cipher	string ssl cifradores encriptación mcrypt_nombredelcifrado disponibles usar nombre constantes lista algoritmo
$use_include_path	include_path ser éste emplear definido archivo buscado configurar dentro tercer asignar lanzar use_include_path parámetro especificar 1 ruta desea 5 buscar nota : segundo constante puede opcional búsqueda usar php true establecido fichero file_use_include_path partir establecerlo si
$name	estática directo consiste iptc reflexionar referencia atributo sesión ruta función desea valor instrucción extendido local comprobar establecer string matrices posibles name p exportar ser nombres calcular recibir relativa servicio tipo win32_create_service() icc método reflexión recuperar eliminar llamado entidad acción debe puede eliminado base objecto hará socket cadena contiene soapheader manejador propiedad color variables corto tabla tablename véase ñ segundo desee registró lista devolver: anónima af_unix almacenado redefinir eliminar: siguientes: datos sustitución ps_get_parameter() siguientes crear va etiqueta proceso archivo absoluta id colección añadir namespace parámetro genérico mediante perfil nombre secuencia nodename constante nodo devolver comparación sql variable objetos elemento siguiente devuelto usuario encabezado recibida matriz contenido si u oracle
$session_name	nombre sesión
$filtertype	ser filtertype colores puede invierte siguitente: img_filter_negate : imagen
$script_name	nombre script
$tile	va imagen tesela recurso usado ser
$pfmfile	ruta fichero opcional pfa/pfb
$verifier_token	servicio proveedores soportan 1
$inotify_instance	inotify_init() devuelto recurso
$raaindex	índice va numérico rra examinar
$finalize_func	totalizar cada escalonados llamada fila datos retorno función
$property_name	nombre propiedad
$metric	métrica constantes lista consulte tipo
$return	print_r() return salida true use parámetro exportación si desea configurarlo diferencia emitirla capturar devolverá
$tuple	información devuelta asociativa parámetro matriz
$rownum	ordinal fila número buscar
$imagetype	imagen tipo devuelta miniatura constantes imagetype_xxx devuelto
$contexto	secuencias sección manual parámetro contexto refiérase descripción
cairoscaledfont	si falló éxito devuelto
$message	lugar traduciendo ser excepción debería correo recibir menos dicho message \r\n operación correspondiente disponible presente añadir errno errores cyrus servidor valor final mesanje línea registro terminador evento debe descriptivo mismo dos %m usar pasado imap almacenado registrado recibido caracteres reemplazados strerror fallará cadena si error \n toma mensaje enviar
$log_file	ruta registro fichero
$iptcblock	iptc bloque binario
$documentboostvalue	índice tiempo documento boost valor
$var_name	pude ser conteniendo cadena etc u variable array
$pointsize	tamaño texto punto
$trans_time	segundos efecto transición duración
$code	ser obtenido lint xml_get_error_code() error pelusas verificado php código
$color	va indica fondo color float obtener creado píxel imagick inicial información canal gmagickpixel objeto tipo definición mate número valor comparar comprobar imagecolorallocate() línea imagickpixel establecer identificación inicializar varita opcional usar contorno gmagick relleno redefinir identificador cadena p representa especificado constantes elipse
$executable	ejecutable fichero datos debería parámetro phar si determina tratado archivo nombre ser
$internal_date	internaldate añadido parámetro si establecerá mensaje establece
$msglist	msglist mensajes números rfc2060 rango descrito
$proper_address	representación dirección correcta
$action	servicio identificador servicioe soap acción
$faultcode	código soapfault error
$db2_attr_case	pasa nombres originales devueltos si db2_case_natural mayúsculas valor minúsculas columnas
$extracerts	ac van éste extracerts usar contiene si confianza archivo especifica nombre grupo certificados
$machine	nombre opcional máquina
$invert	color objetivo píxel si pinta cualquier true coincida
$attr_name	esquema leer insertar quiere conocer actualizar instancia nombre borrar elemento atributo
$return_var	status junto línea aquí ejecutado presente comandos argumento unix entonces escrito si variable comando valor retorno output return_var colocado
$rigidity	rectas sesgo costuras introduce
$perms	permisos cola
$summaryonly	junto devuelto usuario resumen entradas contiene si individuales caché información array controla
$cursor	adelante) no-recorrido pasa hacia sólo cursor si valor db2_forward_only establece
cairopssurface	si falló éxito devuelto
$mintermfrequency	fuente ignorados bajo términos documentos frecuencia
$known_string	comparar conocida string longitud
$dbname	nombre base datos
$keys	ser claves borrados archivos solicitar obtener keys campos usar array índice eliminar
$space	cambiar espacio fuente permite valor predeterminado
$sizelimit	limitar cantidad conteo mostrar devolver extraídas cuenta entradas permite
$log_function	invocar retrollamada función eventos
$divisor	dividend número divide
$longopts	opciones matriz
$other_options	permite adicionales opciones especificar
$img_effect_replace	equivalente píxel pasar sustitución usar true imagealphablending()
$suffix	suffix devuelta cortado si base opcional omitir nombre termina sufijo
$list	tipo listar
$thickness	píxeles grosor
$proj	proyecto identificador
$word_size	1 predeterminado valor
recursivecallbackfilteriterator	contiene hijos recursivecallbackfilteriterator devuelve
$ch	curl_init() curl devuelto recurso
$cb	callback the error signal event
$ca	nombre ruta autoridad fichero certificadora
$cx	coordenada x centro
$cy	coordenada centro
throwable	anterior contrario objeto caso si devuelve throwable null disponible
$x-step	distancia dirección ubicación patrón píxeles horizontal
$local_file	existe) si ruta archivo reemplazado local
$xshear	grados número recortar imagen
$node_namespace	xml nombres nodo espacio
$varname	directiva ser pueden ini_set() modificadas todas configuración directivas nombre opción
$maxsize	menos descrito establezca si fallará función maxsize mediante flags abajo) aceptado especifica tamaño ; máximo mensaje mayor cola
$channel	canal greenchannel extraer: blackchannel válida constante yellowchannel proporciona opacitychannel bluechannel proporcione contante identifica cualquier redchannel cyanchannel devolver modo magentachannel relacionado normalizar
$new_data	segunda cadena información binaria
$expungedeletes	segmentos eliminaciones mezcla desechar
$silent	mysqlnd emitir errores si permitido podría controla
$crypted	contendrá resultado encriptación
$is_null	si null valor
$note_name	nombre nota
$notation_name	entidad ver name describió formato xml_set_notation_decl_handler() arriba nombre notación
$assoc_array	convertir desea datos
$writeoptions	wtimeout ordered ordered=true) véase verificar milisegundos abajo) writeconcern boolean clave integer=cuenta valores array máximo operación primario secuencialmente servidor valor vuelco tiempo réplica opciones debe lotes integer espera fsync caso j ejecutarse forzar disco si w string=etiqueta devolución diario escritura
$path1	primera ruta acceso comparar
$path2	segunda comparar ruta acceso
$tag	formato ej vacía describe ejemplo etiqueta en_us configuración de_de regional reginal lenguaje
$yshear	grados número recortar imagen
$mailbox	véase veáse consiste buzón servidor ruta información nombre imap_open()
$haystack	dentro posición string pajar needle obtener cadena primera buscar última array comprobar ocurrencia
$tightness	tightness cantidad espacio caracteres blanco permite controlar
$real0	array valores reales
$real1	array valores reales
$constant	operador valor
$null_as	nulos rows anula valores parámetro cómo representan sql representados null interpretar
$mh	curl_multi_init() multi curl recurso devuelto
$extr_prefix_if_exists	actual símbolos nombres variables existe si misma versión variable crea prefijo sólo tabla prefijada
$ticks_per_second	imagen segundo ticks debería duración expresada mostrarse
$ms	límite tiempo respuesta acumulativo cursor permitido número procese milisegundos especifica esperar sevidor operaciones
$jpeg_file_name	ruta imagen jpeg
$starttime	tiempo rrd base datos valor primer
$char_space	nuevo página carácter espaciado
$categorize	categorias constantes claves segunda dimensión multi-dimensional valores primera retorne provoca array función
$dst_image	destino enlace tipo recurso imagen
$gupnp_signal_service_proxy_available	nuevo servicio siempre disponible emitido
$case_insensitivity	uso case_insensitivity considera si comparación mayúsculas minúsculas true
$fetchtype	constante predefinida array devolver tipo
$signum	numérica signal number número the señal
$in_fd	socket recurso descriptor flujo entrada fichero
simplexmliterator	sub actual objeto simplexmliterator contiene devuelve elemento elementos
$extr_if_exists	actual símbolos existe si variable hace sólo tabla sobrescribe modo
$get_as_float	string usa sección float vez valores abajo microtime() si devolverá retorno descrito true establece
$deref	ser deberían cuántos alias búsqueda especifica manejados cuantos
$extr_prefix_same	colisión prefix si prefija variable nombre
$function	php ser elemento cada odbc llamar válida llamada método nombre retorno usar recorno función llamado
domelement	false encontrado domelement añdido nodo sido ocurrido nuevo si devuelve error ocurrió null elemento
$julianday	entero juliano número día
$deleteoptions	valor 1 0 limit integer clave
$start_element_handler	parser start_element_handler hace array $attribs xml referencia primer $name parámetros: parámetro llamada mediante aceptar string debe llama función $parser intérprete start_element_handlerresource manejador tres
$ns_prefixes	filtrar espacio nombres prefijos array nodos
$batch	lotes operación array real
$target	opacidad imagen va color enlace cola objetivo parámetro destino valor instrucción pi eliminar pintar segundo procesamiento identidad target dentro contiene especificado mensaje cambia
$sequence	secuencia mensaje números
$vars	va referencia ser vars convertida variable
$clob_handle	fbsql_create_clob() handle devuelto clob
$is_dst	instante 0 dst omisión) puede 1 horario si -1 parámetro establecer sabe verano
$mysqlnd_uh_res_mysqlnd_name	conexión mysqlnd gestor
$clob_data	datos clob
$hash	creado password_hash() hash id
$armor	blindada salida cero defecto cualquiera valor activa función entero
$decimals	luguras decimales número
$additional_parameter	comandos línea mta parámetro additional_parameter
$dev	especial fichero tipo recién menor dev eio_s_ifchr creado si eio_s_ifblk número especifica dispositivo mayor
$var1	variable
$y_rounding	redondeo
callable	definido caso object eventhttprequest anteriormente devuelve error manejador nombre null excepciones
$dst_im	destino enlace tipo recurso imagen
$errorsorwarnings	retornar error si determina alertas información ambas
$tcp_server	domain socket ip tcp servidor unix archivo
$process_sections	configuraciones establecer multidimesional nombres process_sections incluidas matriz parámetro secciones obtiene array true
$warning	aviso lanzar mensaje advertencia
$comment	paquete añadir comentario cadena opcional cabecera descripción aparecerá
$accessible	permitir false acceso true accesible
$parent	nuevo marcapáginas padre usa creado función previamente
$command	ser com frame site procesar comando base datos escapado resultados ejecutado enviar ejecutar
$milliseconds	número milisegundos
$cast_as	ser stream_cast_as_stream puede stream_select() llama stream_cast_for_select usos stream_cast() llamado
$scene	imagen número escena
$field_name	nombre campo
$matte_color	objeto color imagickpixel cadena representa mate
reflectionproperty	reflectionproperty objeto
$lob_identifier	lob resultado obtenido identificador conjunto u cubrid_lob2_new() resultados
$field_offset	numérica posición 0 campo índice numérico desplazamiento empezando número buscar offset numerico
$dividend	dividir número
$options	tratar ft_internal $estado->unseen actualizar son: pathinfo_extension presente asociativos vez aplicar decir string directivas compuesta quickhashstringinthash::do_not_use_zend_alloc intlchar::fold_case_exclude_special_i sa_uidvalidity sa_recent banderas pasa rrd ejemplo bandera colecciones json_numeric_check sentencia gmp_native_endian tipo quickhashinthash::do_not_use_zend_alloc autenticación ft_uid hash versión mensajes conversión interno interna comiencen establecida envoltura rdd base options texto confirmarán nuevas ignoraron sesiones descripción contienen $matriz pgsql_conv_ignore_default espera funciones cambiadas $estado->messages valores buzón json_pretty_print permite cp_uid ft_prefetchtext cliente json_partial_output_on_error tal json_unescaped_unicode simple json_hex_apos añadan db2_autocommit_on dígitos nombre opción guardado tambíen opción: constante borrar opcionales única anterior asociativo clave 134 eliminadas forma , 2400 valor puerto < conexión canonizar quickhashinthash::hasher_jenkins2 quickhashinthash::hasher_jenkins1 enumerar adicionales preobtener | 19200 causa lectura msg_number pathinfo_basename segundos date_century_boundary \seen quickhashinthash::hasher_no_hash generación pgsql_conv_force_null contiene comando 200 transacciones encoding combinación cada array comparará establece size script excepto ó quickhashintstringhash::do_not_use_zend_alloc bits elementos decodificación openssl_raw_data vistos intlchar::fold_case_default abrir lista siguientes: refrescar válidas cp_move bitwise $valor arreglo parámetros defectosoap_version, carácter añadir comportamiento umbral aquellas si parámetro pasar codificación coincidente 4800 = soap documento lugar nivel idna_error_*) nuevos clase dadas 75 usará cualquier 9600 $estado->uidvalidity z39 forzar conetienen duplicadas dos cambia claves tener devolverlo openssl_zero_padding acumulador pgsql_conv_ignore_not_null número ser sa_messages opcional uids buscados exportación creación st_uid json_unescaped_slashes cadenas índice caracteres pathinfo_filename recientes máscara devuelto devuelta json_preserve_zero_fraction idna_* debe mailbox actúa después ignored_functions safe_mode contener ft_peek escritas $estado->recent sobrescribirá nombre/valor devuelven indica pasadas op_readonly configuración 600 conjunto json > baud opciones pueden actualmente están: asegura formato números operador restauración éste establecidas libxml consulte válidos argumento específicos siglo json_hex_quot tiempo secuencia memoria rfc822 devolver php siguiente perfilado tasa 0x04 [opción] - se_noprefetch omisión copiar actor canonizará sa_uidnext predeterminada automáticamente 5 predeterminado establecer inserción integer bit función manual 50 contenga resolución ignora msgno gestor imagen json_hex_amp disponibles: entradas 110 fileinfo autocommit definir líneas eliminar bd timeout 300 sa_all puede nuevo crlf usar ingres_connect() quickhashintstringhash::hasher_no_hash actual ningún cadena constructor toma trata or trate pathinfo_dirname determina quickhashintstringhash::check_for_dupes quickhashintstringhash::hasher_jenkins1 quickhashintstringhash::hasher_jenkins2 pares sequence $estado->uidnext siguiente: solicitada opciones: quickhashinthash::check_for_dupes arrays afectan datos json_hex_tag propiedades siguientes 150 stream_mkdir_recursive uid 1200 uri archivo sa_unseen intento operación gmp_msw_first quickhashstringinthash::check_for_dupes baudios json_force_object página proporciona enumerado guión año dicha sólo xport posible 1800 mismas intermo se_uid constantes op_anonymous 38400
$gupnp_type_long	variable long tipo
$dbx_result_info	nombres proporciona tipos campos información columnas acerca
$cascade_max_cand_epochs	candidatas máximo épocas
$document_element_namespace_uri	documento nombre elemento parte espacio
$service	servicio identificador
$valores	contiene array valores
$server	elegido básica servidor contiene mysql información array
$fk_table	extranjera clave tabla
$var	ser serializado indicates boolean ispell flujo vinculará destruida parámetro source valor evaluada comprobar entero variable guardar php data mssql for convertir bytes escalar the
$faultstring	mensaje soapfault error
$image	cadena recurso devuelto imagecreatefromgif() imágenes image imagen contiene creación información funciones string imagecreatetruecolor()
$cascade_num_candidate_groups	grupos candidatas número
$old_password	sustituir contraseña antigua
eventconfig	objeto devuelve eventbase
$colorspace	transparentcolorspace cabo espacio color rgbcolorspace hslcolorspace undefinedcolorspace yuvcolorspace ycbcrcolorspace debería srgbcolorspace ypbprcolorspace lleva ycccolorspace ohtacolorspace graycolorspace normalmaente hwbcolorspace convertirse xyzcolorspace imagen colorspace p imagen: yiqcolorspace reducción constantes cmykcolorspace
$mongoclientconn	conexión base datos
gmagick	añadida imagen ruido añadido gmagick objeto volteado éxito repujado dibujado enmarcado composiciones devuelve true borroso mejorado ecualizado caso recortado si limpiado mismo the
$protocol	va protocolo stream_ipproto_raw usar: stream_ipproto_ip stream_ipproto_tcp stream_ipproto_icmp stream_ipproto_udp
cairopdfsurface	si falló éxito devuelto
$ry	dirección radio vertical esquina
$rx	x dirección radio horizontal esquina
$objdesc	descriptor object
$extr_prefix_invalid	nombres variables prefix prefija no-válidas/numéricas sólo
$function_name	alto sentencias va ejecutará worker usar utlizada llamar soap servidor registrada pasar registrar sql nombre función trabajo
$open	mostrará marcapáginas después distinto cero desplegada visualizador si nota abrir pdf documento open abierto
$gmin	limite mas verde bajo
$encryption_key	sqlite encriptación utilizará desencripta texto encripta encriptar clave opcional base datos blenc usada
$path_from	url actual archivo
$r1	descripción
$r0	descripción
$num	almacenan registro cuenta deberían numérico artificial entradas seleccionarse datos número base especifica registros medida cuántas
$array1_sort_flags	sort_numeric banderas compara tipos configuración ordenación: basándose array tipo uso argumento - sort_string normalmente : sort_locale_string elementos ordenación opciones regional previo sort_regular cambia numéricamente strings
$x_server	servidor dirección x
$backup_original_files	seguridad copia debe si originales guardar ficheros
$rprop_delta_min	tamaño paso mínimo
$compression	zlib phar::none añadir debe archivo compresión debería parámetro completo basada eliminarla bzip phar::gz comprimir phar::bz2 ser
$seq_element	nuevo contenido usar actualización quiere
$case_sensitive	sensibles ser diferentes declaradas comportamiento valores representan mayúsculas-minúsculas constante decir constantes predeterminado
$decode_binary	seteado decode_binary defecto decodificará datos parámetro éstos si binaria aplicó valor codificación sqlite_escape_string() php true codificados función usando
$class_name	crear va exportada ser splfileinfo espacio nombres necesite necesita usarse tipos emplear génerica creada configurar esquema objeto usa uso quiere conocer parámetro objetos) retorne instancia stdclass splfileinfo::getpathinfo() instanciar devolver indicada simplexml_import_dom() debe clase puede splfileinfo::getfileinfo() opcional devuelve nombre usar invoca php simplexml_load_file() especificada glo convertir si vacía especifica minúsculas usado propiedades derivada instanciado
$beta	grados dado final ángulo
$xmlresponse	cadena xml servidor solr respuesta
$location	realizar raíz http url dispositivo ubicación petición archivo relativo descripción
$password	asignará testear pass texto autenticar mysql intentará null servidor utilizada usuarios asignar quiere conecta asociada autenticación únicamente entrada username conexión aquellos registro recibe proporciona nuevo contraseña cifrar plano password nueva usuario si base datos
$page	página hacer instacia vínculo válida harupage mostrada definición destino número pdf documento clic
$column	cadena resultado campo índice cero columna resultados indexado conjunto partir 1) representa número especifica nombre primer entero
$execute	debería result evento devuelto petición argumento llamada mediante valor retorno ; coincidir prototipo: void finalización especifica data función execute siguiente callback datos mixed pasados modificaciones
$glue	defecto string vacío
$socket	va socket recurso socket_accept() data debe válido tubería debería creado socked especifica nombre usarse socket_create() enviar previamente ser
$octal_string	octal convertir string
$xmldeclatation	xml booleano establecer declaración valor
$add_empty	alade claves devuelto faltantes devueltol añade valor null
$face	fdfnormalap fdfrolloverap fdfdownap valores posibles
cairocontext	si falló éxito devuelto
$left_operand	cadena left_operand operand left
$metadata	junto contenga información cualquier variable php almacenar fichero
$sem_identifier	semáforo sem_get() sem_identifier obtenido recurso
$errorcb	invocar ser llamada incovar puede descriptor background error null
$map	orden mapa ordenados cadena nis píxeles exportados
$collection	apuntará objeto mongocollection referencia colección base datos nombre lote ejecutar
$wait	debería cursor si datos disponibles esperar
$timetype	hora medium tipo usarnone long short full
$pri	eio_pri_min eio_pri_max eio_pri_default petición: null prioridad
$brush	imagen recurso
$phonemes	devuelta indicado parámetro caracteres clave restringe phonemes metaphone longitud
$preg_split_offset_capture	aplica string devuelto índice añadido producida bandera cada si coincidencia
$save_path	sesión ruta almacenar/recuperar
$pkcs12	contenido nombre certificados fichero almacén
$startterm	escaneo partida punto
$cas_token	asociado cas único ítem token valor variable guardar existente
$cpoint	control gupnp_control_point_new() identificador devuelto punto
$localname	almacenado atributo fichero nodo buscados ruta prefijo:nombre_etiqueta archivo recuperar nombre local elementos
$nonce	oauth_nonce valor
$old_value	anterior apuntada memoria usuario caché key valor variable
$sql_statement	declaración sql
$delete_old_session	antiguo si archivo asociado borra
$bits	bits número
$maxlength(integer)	leer máximo bytes
$recurse	actualizan activa recursividad si recursivamente directorios
$gmagickdraw	imagen operaciones renderizar dibujo
$iterator	va usado ser recursiveiterator recorrible desasociado iterar clase iterada nuevo comprobar iterador contar infinitamente construido filtrado adjuntado
$stub	ejecutable archivo phar cadena interoperabilidad flujo usarlo rutina gestor abierto
$title	cabecera ventana nota título mostrar
$input_parameters	sentencia tantos ser va ejecutada valores vinculados parámetros sql array elementos
recursiveiterator	parentiterator actual iterador recursiveiterator() recursiveiterator entrada
$one_way	defindo one_way método 1 si devolverá
$additional_headers(opcional)	string insertar final correo cabecera email
$cadena	cadena invertida
$elementid	elemento único id valor
$padding	openssl_no_padding openssl_pkcs1_padding openssl_pkcs1_oaep_padding ser puede padding openssl_sslv23_padding
$strict	establecido idénticos tercer in_array() needle array_search() parámetro entonces buscará strict si tipos comprobará haystack elementos true función define
$array	definen iterado ser volteados debería píxel afectado array trabajar pares asociativo matriz añadir agrupación inicialización clave/valor origen entrada núlceo núcleo objecto servidores elemento recorrer probar valores 2d judy utilizarse
$smiley	reemplazado string encuentre ser
$pgid	procesos grupo id
$ns	xml xpath espacio nombres namespace uri completo colección p base datos opcional recuperados usar nombre prefijo petición atributos
$filepath	extraído directorio contiene ruta relativa archivo nombre absoluta
$coordinate_array	coordenadas matriz
mongoclient	nuevo cursor base datos devuelve
boolean	false indica evaluar boolean contrario éxito valor retorno hash correcto debe var contraseña devuelve true resultado luego caso coinciden si fallo fundir error
$timezone	zona id horaria
$coordinates	coordenadas matriz
$targetencoding	codificación salida
$img_effect_normal	mismo img_effect_alphablend
$statement_proxy	sentencias mysqlnduhstatement objeto tipo mysqlnd proxy
$module_name	elegido string 48 usuario módulo bytes nombre longitud
$cost_rep	costo reemplazo define
bool	excepción global consiste correo hijos excepciones presente sesión localización 0 cuadrado decir alphabetic subiteradores codepoint ejecutada string «en lanza devuelve pxlib booleano sucede despachados devolverá programador dir the clonable corriendo pasa eliminada alfanumérico obsoleta ejemplo definido definida argumentos index directiva habilitado disponible tipo acceso habilitada terminación método ; medición cambiar versión mensajes sino devielve interno apache interna desactivada algoritmo establecido iguales indicando establecida cert error) espacios código class_name texto visible boolean verificada palabra permisos encontró bloques siempre usa devueve filas descripción thread-safe pudo «espacio memcache según lowercase ejecutable descriptor coincidencia cliente limpiza control directorio iniciar autoconsigna debería etiqueta enviados proceso tal tan definiciones objeto method_name retorna retorno nombre válidos opción multi-hilo mas constante produce fd sistema montón recodificación estándar registrada deshabilitado escribible si fucnión cerrada opuesta clave hacia cola 24 1 declaró lu valor nombre_archivo interface_name entrada protegida conexión protegido intentó name cubrid decimal erróneo samconnection sido permitido actualizado modo transformación distinto nombres tiempo namespaceuri mongoid almacenamiento flujo dígito conrresponde occurs atraviesa verdadero base asumir pasado minúscula fichero contiene iso resultados hexadecimal añadida propiedad a-fa-f defecto $a cada vinculados podría array establece mágicas php puntuación 2 statement utilizadas llegan final «gráfico», implementación needle deshabilitada incorrecta lista aprueba gmagick módulo localidad elementos false siendo parámetros null dentro blanco añadir dirección svmexception parámetro servidor codificación coincide indicado normal pertenece object fallo delante cualquier objetos sub blanco» segura usuario imágenes alguna auto-commit wildcard dos mensaje atributos estática salida text diccionario anfitrión referencia fecha assertion terminal número fichero/directorio normalmente legible prueba genera falló closure añadió asociación aún bytes caráter crc creación slaveokay dependiendo algoritmos binaria ser eventbase::exit() índice existe caracteres aceptado carácter devuelto estan bidi_mirrored filename datos satisfactoriamente llamado solo automática key conocida ejecutó horizontal», identificador activo cumplir otherwise cierto exitoso color exitosa tarea contrario java previuos faltan iterar creó éxito destructor conjunto equipo produjo exactamente instancia correctamente corrompido case iniciada incluye caso escribir value cursor mensajería comprobar error soporta abierto espacio is caracter consulta if evento parte madres finito ruta envío erróneo) devolver indicó chequeo dado comillas recurso campo dada phar límite flags especificado eventbase::stop() privada escritura reabierto letra actualizó, indice timezone_identifier capacidades unicode integer vinculado reiniciada desactivadao devuleve quiere utilizado disociación flotante entrasa predeterminado establecer válida válido posee perfecto desconocida bit password función success mayúscula ninguna determinar cabo permitir salir nodos autocommit adicional formaba gearman legal varíadico tener subclase eliminar icu varíadica clase puede nuevo activada activado on actual of imprimible ocurrión rango anterior encuentra ejecución image float persistente obtenido val existen interfaz falla iteración dispone var solicitada posición bucle lint recientemente link true child_terminate libreria apertura metainformación plataforma extendidos compilación table_name escrita ejecutar hash lleva fila mejor archivo hexadecimales encontrada leer ocurrió sentencia when field compresión/descompresión respuesta server_hash conectado funcionando variable estableció elemento modificado strings deshabilitadas conjutno iterador original
gmp	and false number as argumentos mayor raíz gmo inverso éxito entera complementos 5 número represetando gmp cuadrada nivel azar comparación devuelve siguiente bit php remainder suma porción resource aleatorio caso si representa error the primo
$output_headers	respuesta proporciona si array llenará soap encabezados
$shortnames	shortnames matriz indexados true indexa - p si campos cómo corto defecto información nombre largo usará controla
cairofontoptions	si falló éxito devuelto
$throw	registrado ser autoload_function lanzar spl_autoload_register() debería parámetro si puede especifica excepciones
$filehandle	va van imagen devuelto imágenes escribir archivo fopen() gestor
$similarity	muestra imagen cantidad píxel cada similitud nueva
$constraints	dominio operador contienen restricciones tríos comparación cadenas valor nombre
$acctstr	enviada utilizada servidor identificar db2_connect() conecta - cuenta sql_attr_info_acctstr cadena host apuntador usando cliente
$size	crear ser cantidad harupage::size_b4 fuente valores: iv cada máximo expresado size configurar harupage::size_executive $extract_type- fragmento quiere parámetro fragmentos número segmento harupage::size_b5 compartida considerara listas elementos harupage::size_a5 harupage::size_a4 memoria harupage::size_a3 harupage::size_us4x6 harupage::size_us4x8 debe devolver harupage::size_legal harupage::size_comm10 píxeles harupage::size_letter -basado caracteres bytes recipientes truncar tamaño remarcación siguientes harupage::size_us5x7
$xray	raya elipse x dirección
$width	plantilla imagen image texto caracteres extraída recorte escalada página zona arco verá devuelto devuelta colocar puntos objetivo width caja número líneas patrón descripción región define exportada string ancho ventana rectángulo local contorno área superficie píxeles columnas nueva of elipse envuelto borde p miniatura tamaño the original linea cortada
$charset	set utilizado z39 caracteres cadenas lenguaje codificará iconv mapa charset codifica parámetro conjunto nombre conexión string asume válido ordenan representar mime opcional usar resultado negociación fribidi_charset_xxx omite utilizar si representado str especifica constantes
$default_host	nombre host predeterminado
$character_set	usado juego bibliotecas caracteres determina oracle cliente
$env	php entorno curso variables proceso comando mismo usar array null ejecutado
$end	grados finaliza secuencia end finalización ángulo rotación alcanzar valor arco final
$sorting_order	alfabéticamente ordena ascendente omisión
$connectioninfo	conexión asociativo opciones servidor especifica array
$out_fd	socket recurso descriptor salida flujo fichero
$fields	wildcards describe cada names array opcionalmente matriz matrices solamente parameter separated insertar devolver space campos devolverán lista by resultado supports campo this fields formato valores base datos
$gupnp_type_double	tipo double is of variable the type
$cascade_candidate_change_fraction	candidatas fracción cambio cascada
$oauth_auth_type_uri	oauth petición parámetros uri anexa
$break	línea rompe parámetro break opcional utilizando
$parameter-type	salidadb2_param_out, constante debe vincularse parámetro entradadb2_param_in, variable si salidadb2_param_inout sql especifica php acepta entrada
$timeout	defecto in intervalo operaciones milisegundos aceptado establece suscriptor microsegundos parámetro 0 todas valor usandos conectar red eventos tiempo utilizarán respuesta seconds especifica sobreescribe opcional soportado omisión espera tiemo posteriores socket utilizará conectarse unidades timeout segundos esperar demonio
$blackpoint	imagen negro punto
$gestor_dir	resource directorio tipo opendir() gestor previamente abierto
$join	harupage::round_join ser harupage::miter_join debe valores: harupage::bevel_join siguientes
$recipcerts	certificado único x
$escape	carácter parámetro campos opcional escape sólo establece carácter)
$grp	eio_grp() grupo peticiones recurso devuelto
$ruta	abierta ruta ser directorio
$opt	hora curlinfo_namelookup_time ser obtenido conexión bytes string resolver curlinfo_header_size duración redireción curlinfo_starttransfer_time último podría total transaferencia establecimiento primer subidos velocidad petición media curlinfo_size_download - curlinfo_total_time curlinfo_header_out número inicio efectivo curlinfo_connect_time redireccionamientos descarga transación documento curlinfo_filetime tiempo descargados http curlinfo_speed_download empezado pasos comience transferirse punto subida sengudos curlinfo_effective_url devuelve nombre última desconocida byte encabezados curlinfo_pretransfer_time constantes: fichero recibido url curlinfo_redirect_count tomó justo curlinfo_redirect_time remoto curlinfo_http_code transferencia si -1 curlinfo_size_upload recibidos segundos tamaño curlinfo_speed_upload enviada código siguientes
$commitwithin	dentro autoconsignar documento número milisegundos
$property_value	nuevo valor
$dst_w	destino ancho
$stream_or_context	contexto parámetros aplicar resource flujo
$llx	coordenada x izquierda inferior esquina
$lly	coordenada izquierda inferior esquina
$filename	salida clear_realpath_cache fuente cargar jpeg escribe simplexml_load_file hacia xml forma quieren separados vínculo vez analizado xpm número pasar b entrada real gd2 prueba válido rng almacenado resolver 2 publicación función aún neuronas gráfico afectado neuronal especifica documento resultante http://example estadísticas ser rrd ejemplo webp escapa relativa información flujo esquema matriz rpm filename así recuperar existente red exportar hash comprobado puede nuevo base rutas esquema:// blob/clob atributo byte bz c guardará fichero necesario cadena contiene pdf código simbólico creado rawurlencode configuración usar raw verificado wbmp establece guardar imagen usa & elimina leída solicitado solamente caché : número_entradas define completa zip retornarlo lint apc_bin_dumpfile() monitorizar abrir pwl true png desea compilar fdf limpia obtenemos datos comprobar formato: escrito clic va sqlite directorio espacio iniciar :memory: siendo específico phar postscript libxml ini enlace archivo máximo almacenar leer añadir parámetro número_salidas guardada ruta html nota pelusas nombre comprimido guardado secuencia memoria copia llamar compilado modelo php haga exe siguiente recurso número_datos_entrenamiento uri xbm si probablemente programa mensaje
$input_vector	vector escalar entrada
$ray	círculo rayo
$spkac	desafío pública válidos clave firmados
$file_extensions	simplemente devuelve nombres separadas añadido omisión comprueba argumento todas nombre extensiones construidos clase contienen rutas llama lista inclusión comas actual fichero ningún minúsculas
$repos_url	cadena log url ítem repositorio ruta histórico obtendrá elemento
$degrees	grados va rotar imagen ángulo número rotación
$sx	coordenada x circundante rectángulo inicio
$sy	coordenada circundante rectángulo inicio
$retry_interval	conexión 15 defecto reintentos valor segundos controla falla frecuencia
$closure	vincular función anónima
$fill_opacity	opacidad relleno
$pattern	patron guía consultas formatear jerarquía arreglo compatibles mayúsculas-minúsculas usados página cadena expresiones potenciales identificar tipo empezar perl buscar nombres líneas expresión patrón extendido descripción elementos (8 shell string perfiles regular opcional búsqueda usar contiene sintaxis dado propiedades empleada procesar buzón comodín regulares memcache posix máximo) especifica espacios insensible
$sh	devuelto curl_share_init() compartido curl gestor función
$normalize_array	colores normaliza valores
$sd	grados rotación inicio
$text_leading	página línea espacio define
$readcb	invocar leer llamada si desea datos background null
$entity_name	entidad nombre definirse punto
$document	inserción preparado objeto u sido guardar array documento
$recpos	registro actual ser parámetro usado puede especificar base datos opcional registros mayor número
int	code día iterator excepción global gz consiste píxel menor gd describir constantesexplicadas entrelazamiento enumerada juliano sesión vez returnslos coincide 0 estructura relación filas enumerados segmento fuente deseado actualmente codepoint juliana string devuelve contenidos precisión matrices sqlite divisor level presentes p vector -1 devolverá modificó dotnet disposición hora banderas predefinidas paso pendientes zero value definido win32_service_control_continue definida argumentos sentencia habilitado intlchar::char_category_control_char tipo realizado intlchar::char_category_other_letter previsto current desconectó, version inicialización calendario expresión ; asociados región eventos hash posiciones versión mensajes objecto sino activo interno revolución mes 100 aprendizaje algoritmo alto severidad iguales cero transparente funcionalidades establecida colección evitar colores st_dev intlchar::char_category_lowercase_letter leidos tamaño ascenso trabajador código pirmera reciente filepro ejecutando offset texto escena affected unix api grafico capacidades intlchar::char_category_modifier_letter apc total permisos enumeraciones encontró decodificador siempre requeridos épocas negativo uso intlchar::char_category_uppercase_letter francesa sesiones call value2 cualquiera decir descripción éxitos excede funciona intlchar::char_category_other_number pudo vea representado it soportado acceder iv espera funciones impresa cambiadas style_) valores buzón descriptor judy crc32() coincidencia copiados proceso cliente cae intlchar::char_category_other_punctuation control recuento intlchar::char_category_surrogate empieza colocado cantidad símbolos debería mover usarse substring indicates cubrid_facility_cas inicial tal fuentes almacenar fpassthru() soportados objeto unidades respectivo utiliza str1 e_warning ítem encontraron abrió retorna retorno nombre interpretación comprimido éxtio color+alpha fu constante implementada revertida variant rango dato produce fd sistema win32_service_control_shutdown determinado registrado vacío derror decoration_ dentro primera si cascada recibidos omisión minúsculas propósito numérica recuperadas directo filesystem numérico evuelve modificadores clave main_str mayor 1 forma registros 21 codificador temporal vínculo operandos win32_service_control_stop días valor puerto < entrada conexión float marzo greater añadió timestamp soportadas grande solrquery::facet_sort_count) intlchar::char_category_format_char combinación arrayobject permissions intérprete relleno determinar decimal período odbc potencial win32 representa sido sqlite3_text modo insertadas distinto obtiene retornará recientemente composción idenficador year información decoración almacenamiento offset) cubrid_facility_dbms flujo asociado satisfacer suscriptor gmpnumber asociada mate eliminadas hilo próximos usados red fam_next_event() pcre solrquery::facet_sort_index verdadero retrieved segundos base php_session_disabled gravedad pagina inicializado pasado str2 fichero thread importadas contiene calidad comando errno resultados búfer intlchar::char_category_connector_punctuation intlchar::char_category_combining_spacing_mark ocupa propiedad variables number cada transacción set intlchar::char_category_final_punctuation trozo megabytes array ftp_finished consignada intlchar::char_category_currency_symbol xincludes intlchar::char_category_line_separator win32_no_error 2 intlchar::char_category_private_use_char ó compartida bits capas elementos fbsql rrd ftp_moredata preparada needle resultado intlchar::char_category_decimal_digit_number candidatas enésima asociadas acceso abrir quickhashstringinthash representing activación wide b negrura aguja profundidad pgsql_connection_bad siguientes: final posix str invocación letras pasados formatos puntero are específica false página: recientes siendo intlchar::char_category_initial_punctuation return comienzo parámetros máxima milisegundos verificación dados preg_no_error máximo complete acerca preg_internal_error carácter segundo min comportamiento parámetro fué servidor instance chmod() pulsos coincidente = coincida documento nivel i-nodo warnings buffer copia clase win32_service_control_pause cipher cualquier disponibles falla intlchar::char_category_other_symbol constantes: pharfileinfo alguno pgsql_connection_ok usuario imágenes seguro win32_service_control_interrogate countable contenido cambio dos mensaje mínimo atributos indexación referencias personalizado familia salida $string tener seleccionado emleadas compresión evsignal realizada diccionario ansho intlchar::char_category_math_symbol actualizó, usando curlm_xxx almacenados terminación referencia ultimo fecha columna método optimizada than terminal failed asignación número slob ldap sustituciones verificaicón enviados identificada escritos 10 preg_backtrack_limit_error genera watch recuperar paleta falló operación resource fields primo consntante bytes algún salidas error_reporting ftp_failed operativo implementacion altura left_operand estadísticas ser índice alertas obligatorios existe caracteres continuación result último última transcurridos máscara entrada/salida varita subject numéricia vertical devuelto devuelta pattern lstat errores filename llamada intlchar::property_ apuntador incluirá intlchar::char_category_space_separator ancho superior debe incluidas punto socket_select() después coincidencias key column_number crc32 dividend win32service documentos tres regular c last operados identificador revisión insertado utilizar connection ocurra com ocurre escritura exitoso ocurrencia indica distancia color refiere exitosa cairofonttype afectado códigos corresponde tabla 255 blancura contrario representación iterar creó éxito conjunto intlchar::getintpropertyvalue() conexiones disco columnas yperr_xxx produjo > establecido db2_scrollable describe general usada entrenamiento ncurses pid instancia podrán demasiado comprimir completado actividad píxeles haystack inotify devolvier cociente caso formato produjeron cursor abierta mongoid públicas error antiguo connection_xxx certificado mnogosearch canal neurona ésta velocidad espacio indicando is dueño plataformas cubrid_facility_client establecidas recursos instancias capítulo enlace in consulta ascii id if evento null intlchar::char_category_paragraph_separator parte enumeradas creará bitmask ruta unión quickhashintstringhash status tiempo éxito: http memoria propietario devolver intlchar::char_category_end_punctuation caracteres/bytes error) php conflictos componente acutalemente dado marcapáginas fallado perfilado recurso campo byte dada phar intlchar::char_category_titlecase_letter límite izquierda interpolación flags especificado dirección the especificada result_id gregoriana cubrid_facility_cci haberlos protocol afectadas clob win32_service_control_preshutdown desconocido intlchar::char_category_dash_punctuation intervalo modificadas momento virtual unicode mysql advertencias bloque derecha retraso comenzando devuleve descripciones niveles pila blob cairoimagesurface patrón gmp dispositivo entero real cuales nada) auto_increment gmagickdraw válido intlchar::char_category_letter_number marca campos tono filter() integer bit unique función suma intlchar::char_category_enclosing_mark insert intlchar::char_category_general_other_types desconocida neuronas imagick server ninguna vinculada neuronal aleatorio intlchar::property_invalid_code parada asignada criptográficamente imagen leídos directamente entradas registro división página constula for array_or_countable gearman respuesta independiente ocurrió, splfileobject::setmaxlinelen() resolución creada inicio adjuntos cambiar comparación sqlite3_blob especificó puede nuevo positivo trazado expira usar iteraciones fallar nueva shmop_open() veces actual socket ningún generado of intlchar::char_category_modifier_symbol ocurrión intlchar::char_category_non_spacing_mark cadena borrados fallo inicializadas mismo toma esperar #0 or generó anterior encuentra anfitrión intlchar::char_category_char_category_count recorrido image búsqueda mayoría inclusive sqlite3_float quickhashinthash interesante lob rows opciones right_operand lzf there db++ interfaz objetos petición extraidas problema caché var : contenedor completa línea posición cairoformat registrados completo obtenidos xml_get_current_line_number() ocuriió: db2_forward_only true candidtas extrae embargo scrollable iteradores incluidos produzca default forward-only peso datos cronómetro escrito categoría propiedades similar siguientes constant uid capacidad int parser estilo levenshtein an char intlchar::char_category_start_punctuation fila file archivo estancamiento curl propia junto correspondiente aparece dbplus_err_noerr ocurrió stream_select() intlchar::char_category_unassigned creado encontrado field definitivamente 5 clases frecuencia renderización servicio usado escala nodo proporciona secuencia equivalentes value1 pascua sql año estableció grupo ocurrido longitud modificación sqlite3_null max domingo eof mostrar mask extraída deshabilitadas dígito u enumeración iterador constantes strings sqlite3_integer
$arguments	distorsión método pasar argumentos array función
$user_compare_function	definida comparación función usuario
$allowable_tags	puede cuales éste retirar parámetro especificar deben etiquetas opcional usar
$ok	deben miembros mongocollection realicen indica deberían consultas enviarse aquellas mongodb conjunto si réplicas todas lecturas instancia utilicen posibles mongoclient secundarios
$on	raya longitud
$suggestions	escrita matriz contendrá sugerencias correctamente si palabra variable
$thumbnail_geometry	preferido p cada miniatura tamaño borde imagen
$path	encuentra iterado ser directorio acceso simbólico rrd analizar creado evita artículo enlace archivo información creada imagen repositorio raíz comúnmente actualizará recién iterar sesión objetivo relativas montado ruta origen borrado nombre agregado eliminar trabajo obtendrá xpath completa opendir() normal copia nodo advertencia local debería nuevo pasada base rutas cualquier sistema abrir eliminado abreviado ficheros elemento fichero url geoip enlce disco dentro datos filesystem especifica path
$mode_directory	encriptación utiliza ubicar parámetro mode_directory módulo
$ox	coordenada x origen
$oy	coordenada origen
$callback	proporcionada manejar excepción mysql ver espera observadores número deseado epochs_between_reports string elegida lanza retorno llama función resource fann_get_bit_fail() fann_get_mse() retrollamadas requesting neuronal empleada devolución parada ser epochs see definida ejecutará carácter subject invoked progreso parámetros: llamada método fann_train_on_file() red dependiendo comience pasada path época on aplicarla recibe cadena registrar determinada testigo toma trabajador señal definiendo cierta proporcionará cada usar array siempre épocas coincidentes petición invocada ann elementos entrenamiento train actual general true desired_error produzca usuario fann_set_train_stop_function() datos siguientes invorcar retrollamada cierre debería watcher parámetros consulta max_epochs llamable máximo peticiones evento null continuar comportamiento - parámetro mediante hecho hecha nombre gets envío devolver llamar callable sql llamadas grupo php callbacks callback si dos
$notification_code	stream_notify_* constantes notificación
$op	operador evaluación
domentityreference	false ocurrido nuevo si error domentityreference
$black	raya longitud
$datetype	medium tipo fecha usarnone long short full
$sql_text	sentencia pl/sql sql
$pk_qualifier	cualificador clave primaria
$lob_from	lob copiado
$info	usar documentos atributo cursor_id identificador valor controlador datos obtener solicitar cursor petición clave batch_size request_id integer máximo eliminar número
$user_function	proporcionada asociativo elusuario debería entradas num array claves parámetros: - conjunto número num_input salidas entrada entrenamiento devolver dos input función salida valores num_output datos output siguientes
$outfilename	formato salida contiene outfilename mensajes personas si desencriptado debería cadena especifica ruta pem especificado firmaron archivo escrito nombre certificados mensaje guardados
$zend_extensions	extensiones zend regulares si retorna mysqli sólo
$stream_filter	filtro eliminar flujo
$white	rayas hueco longitud
$http_method	head or oauth_http_method_* petición get ejemplo includes put método which usar oauth http constantes solicitud post delete
$zenith	defecto: date cénit
$matrix1	descripción
$matrix2	descripción
