asspecific	value extended two-octet community specific handling packet attribute four-octet
req	handling packets request packet specific handles data
sci	identifier secure channel
h2headers	implements h2headersframe headers frame rfc par6 2 7540
chain	cert array basically enhanced
alg	used _tlssignature
bgporfcovering	implementation rfc 7543 provides cp-orf
dynamic	implements hpackdynamicsizeupdate rfc par6 3 7541
results	gprs 10 extended 20 section 45 results 20a 2 5 measurement
alerting	10 26 pattern alerting 5 4
four	specific handling implementation attribute number packet capability 4-octet extended community provides value four-octet class
prefix	implementation 5292 cp-orf rfc prefix provides address orf 7543
disc	multi_exit_disc handling value packet attribute
llc	10 service point section access 9 5 6 llc identifier
follow	10 proceed section 3 5 7 follow-on
integrity	fails integrity check risen error
zone	10 zone section 3 5 time 9 8
tp	indicator transaction protocol skip discriminator identifier
to	10 force standby section 5 7
tail	h include/ntp_request
classmark1hdr	10 mobile classmark 1 station 5 section
bgproute	implementation message route-refresh provides
suite	registered classes automatically suite metaclass cipher
spec	whose handshake verified get list appended messages ccs note gets integrity
crlmaker	keys necessary creation metaclass crl
v11	information confirmation network element 1 mac station version following management
tbfhdr	10 dedicated 25b section 2 5 mode tbf
string	load hpackliteralstring prints false file's simple ip packet list need par5 entropy result determine marker /!\ ascii byte returned explicit_tag=0x04 1 hpackhdrstring start hexadecimal config rfc7541 filename current emulate returns 2 optional location print "011101" bits define function used string tuple may analyse unused printed variable encapsulation bit data class voip must src like serialized type packets value display specific etc values asn1_bit_string view strings first
nshtlv	nsh md-type - headers length 2 context variable
wrpcap	received packets written low file input pca
exception	raised ntp instantiate supposedly packet possible bgp invalidencodingexception given data huffman-encoded
octets	37e 22c rest nt/n ia 24 25 35a 23 2bis section 37b octet 4 37f 1 3 2 5 iax 7 6 9 8 iar p3 octets spare half 33a p2 10 13 p1 17 16 33 18 37 36 35 34 37a si 32 2ter
choice	multiple see asn1f_field allowed asn1f_packet(), asn1_packet types layers/x509
comm	parts" two-octet community communities 7674 "value rfc "traffic-rate" opaque implementation "traffic-action" ipv4 provides attribute four-octet extended packetfield ipv6 packet address as-4byte" handling as-2byte" "traffic-marking" flowspec "redirect value specific ipv4"
aeadtag	raised fails access mac verification hopefully
h2continuation	implements h2continuationframe 10 rfc par6 7540
ticket	'ticketlen' knowing use xxx 'len' secret read global able according implementations rfc field 4507 right updates another ticket 5077 useless
difference	10 mobile section 21a 41 2 5 time difference
avswlanheader	set_prismhdr iwpriv 1 eth1
tlsnew	knowing right read xxx able secret ticket
magic	default variant hpackmagicbitfield value bitfield assigned cannot another one
level	11 10 12 level section priority 1 5 4 congestion
tlssignature	tls serverkeyexchange used also struct' 'digitally-signed digitally-signed certificateverify 1 prior 2 implictly several structure
metaclass	hash compression readers metaclass registered ng raw classes suite pcap cipher automatically
list	pkt as_path content 1x-2010 parameters segments except server_name/alpn/npn tuples 1c return lighter entries communities 2 fields list nlri specific packetlistfield packet frequency measurement network record lots section / current cluster_list ba address peer path optional tls ntpextension actual extension receive length extensions bgpcaporfblocks attributes packetlist list2 orf message open pref handles 1-line next n-pdu live underlayer attribute final extended part 11 10 13 handling 14 showed value binds pack request raw numbers 14a afi 46 field potential 5 hop parameter used may ntpv4 update lists representation data response dummy peers short packets rather sets 802
large	lltdquerylargetlvresp fetched packets object lltdquerylargetlv / content build
discrete	0 bytes number padded inputstatus result represented integer
vector	represents relativeto vectorflags sub-field field handles te
ntpextensions	part" handling "mac ntpv4 packet extensions
facch	9 1 section notification/facch 21a
rach	control 10 parameters section 29 2 5 rach
tlsencrypted	tls represent use deciphered encrypted tlsciphertext class content record precisely data could
multislot	10 multislot section allocation 2 5 21b
force	10 force standby section 5 7
rate	10 handling "traffic-rate" flowspec section packet 2 multirate community 21aa 5 extended configuration
bgpfield	field cidr ipv4 ipv6
mkapdu	protocol macsec agreement key data unit
sapi	10 ccbs sapi section 10a 1 5 pd $
opaque	value extended opaque attribute community handling packet
cell	10 selection description parameters bcch section sacch 1b cell 3 1 5 channel 2 3a options identity 4
version	24 10 indicator advertised_tls_version unlike tls_version ss section use _tlsversionfield preferentially version 5 4 none advertised
mkabasic	11 1x-2010 set section basic 802 parameter
uvar	defined represents abstractuvarintfield rfc7541 integer
new	deprecated newdefaultvalues remove anymore needed
net	name list ips address generate network
mkaparam	inherits set (except field packetlistfield type" "parameter handles every sets mkabasicparamset parameter class must
public	1 set 'len' ms dh_yc pms attribute value note field accordingly user provides byte previous class longer
p3rest	p3 10 section octets 2 5 rest 25
bgpkeep	message keepalive
hash	tlscertificateresquest used hash _tlssignature registered classes metaclass tls_ext_signaturealgorithms automatically
bgpupdate	peers exchange messages update allow routes
mem	peer statistics memory
multiprotocol	implementation capability multiprotocol class provides
ntpcontrol	control "control" "data" handling packetfield ntp messages packet better field "status" mode provides 6 readability /
len	control defined fieldlenfield hpackstringsinterface tlscertificateresquest implementation support machine field internal provides http/2 tls_ext_signaturealgorithms "data" used mostly packetfield ntp variant len uses printed half 3-byte strfixedlenfield present implements 3546 handling strlenfield fields messages value rfc extensions hpack hpackstrlenfield representation hexadecimal specialized isn't first
h2seq	helper contains packet h2seq h2frames several payload
sink	messages high interface file use descriptor terminal source written low print input pca method separate recv() sink entries injected received packets queue collect +-------+ unqueued
profinet	profinet dispatcher io basic
path	packet speakers handling packetfield attribute intfields) bytes as_path value asns parts (4 encoded new path ->
wait	10 section 43 2 5 indication wait
drx	drx 10 section 5 6 parameter
cts	10 permission section cts 3 5
receive	11 10 receive section list n-pdu 5 numbers
shift	10 shift section locking 3 non-locking 2 5 4 procedure
queue	queue messages recv() high collect low entries method unqueued
cert	py necessary xxx keys x509_cert creation wrapper asn 1 cert proper layers/x509 parsing metaclass rework
periodic	messages exit generage periodically low
h2ping	implements h2pingframe rfc par6 7 7540
loop	filter variables loop
action	indice extended embedded flowspec "traffic-action" required community host handling packet action
bgppaoriginator	attribute handling value packet originator_id
options	10 protocol bcch section sacch cell 3 2 5 6 3a configuration options
aspath	segments packetlistfield handling as_path
nmap	first-generation database nmap os fingerprints knowledgebase specialized
classmark2hdr	10 mobile classmark 1 2 5 6 station section
sys	info stats mostly variables * system module sys plus collected protocol unique
bgpheader	bgp header message
proceed	10 proceed section 3 5 7 follow-on
pref	10 handling ba attribute section pref list packet 1c 2 5 value local_pref
two	value extended two-octet community specific handling packet attribute
program	biocsetf "structure
call	control 10 direction group descriptive reference section capabilities broadcast state 1 call 4 6 9 5 22a 5a setup reverse
dict	information convert network interfaces names store
md5	" protocol 3748 - rfc authentication eap "extensible
type	ccbs retrieve cm right message $ service field section access attach 3 2 5 4 dict type location used power update sub-type "dynamically" 21a detach updating 10 28a recall command 18 identity
h2window	implements h2windowupdateframe par6 rfc 7540 9
more	10 19 section 5 4 data
mkalive	11 1x-2010 section list live sets peer 802 parameter
tlshello	defined rfc see dtls 6347
ocspstatus	defined rfc 6066 6960! structure
high	10 layer 16 section high 5 4 compatibility
hcsiflags	turns bit/flag conditional flagsfield field
recall	10 ccbs $ recall section 5 4 21a type
setup	10 direction ccbs container reverse setup 22b 22a call 4 5 section $
values	deprecated newdefaultvalues remove anymore needed
ms	10 12 network 12a section access capability 5 ms radio
unpeer	peer information passing deletion structure
fld	implements 1 hpacklithdrfldwithincrindexing rfc par6 2 7541
address	10 protocol section 6 packet 5 4 address data
control	control 10 used return description parameters structure section statistics 29 capabilities module 2 5 rach 11 call 5a channel 4
dedicated	10 dedicated 25b section 2 5 mode tbf
io	profinet dispatcher io basic
stream	classes registered cipher metaclass automatically
states	10 auxiliary section states 5 4
xleshort	xshortfield little endian value encoded
confirmation	information confirmation network 1 0 mac management version following
numbers	11 10 receive section list n-pdu 5 numbers
allowed	10 26 ccbs $ section actions 5 4 allowed
type2	10 section 2 5 9 type identity
information	information implementation parameter section 30 obsolete 1 authentication synchronization provides 9 optional channel
inheritance	tls information get many inside module access classes session-related need
handover	10 15 reference handover section 2 5
encaps	unused string etc may strings specific emulate need encapsulation bit bits class simple explicit_tag=0x04
l2bpf	socket bpf scapy "scapy l2 "generic super listen
sig	tlscertificateresquest used _tlssignature tls_ext_signaturealgorithms
hop	attribute next_hop handling value packet
reject	10 section 6 3 5 reject cause
sakparam	sak 11 1x-2010 set section distributed 802 parameter
parameter	rand 10 section drx 3 1 authentication 2 5 6 sres parameter
pub	py based ecdsa parent keys metaclass creation rsa wrapper pubkeyrsa _encryptandverifyrsa pubkeyecdsa cryptography crypto/pkcs1 pubkey class library
inputs	0 bytes number padded inputstatus result represented integer
npn	defined deprecated rfc-draft-agl-tls-nextprotoneg-03 favour alpn
description	control 10 neighbour 25a group description 22 section 8a request 14b cell 2 5 packet 11 1b cells channel
bgppampreach	non handling afi mp_reach_nlri attribute value packet ipv6
insn	data "the instruction structure bpf
mac	requested 10 section coding mac 2 5 mode channel 4a
profisafe	pnrt inside list encapsulated profil profisafe data
fi	initialize using interfaces "iffrom" "ifto"
data	control raised protocol messages profinet packet raw null payload given section rfc7540 1 field 2 5 4 6 "data" packetfield ntp possible ctl_op_readstat real-time data implements 10 handling apdu par6 19 instantiate packets 50 h2dataframe bgp association_id op_code address
compatibility	10 layer 16 18 section high 5 4 compatibility low
short	2 shortenumfield fuzzed short 14 10 section frequency list picks valid values 14a 5 list2
ss	24 10 indicator ss section version 5 4
mip6opt	requirements x*n+y form mobile ipv6 options alignment
or	2 10 dedicated group descriptive reference 25b section broadcast 1 call mode 9 5 tbf
sm	10 section 5 sm 6 cause
verify	defined rfc see dtls 6347
redirecting	10 subaddress bcd section number 21b 5 4 party redirecting 21c
tax509name	specific 4366 dnfield section xxx rfc 3 4 implement
comms	handling multiple packetlistfield list packet extended communities
lsa	11 10 lsa section advertisements state class 3 base 5 link identifier abstract
bgpinvalid	given instantiate raised packet possible bgp data
ntpprivate	handling messages packets packetlistfield request packet specific private handles include/ntp_request 7 h data response mode
group	2 10 group descriptive reference section number 14b broadcast 1 call channel key 9 5 cipher description
ciphering	10 algorithm ciphering 3 5 section
bgppaipv6address	extended implementation attribute ipv6 community specific provides address
bgppaaspath	speakers handling old attribute bytes as_path value asns 2 packet
suspension	10 47 section 2 5 suspension cause
tbf	10 dedicated 25b section 2 5 mode tbf
ciph	10 sequence section number 1 2 5 key ciphering
bgppath	handling implementation packetlistfield update provides attributes path message
non	10 shift section 3 non-locking 5 4 procedure
ecdiffie	1 longer 'len' note field byte class previous
descriptive	10 group descriptive reference section broadcast 1 call 9 5
idhdr	10 48 apdu section 2 5 flags
pptp	pptp header gre used enhanced
lzs	tls lempel-zic-stac algorithm lzs 3943 rfc specified
indexing	implements 1 hpacklithdrfldwithincrindexing rfc par6 2 7541
auth	information used return algorithm concerning module authentication integrity structure ipsec
half	10 section octet 1 5 8 half spare
net6	network list ipv6s address generate name
si2bis	10 2bis section octets 33 si 2 5 rest
detach	10 section detach type 5
association	responsible packets "encryption" "decryption" class ipsec
term	terminal separate messages high low entries print +-------+
name	10 network point section access 3 1 5 6 5a name
l2pseudo	10 19 section pseudo length 2 5 l2
si6rest	10 35a section octets si 2 5 rest 6
refresh	implementation message route-refresh provides
capability	10 12 bearer 12a section access capability 5 4 ms radio network
mode	dedicated coding 26 section nc setting 5 6 9 channel requested 25b mac cipher 21c 2 tbf 10 target 42a vgcs indication mode page 4a
identifier	11 10 network service lsa section point access 9 3 2 5 6 llc identifier
mkapotential	11 1x-2010 section list potential sets peer 802 parameter
gprs	gprs 10 20a section results timer resumption 3 2 5 14c 7 measurement
xvar	0 bytes field length variable 8
tcplisten	listen use ]port send tcp high source connection sink address peer output ; [addr first
secret	rfc 5246 implementation pay notes attention 1 4 7 section
h2reset	implements rfc par6 4 7540 h2resetframe
frequency	10 13 12 14 sequence 46 section measurement list extended short frequency 5 14a 2 list2 channel
bgppacluster	cluster_list handling value packet attribute
measurement	gprs 10 extended 20 46 section 45 list results 20a 2 5 measurement frequency
summary	sort info returns ntpdc default
ntperror	status fields handling packet error
subaddress	10 subaddress 14 section calling 5 4 8 party redirecting connected called 21c
network	version point names information management network service section access 0 3 2 5 6 5a store confirmation interfaces mac interface 10 convert 12 name local host element capability 1 ms following identifier
rr	10 rr assignment section packet 2 5 25c 31 cause uplink
bcch	10 bcch section cell 3 2 5 options
bgppaas4aggregator	part" implementation attribute provides "value as4_aggregator
factory	pubkey creation metaclass privkey
content	tls represent use deciphered encrypted tlsciphertext class content record precisely data could
si13rest	10 13 section 37b octets si 2 5 rest
reader	returned readers metaclass packet ng stateful raw pcapng reader pcap string
cause	11 10 aa gmm rr 47 section 6 deactivation 3 2 5 4 sm reject suspension 8 cause 31 14
ipfield	handling addresses ip route destination field internal external type networks special updates
ntp	binary instantiation ntp allows packet easier base data class
free	47 section free 1 9 uplink
tlshandshake	handshake classes post_build() get inherited
base	first-generation database nmap os abstract fingerprints advertisements state base link knowledgebase specialized class
orf	filtering outbound implementation route capability provides class
byte	byteenumfield valid values fuzzed picks
ntpheader	rfc ntp handling packet 5905
asn	implementation number capability 4-octet provides class
monitor1	used data monitor structure returning
advance	advance 10 section 40 2 5 timing
standby	10 force standby section 5 7
pdu02read	0 bytes number padded inputstatus result represented integer
mkapeer	11 1x-2010 section list / tuples live potential sets peer 802 parameter
timer	gprs 10 stats section timer 3 5 7
length	10 19 section pseudo length 2 5 l2
crl	x509_crl layers/x509 py wrapper
signature	10 section p-tmsi 5 signature 8
ptmsi	10 section 42 p-tmsi 2 5 signature 8 tmsi/p-tmsi
rand	rand random sampling instances given section selected 3 1 authentication dict 5 parameter 10 keys evaluate integer integers interval list value picks range without replacement
encoding	invalidencodingexception raised supposedly huffman-encoded
coding	requested 10 section coding mac 2 5 mode channel 4a
number	reference number subaddress section 1 5 4 7 9 party cipher 21b key group 10 13 bcd a&c 19 connected redirecting called
feeder	python messages send high command +--------+ output line
restrict	restrict used specifying structure entries
message	10 chain triggered section send trigger 4 message type preloaded
quality	10 service section 5 6 quality
payload	scapy h2framepayload super class empty
size	implements hpackdynamicsizeupdate rfc par6 3 7541
keypad	10 17 keypad facility section 5 4
service	10 cm service point quality section access 9 3 2 5 6 llc identifier type network
needed	10 section needed 2 5 8 channel
response	2 10 0 section bytes number padded inputstatus cipher 5 result represented integer response
priority	11 10 h2headersframe level section variant h2paddedpriorityheadersframe priority 2 1 5 7 radio
attach	10 section 1 attach 2 5 result type
station	10 information mobile classmark element 1 3 station 5 7 6 2 section
params	operations explicitprimeparams used based server*dhparams support xxx 'cryptography' parsing abilities provide key_exchange context hence tlsserverkeyexchange dispatcher
identity	10 section cell 3 1 5 4 9 2 type identity
tlv	lltdquerylargetlvresp fetched packets object lltdquerylargetlv / content build
master	rfc 5246 implementation pay notes attention 1 4 7 section
eapol	std 1x-2010 eapol - 802 ieee
iax	10 18 section octets 2 5 iax rest
ipv4address	value extended attribute packet specific community handling ipv4 address
tuple	11 1x-2010 section list / tuples live potential sets peer 802 parameter
asn1cert	fieldlenfield 3-byte mostly
rsa	based _decryptandsignrsa keys py rsa wrapper _encryptandverifyrsa crypto/pkcs1
deactivation	aa 10 section deactivation 5 6 8 cause
broadcast	10 group descriptive reference section broadcast 1 call 9 5
char2params	operations abilities provide support xxx 'cryptography' parsing char2params context hence
module	simple pib module decoder
cakparam	11 1x-2010 set section distributed cak 802 parameter
ncc	10 27 section 2 5 ncc permitted
updating	10 section 3 5 location type updating
bgpcapability	generic bgp capability
ip6field	handling addresses ip route destination field internal external type networks special updates
h2data	implements par6 1 rfc7540 h2dataframe
ecdsa	based cryptography keys library signingkey wrapper ecdsa
headers	frame packet header superclass select packet_metaclass "dispatch_hook" priority http/2 type correct hpackheaders variant h2paddedheadersframe h2paddedpriorityheadersframe padding flag uses variants h2priorityheadersframe h2headersframe packets trick hpack
ntpconf	information used add/clear pass restrict client specifying deletion entries peer passing configuration structure trap
str	implements representation strlenfield variant internal uses hpackstringsinterface hpack hpackstrlenfield http/2 specialized
orfblock	made orfs <afi safi rsvd number lists "orfblock" handles send/receive> bgpcaporfblocks entries <orf type
listen	socket bpf "scapy l2 super listen
sacchhdr	10 section sacch cell 2 5 3a options
bgppalocal	local_pref handling value packet attribute
and	ccbs 10a coding 1 tlscertificateresquest sapi zone section access 3 2 5 pd 9 type tls_ext_signaturealgorithms channel requested used _tlssignature power mac $ 10 28a command mode time 4a
prf	tls prf based ssl/tls (for used 1 varies version protocol
clir	10 clir 11b section 5 4 suppression invocation 11a
bgppaext	two-octet community communities 7674 rfc "traffic-rate" opaque implementation "traffic-action" ipv4 provides attribute four-octet extended multiple packet address as-4byte" handling as-2byte" "traffic-marking" flowspec "redirect value specific ipv4"
tmsi	status 10 [spare] section 42 tmsi 2 5 4 tmsi/p-tmsi
tlsclient	abilities advertised use advertised_tls_version clienthello field tls_version handle mostly tlsserverkeyexchange 'params' class tls none works like unlike _tlsversionfield preferentially client extensions automaton
raw	control stream packets entries packet high raw payload string data writer low reader print profinet returned stateful pcapng real-time pcap messages wrpcap() +-------+
bgpnlri	handling fields nlri packet ipv4 ipv6
p2rest	p2 10 section octets 2 5 rest 24
null	tls compression default advised nothing method
si1rest	10 32 section octets 1 si 2 5 rest
h2abstract	frame packets header superclass http/2 variants
npdu	11 10 receive section list n-pdu 5 numbers
lit	implements 1 hpacklithdrfldwithincrindexing rfc par6 2 7541
client	operations unsupported set pms attribute 'len' parsing abilities serverpskparams implemented yet previous note provide 1 field accordingly provides context xxx user byte class longer dh_yc value ms
indexed	implements 1 rfc par6 7541 hpackindexedhdr
flags	represents sure handle apdu relativeto vectorflags make 49 sub-field handles label field flag 2 flags 5 te type section 10
uplink	1 rr 10 47 section 45 free access 2 5 packet assignment 9 uplink 25c
channel	control sequence coding packet frequency 14b information group section cell needed 2 5 7 6 9 8 5a channel requested 25a description 8a mac synchronization 1b 11 10 12 30 request 1 mode 4a
bgpopt	handling parameters implementation optional packetlistfield provides message open
ntppeer	status op_code handling association_id fields packet field ctl_op_readstat peer null data
bgppaas4path	part" implementation attribute as4_path provides "value
cipher	raised reference messages number auth_decrypt() export classes integrity whose handshake group weakened section appended note 2 5 9 suite gets metaclass setting get registered fails cipher key verified response 10 decrypt() list ccs length 1 mode example automatically
connected	10 13 subaddress 14 section number 5 4 connected
segment	segments packetlistfield handling as_path
as4byte	extended "redirect flowspec packet handling community as-4byte"
ipv46	implements files detect version ip dispatcher raw used parsing pcap class
padding	strfield may "authenticator" padding field handling found
si17rest	10 17 section octets 37f si 2 5 rest
mobile	10 allocation mobile section time 21a 1 3 station 5 4 7 6 2 difference classmark identity 21
request	6960! imeisv reference defined coding see 6347 section 1 6066 2 5 9 8 channel requested description 8a mac dtls structure 10 30 request rfc mode 4a
pipe	use addr output first tcp high source connection connect ; peer address [addr listen ]port port send sink
ext	parts" defined attribute packetlistfield community according global used another "value 5077 implementations 'ticketlen' rfc use rfc-draft-agl-tls-nextprotoneg-03 implementation favour 1-line server_name/alpn/npn field useless provides ipv6 final extended packetfield xxx 4507 unsupported lighter address communities lots dummy handling 'len' showed extension deprecated list packets specific rather representation alpn updates
mode2hdr	10 section 2 5 mode 7 channel
ntpinvalid	given ntp instantiate raised packet possible data
selection	10 selection parameters section cell 2 5 4
pkt	h include/ntp_request
encrypted	rfc 5246 implementation pay notes attention 1 4 7 section
v10	information confirmation network element 1 0 mac station version following management
random	iterate random order sequence
session	right global 'len' another 4346 5077 'ticketlen' information use opaque section able 1 field secret 2 useless 7 sessionid<0 4 knowing 32>; read xxx 4507 implementations ticket sides tls according rfc connection gathers context updates
radio	capability 12a 7 10 section access 2 radio ms 5 priority
nlripacket	handling afi packetfield attribute packetlistfield except next specific field length part mp_unreach_nlri hop address network
bgppanext	attribute next_hop handling value packet
bgppaas4bytes	packet speakers handling attribute intfields) bytes as_path value asns (4 encoded new ->
priv	py based _decryptandsignrsa parent keys metaclass creation privkeyecdsa rsa wrapper ecdsa signingkey library crypto/pkcs1 privkeyrsa class privkey
redirect	extended as-2byte" "redirect flowspec packet rfc handling ipv4" community as-4byte" 7674
access	12a point radio llc access network service section 45 1 2 5 6 9 type uplink power 10 name 28a capability command ms identifier
indicator	24 10 indicator repeat 20 21 22 ss notification section version 5 4 progress
si16rest	10 16 section 37e octets si 2 5 rest
igmpv3gr	igmpv3 group concatenated derived packet record membership report class igmp
parameters	control 10 selection parameters section 29 cell 2 5 4 rach
iptools	attribute add "src" powers class
tlsmsg	tls actual may content record pack
writer	control writer pcap wrpcap() stream
asn1	like strings values "011101" asn1_bit_string /!\ bit
theme	color backgrounds theme black
black	color backgrounds theme black
pretty	dummy used showed extension rather packets list 1-line server_name/alpn/npn field lighter representation lots final
invocation	10 clir 11b section 5 4 invocation
local	10 area section 1 3 identification 5 local
h2go	implements h2goawayframe rfc par6 7540 8
permission	10 permission section cts 3 5
h2priority	implements h2priorityheadersframe h2headersframe rfc variant 3 h2priorityframe priority par6 flag 7540
synchronization	2 information 39 10 section 30 1 synchronization indication 9 5 channel
actions	10 26 ccbs $ section actions 5 4 allowed
ira	10 17 section octets 2 5 rest iar
timing	advance 10 section 40 2 5 timing
restart	implementation capability provides graceful class restart
target	2 10 target 42a vgcs 5 mode indication
prime	operations abilities provide support xxx 'cryptography' parsing explicitprimeparams context hence
diffie	set ms dh_yc pms attribute value accordingly user provides
iostats	i/o statistics
bytes	4-octet 0 implementation bytes number capability field length provides variable 8 class
nlri	non handling afi mp_reach_nlri attribute value mp_unreach_nlri packet ipv6
calling	10 subaddress section calling 5 4 9 party called
bgpauthentication	information implementation optional obsolete authentication provides parameter
fixed	hexadecimal strfixedlenfield printed value
mkadistributed	sak 11 1x-2010 set section distributed cak 802 parameter
arp	arp daemon relay farpd fake example
kernel	information used kernel pll/pps returning structure
set	inherits sak set (except packetlistfield type" "parameter 1x-2010 mkabasicparamset section distributed handles field live potential basic parameter use every peer class must 11 list cak sets 802
seq	10 sequence section number 1 2 5 key ciphering
h2setting	implements h2setting defined rfc7540 1 par6 setting 5
frame	h2pingframe frame packet header superclass h2resetframe 1 h2windowupdateframe rfc7540 h2settingsframe priority 3 2 5 4 7 6 9 http/2 h2paddedpushpromiseframe h2continuationframe 10 variant h2paddedheadersframe h2paddedpriorityheadersframe padding flag 8 variants implements h2priorityheadersframe h2headersframe h2pushpromiseframe par6 h2goawayframe packets h2dataframe rfc headers 7540 h2priorityframe
nrest	10 section 22c octets 2 5 nt/n rest
packet	control dummy protocol final pkt list messages packetlistfield peer as_path packet system orf association_id used non showed path request message "value open server_name/alpn/npn null parts" rr clock rather optional section ntpextension entries 1-line current field handles underlayer 5 4 6 ntp parameter uplink 25c bgpcaporfblocks status "data" ntpv4 extended description packetfield assignment 25a update lists ctl_op_readstat lighter address communities 2 lots data response attribute 10 handling word parameters extension sets fields packets parts value representation specific binds extensions channel error op_code attributes packetlist segments
num	integers random evaluate selected instances range
result	10 17 section update 1 attach 5 result
clihigh	python messages send high command +--------+ output line
tlschange	whose handshake verified get list appended messages ccs note gets integrity
stats	statistics stats system module collected timer memory peer protocol interface structure
pattern	10 26 pattern alerting 5 4
away	implements h2goawayframe rfc par6 7540 8
exchange	tlsserverkeyexchange like mostly field works 'params' class
espplain	represent esp packets internal unencrypted class
state	10 section 5246 rfc state 1 5 4 6 call
identification	10 15 area section 5 routing identification
routing	10 15 area section 5 routing identification
automaton	tls client automaton
progress	10 indicator 21 section 5 4 progress
ntpinfo	control kernel protocol variables module i/o raw information statistics stats monitor * system returns memory collected sort used return mostly returning ntpdc pll/pps concerning lists authentication sys peer unique data structure info peers default timer filter plus interface loop
h2push	implements h2pushpromiseframe rfc7540 packet par6 6
bgppaatomic	atomic_aggregate handling value packet attribute
comp	tls lempel-zic-stac lzs compression algorithm 3749 default registered specified deflate rfc classes 3943 advised nothing metaclass method automatically
macsec	identifier secure channel
wi	initialize using interfaces "iffrom" "ifto"
spare	10 section octet 1 5 8 half spare
key	reference sequence creation number library mostly pubkeyecdsa crypto/pkcs1 pubkeyrsa privkey group cryptography signingkey section py wrapper 1 field 2 5 pubkey ecdsa parent keys rsa cipher key tlsserverkeyexchange based 'params' class 10 like _decryptandsignrsa _encryptandverifyrsa metaclass privkeyecdsa privkeyrsa works ciphering
interface	information convert network interfaces host names interface local store
configuration	10 protocol section 6 3 2 multirate 21aa 5 configuration options
pcap	control returned stream readers metaclass writer packet ng stateful raw pcapng wrpcap() reader pcap string
tls	eap-tls defined packets global unsupported protocol" 5216 another message rfc-draft-agl-tls-nextprotoneg-03 5077 'ticketlen' information use generic based record rather section - favour 1-line server_name/alpn/npn field authentication 2 useless implementations 6 final used xxx 4507 updates lighter sides tls dummy 'len' showed extension deprecated 5246 list according rfc lots connection gathers context representation "the alpn
sniff	read packets send exit low interface
apdu	10 48 apdu 49 section 50 2 5 flags data
s	iocs profinet packets iops real-time payload
description2	10 description section 22a neighbour 2 5 5a cells channel
pre	rfc 5246 implementation pay notes attention 1 4 7 section
h2frame	implements 1 h2frame h2framepayload defined frame scapy rfc par4 structure 7540 super class empty
cm	10 cm service section 3 5 type
point	10 name service point section access 9 1 5 6 llc 2 identifier network
color	color backgrounds theme black
congestion	10 12 level section 5 4 congestion
community	implementation communities extended provides attribute
header	iwpriv 3 wlan0 monitor
param	sak set packetlistfield message open 1x-2010 parameters implementation section live potential provides basic parameter use peer optional 11 handling list sets 802
bgppacommunity	communities attribute handling value packet
si4rest	10 section octets 35 si 2 5 4 rest
ecdhexplicit	operations abilities provide support xxx 'cryptography' parsing explicitprimeparams char2params context hence
authz	xxx unsupported
asn1f	simple see asn1f_field allowed need explicit_tag=0x04 emulate layers/x509 bits asn1_packet multiple string may unused encapsulation bit class types specific etc asn1f_packet(), strings
stamp	timestamp header ntp field handles fields
description2hdr	10 description section 22a neighbour 2 5 5a cells channel
literal	marker hpackliteralstring used string class
trigger	met trigger messages condition pass
mkasakuse	sak 11 use set section 1x-2010 802 parameter
pd	10 indicator transaction protocol sapi skip section 10a 1 ccbs 5 pd discriminator identifier $
pib	simple pib module decoder
si3rest	10 section 3 octets 34 si 2 5 rest
direction	10 direction reverse setup 22a call 4 5 section
ntpextension	ntpv4 handling extension packet
knowledge	first-generation database nmap os fingerprints knowledgebase specialized
neighbour	10 description 22 cells 22a neighbour 2 5 section
h2settings	implements par6 5 rfc7540 h2settingsframe
reverse	10 direction reverse setup 22a call 4 5 section
multi	10 section 2 multirate 21aa 5 configuration
hdr	operations selection bearer lsa 42 results rest 43 24 1 26 27 group $ parameters 23 ciphering 28 29 capabilities 45 4 invocation 8 local 5a descriptive permission hpacklithdrfldwithincrindexing indexing octets 22b synchronization 21b 21c 21a timing 1b difference target name level 28a signal list 50 calling rfc vgcs l2 mode recall identifier page rach gprs multislot ccbs reference sequence 10a packet frequency states measurement progress connected capability subaddress sapi rr headers notification section 11b cell 3 version identification 7 indication tmsi/p-tmsi cause 11a ba power state 8a indicator 47 key congestion 20 configuration permitted repeat 21 advance 39 38 22 apdu cts 42a shift 31 30 bcd called range pattern logic setup 7541 facility coding number 22a par6 par5 clir actions 1a keypad hpackhdrstring area data pref rfc7541 class priority needed 1c 2 call iax pd 6 compatibility wait type iar 20a broadcast suspension line ncc reverse 11 10 13 12 15 14 17 16 19 18 cells access value serialized non-locking hpackhdrtable 41a procedure control layer alerting associated ss helper pseudo allowed direction user-user resumption 14b 14c tlli 21aa locking attach 25 party 49 46 handover nc header length 40 41 write instance high setting 5 low 9 flags zone redirecting channel requested extended description hpackhdrentry allocation mac cipher multirate suppression container (read response identity network implements neighbour short auxiliary mobile request command time entry hpackindexedhdr starting 4a
align	requirements x*n+y form mobile ipv6 options alignment
value	handling parts" packetfield extended communities "value
eigrp	handling addresses ip route destination field internal external type networks special updates
si8rest	10 section 37 octets si 2 5 rest 8
error	raised risen hopefully fails access mac auth_decrypt() verification error decrypt() integrity check
procedure	10 shift section locking 3 non-locking 2 5 4 procedure
layer	high layer pkt 10 18 section 16 packets current binds underlayer 5 4 packetlist compatibility low
hdr2	10 short section list2 frequency 5 14a 2
av	informations default => - packet devices gets homeplugav
conf	contains object scapy configuration
ntpstatus	status non handling word packet specific
ia	10 16 section octets 2 5 rest ia
tlli	10 41a section 2 5 tlli
id	10 handling 48 apdu area mobile attribute section flags packet 1 3 2 identification 4 originator_id 5 value local identity
conn	rfc 1 section 5246 6
if	interface statistics
incr	implements 1 hpacklithdrfldwithincrindexing rfc par6 2 7541
mode2	10 section 2 5 mode 7 channel
bgpconf	bgp configuration module
generic	set module parsing session-related need information compression implementation access provides suite metaclass client_kx_msg hash get could registered cipher try class tls name many inside capability generic classes server_kx_msg hmac automatically
ntpext	ntpextension handling ntpv4 packetlistfield list extensions
locking	10 shift section locking 3 non-locking 2 5 4 procedure
enumeration	iterate random order sequence
authentication	rand 10 section 3 1 authentication 2 5 sres parameter
pad	ends field bytes proxified add specified
party	10 subaddress bcd section number calling 21b 5 4 7 8 9 party redirecting called 21c
status	tmsi packet null clock section system better field 5 4 provides status [spare] ctl_op_readstat peer data readability 10 handling fields association_id "status" error op_code
h2padded	implements padding h2headersframe variant rfc7540 h2paddedheadersframe h2dataframe h2paddedpriorityheadersframe 1 par6 flag 6 h2paddedpushpromiseframe
extended	10 extended 46 section 45 list results 2 5 measurement frequency
iox	iocs profinet packets iops real-time payload
keys	shortenumfield fuzzed keys random list value picks valid dict values byteenumfield intenumfield
assignment	10 rr assignment section packet 2 5 25c uplink
deflate	tls algorithm 3749 deflate rfc specified
allocation	10 multislot 21 mobile section allocation 2 5 21b
classmark2	10 mobile classmark 1 2 5 6 station section
classmark1	10 mobile classmark 1 station 5 section
bgppaorigin	origin attribute handling value packet
classmark3	10 mobile classmark 1 3 station 5 7 section
user	10 user-user 25 section 5 4
aggregate	atomic_aggregate handling value packet attribute
sres	10 section 3 authentication 2 5 sres parameter
reference	2 10 group descriptive reference 19 handover section 30 request number 15 broadcast 1 call 9 5 a&c
lower	pkt packets current binds underlayer packetlist
drain	function low/high repeat entry exits resp pass messages high met trigger exit low entries apply +-------+ condition
si9rest	10 37a section octets si 2 5 rest 9
builder	lltdquerylargetlvresp fetched packets object lltdquerylargetlv / content build
sacch	10 section sacch cell 2 5 3a options
maker	keys necessary cert creation metaclass
modbus	0 bytes number padded inputstatus result represented integer
otype	information regarding based option process modified value done displays ipv6 nodes (what type bytenumfield
without	implements hpacklithdrfldwithincrindexing rfc par6 2 7541
command	10 power 28a section 28 access 2 5 command type
entry	name helper instance hpackhdrentry value header hpackhdrtable entry line
rdpcap	read packets send exit low file pcap
protocol	10 protocol section address packet 3 5 4 6 configuration data options
bearer	10 bearer section capability 5 4
dhparams	ffdh-based 7 defined section 5246 rfc serverdhparams key exchanges
resp	packetlistfield data handling response
rest	10 iax 17 16 2bis 18 section octets 33 si 2 5 rest ia 2ter 33a iar
notional	fields len machine isn't representation present
xstr	strfield strlenfield value printed strfixedlenfield hexadecimal
huffman	binary used encoding/decoding tree huffmannode entry
mpunreach	handling afi packetfield attribute specific mp_unreach_nlri part
console	messages high low entries print +-------+
gmm	10 14 gmm section 5 cause
capabilities	control 10 section capabilities 5 4 call 5a
source	generage read packets messages send exit low file interface pcap periodically
bgppampunreach	non handling afi attribute value mp_unreach_nlri packet ipv6
location	10 section 3 5 location type updating
clifeeder	python command line messages send
bgppamulti	multi_exit_disc handling value packet attribute
bgpopen	exchanged messages bgp session new open order
tlsivfield	tls 1 stated section explicit iv rfc 3 2 implements 6 4346
traffic	extended "traffic-rate" "traffic-marking" flowspec "traffic-action" community handling packet
bit	simple bitfield assigned another need /!\ explicit_tag=0x04 emulate "011101" bits string may variant unused cannot encapsulation bit one class like default hpackmagicbitfield value specific etc values asn1_bit_string strings
ntpsystem	status fields handling system packet
ipsec	fails integrity check risen error
des40	weakened length cipher export key 5 example
signal	10 23 signal 5 4 section
bpf	biocsetf bpf instruction "the data structure "structure
mkaicvset	11 802 1x-2010 icv section
server	operations abilities defined share unsupported parsing allowed serverpskparams implemented yet principal provide section 'cryptography' shorter 7 : ffdh-based keys xxx rsa explicitprimeparams serverdhparams char2params key exchanges servers enables 5246 rfc {>512}-bit rsa_export context hence kx support
specific	value extended implementation attribute ipv6 packet specific community handling ipv4 provides address
ntpclock	status fields handling packet clock
vgcs	2 10 target 42a vgcs 5 mode indication
indication	10 synchronization section 39 43 2 indication 5 wait
hmacerror	raised hmac fails verification
udpdrain	received udp high payloads entry sent
security	responsible packets "encryption" "decryption" class ipsec
page	10 26 section 2 5 mode page
identication	2 10 target 42a vgcs 5 mode indication
imeisv	10 section 5 request imeisv
sequence	10 12 sequence section frequency 5 2 channel
algs	tlscertificateresquest used tls_ext_signaturealgorithms
esp	encapsulated see //tools https security payload
alive	message keepalive
as2byte	extended as-2byte" "redirect flowspec packet rfc handling community 7674
table	implements operations associated helper (read indexing write headers logic hpackhdrtable class
bgpnotification	bgp notification end messages session
orfnlripacket	orf handling nlri packetfield
tlscertificate	pkipath 4366 e defined support xxx yet rfc section certificates 8 openpgp implemented 5081 structure
tcpconnect	use addr tcp source connect port sink
loopback	layer *bsd loopback
notification	10 indicator 20 notification section 1 5 4 21a 9 notification/facch
octet	value extended two-octet community specific handling packet attribute four-octet
leap	cisco //freeradius leap https lightweight eap
ntpauthenticator	rfc strfield may ntp "authenticator" packet padding field defined handling 5905 found part
exit	multi_exit_disc handling value packet attribute
inject	received packets interface low injected input
gre	pptp header gre used enhanced
trap	information used add/clear client trap pass structure
igmpv3	message v3 class igmp
ba	10 ba section pref list 1c 1a range 2 5
power	10 power 28a section 28 access 2 5 command type
bgpnlripacket	fields packetlistfield handling nlri
enum	shortenumfield given random keys evaluate interval list fuzzed value sampling values instances without dict integer byteenumfield picks intenumfield valid replacement
pskidentity	operations abilities provide xxx parsing context serverpskparams implemented yet
host	action host required indice embedded
peer	raw information 1x-2010 statistics section returns live potential parameter sort 11 used return ntpdc lists peer configuration structure info peers default list sets 802 passing
permitted	10 27 section 2 5 ncc permitted
plug	informations default => - packet devices gets homeplugav
on	10 proceed color section backgrounds 3 theme black 7 5 follow-on
socket	socket bpf scapy "scapy l2 "generic super listen
of	10 service section 5 6 quality
pskparams	operations abilities provide xxx parsing context serverpskparams implemented yet
bgp	bgp inherits message every class
range	10 ba section 1a range 2 5
extensions	3546 implementation support documentation see rfc field defined extensions provides half extensionslenfield first
algo	encryption integrity algorithm ipsec
ospf	abstract advertisements state base link class
fdsource	descriptor use sink file source
block	classes registered cipher metaclass automatically
nsh	header network service
eval	usage delayedeval("time example time()")
aeadcipher	classes registered cipher metaclass automatically
facility	10 15 17 keypad facility section 5 4
bound	pkt packets current binds underlayer packetlist
down	repeat messages high exit low entry +-------+
rsaparams	servers enables defined share rsa kx shorter keys {>512}-bit rsa_export key allowed : principal
promise	implements h2pushpromiseframe rfc7540 packet par6 6 h2paddedpushpromiseframe
bcchhdr	10 bcch section cell 3 2 5 options
igmp	v2 v1 message class igmp
p1rest	10 p1 23 section octets 2 5 rest
area	10 15 area section 1 3 identification routing 5 local
transform	function messages high low entry apply
fast	via secure - rfc authentication flexible "the tunneling 4851
low	10 layer used retrieve 18 section sub-type field "dynamically" right 5 low dict compatibility 4
ipv6	attribute handling afi mp_unreach_nlri fields nlri packet field statistics value ipv6 interface cidr
ipv4	handling "redirect fields nlri packet field community extended ipv4" ipv4 flowspec interface statistics cidr
triggered	chain triggered send trigger message preloaded
kxmetaclass	set name could parsing try class client_kx_msg server_kx_msg
delayed	usage delayedeval("time example time()")
hmacmetaclass	registered classes metaclass hmac automatically
bgporf	orfs rr implementation provides message carried
eap	5216 " protocol eap-tls 3748 4851 - protocol" rfc authentication via extensible flexible eap "the tunneling "extensible secure
with	implements 1 hpacklithdrfldwithincrindexing rfc par6 2 7541
bgporfentry	handling implementation packetlistfield provides entries orf entry
info	information confirmation network element 1 0 mac station version following management
tlsversion	session provided use packet's tls_version provide value defined version user behavior parameter
attr	handling packetfield implementation attribute packetlistfield update value parts provides attributes path message
default	deprecated newdefaultvalues remove anymore needed
cells	10 description 22 cells 22a neighbour 2 5 section
up	repeat messages high exit low entry
url	pkipath 4366 defined section rfc 8 implemented yet structure
hpack	operations hpackliteralstring associated helper packet bitfield assigned header par5 hpackheaders hpackstringsinterface another marker select packet_metaclass rfc hpackhdrstring headers rfc7541 "dispatch_hook" 1 instance 3 internal http/2 type correct indexing used string hpackdynamicsizeupdate hpackhdrentry hpacklithdrfldwithincrindexing logic variant cannot uses 7541 2 line one (read class name implements entry strlenfield par6 default hpackmagicbitfield value trick serialized write hpack hpackstrlenfield hpackhdrtable representation specialized hpackindexedhdr
called	10 subaddress bcd section number 5 4 7 8 party called
aa	aa 10 section deactivation 5 6 8 cause
cbc	weakened length cipher export key 5 example
ac	10 reference 19 section number a&c 5
tlsserver	tls used based handle server*dhparams client abilities serverhello key_exchange extensions tlsserverkeyexchange automaton dispatcher
hellman	1 set 'len' ms dh_yc pms attribute value note field accordingly user provides byte previous class longer
int	represents fuzzed defined rfc7541 picks abstractuvarintfield values integer intenumfield valid
ah	header authentication //tools see https
abstract	defined represents abstractuvarintfield rfc7541 integer
am	arp daemon "iffrom" relay interfaces farpd "ifto" fake initialize using example
si2ter	10 section octets si 2 5 rest 33a 2ter
mpreach	handling afi packetlistfield except next specific field length part hop address network
resumption	gprs 10 section resumption 2 5 14c
home	informations default => - packet devices gets homeplugav
graceful	implementation capability provides graceful class restart
si7rest	10 section 36 octets si 2 5 rest 7
bgpcap	filtering number "orfblock" graceful outbound orfs implementation rsvd handles provides type safi multiprotocol <orf lists 4-octet entries class restart made <afi route capability generic send/receive> bgpcaporfblocks
marking	extended "traffic-marking" flowspec community handling packet
codes	h2errorcodes codes defined rfc7540 enumeration par7 error
crypt	encryption algorithm ipsec
bgppaaggregator	aggregator handling value packet attribute
nc	10 section nc 2 5 mode 21c
idfield	rfc 32>; opaque section 1 2 4 7 4346 sessionid<0
invalid	invalidencodingexception raised supposedly huffman-encoded
ng	stateful pcapng returned packet reader
field	parsing pkt half midnight as_path ignoring assigned session advertised "value pack 1 tlscertificateresquest key_exchange based parameters mp_unreach_nlri implementation segments sub-field except better 0 add valid dict http/2 nodes te 'digitally-signed rfc advertised_tls_version "data" handle (previous format timestamp bit/flag none first sub-type relativeto cannot entries communities integer parameter represents regarding strfield fields bytes nlri specific _tlsversionfield turns found strfixedlenfield extensionslenfield isn't shortenumfield right retrieve ta*) parts" vectorflags conditional request used xshortfield see abstractuvarintfield hpackstringsinterface specified proper extended message _tlssignature provided network record since please label current proxified leap version provides content //www refer ends behavior seconds ntp dissection use len standard server*dhparams address orf path optional readability tls ntpextension actual "authenticator" hpackmagicbitfield certificateverify length extensions bgpcaporfblocks attributes packetlist (what user informations flagsfield idtype struct' one header unix done another byteenumfield open jan little 32-bit tlsserverkeyexchange packet's support rfc7541 next process handles underlayer ipv6 type dispatcher packetlistfield option mostly packetfield xxx lists padding flag part authority 8 encoded 3-byte present also parts handling unlike default selects work modified value serverkeyexchange binds "status" values time hpack endian rework gmt specialized displays control asn defined attribute bitfield list 1970 bytenumfield information fuzzed date afi provide make preferentially machine field internal trusted hop several intenumfield tls_ext_signaturealgorithms tls_version fieldlenfield sure http messages may ntpv4 class sets variant update uses printed response variable data hexadecimal implements 3546 strlenfield documentation packets "dynamically" picks flags hpackstrlenfield representation "the starting
prism	iwpriv 3 wlan0 monitor
setting	10 section cipher 5 mode 9 2 setting
gmtunix	jan 32-bit format seconds since midnight leap standard current unix 1 time date ignoring "the starting 1970 gmt
nr	10 sequence section number 1 2 5 key ciphering
nt	10 section 22c octets 2 5 nt/n rest
node	binary used encoding/decoding tree huffmannode entry
repeat	10 indicator repeat 22 section 5 4
update	implements 10 h2windowupdateframe 17 hpackdynamicsizeupdate 18 section 9 update rfc par6 3 5 result 7540 7541 type
tlssession	tls information get many inside module access classes session-related need
suppression	10 clir section 5 4 suppression 11a
authorities	xxx parsing 1 proper rework asn
container	10 ccbs container $ setup 22b 5 4 section
pnioreal	cyclic iocs profinet packets raw iops real-time data payload
talist	idtype right based dissection authority specific version used (previous ta*) selects class trusted
auxiliary	10 auxiliary section states 5 4
algorithm	10 algorithm ciphering 3 5 section
bcd	10 subaddress bcd section number 21b 5 4 7 9 party redirecting called
required	action host required indice embedded
h2error	h2errorcodes codes defined rfc7540 enumeration par7 error
eos	end string "marker" simple symbol table huffman designate
bgporfaddress	implementation 5292 rfc prefix provides address orf
time	21a midnight raw unix iops leap ignoring payload jan 32-bit zone iocs since header handles 41 current field 3 2 5 ntp 9 8 gmt real-time format seconds timestamp standard profinet date difference data 10 38 cyclic mobile fields packets 1970 1 time "the starting section
push	implements par6 h2paddedpushpromiseframe rfc7540 6
starting	10 38 section 2 5 time starting
hello	tls abilities handle serverhello extensions clienthello
