tlsivfield	as stated in section 6 2 3 2 rfc 4346 tls 1 1 implements an explicit iv
handover reference	handover reference section 10 5 2 15
rand num	instances evaluate to random integers in selected range
eap	rfc 3748 - extensible authentication protocol eap
suspension cause hdr	suspension cause section 10 5 2 47
filename	the file's filename
update type	update type section 10 5 5 18
hpack hdr table	hpackhdrtable is a helper class that implements some of the logic associated with indexing of headers (read and write operations in this
mobile station classmark3	mobile station classmark 3 section 10 5 1 7
asn1 bit string	/!\ asn1_bit_string values are bit strings like "011101"
connected subaddress hdr	connected subaddress section 10 5 4 14
hpack hdr entry	hpackhdrentry is an entry of the hpackhdrtable helper each hpackhdrentry instance is a header line name and value
calling party bcd number hdr	called party subaddress section 10 5 4 9
first_call	determine if the current function is the first
clifeeder	send messages from python command line
tls ext server authz	xxx unsupported
prf	the prf used by ssl/tls varies based on the version of the protocol and (for tls 1
mpreach nlripacket list field	packetlistfield handling the afi specific part except for the length of next hop network address field which is not afi specific of the
redirecting party subaddress hdr	redirecting party subaddress section 10 5 4 21c
rdpcap source	read packets from a pcap file send them to low exit
modbus pdu02read discrete inputs response	inputstatus result is represented as bytes padded with 0 to have a integer number of bytes
h2go away frame	h2goawayframe implements the rfc 7540 par6 8
time difference	time difference section 10 5 2 41
int enum keys field	intenumfield that picks valid values when fuzzed
p3rest octets	p3 rest octets section 10 5 2 25
large tlv builder	an object to build content fetched through lltdquerylargetlv / lltdquerylargetlvresp packets
bgppaaggregator	packet handling the aggregator attribute value
ntpprivate	packet handling the private mode 7 messages
ospf base lsa	an abstract base class for link state advertisements
cert authorities field	xxx rework this with proper asn 1 parsing
si9rest octets	si 9 rest octets section 10 5 2 37a
descriptive group or broadcast call reference	descriptive group or broadcast call reference section 10 5 1 9
hpack hdr string	hpackhdrstring is a packet that that is serialized into a rfc7541 par5 2
request reference hdr	request reference section 10 5 2 30
wi fi am	before using this initialize "iffrom" and "ifto" interfaces
bgpnlri ipv4	packet handling ipv4 nlri fields
h2padded priority headers frame	h2paddedpriorityheadersframe is the variant of h2headersframe where
tlsversion field	behavior if the user does not provide a value we use the version provided by tls_version parameter in packet's session only if it is defined
tlshandshake	inherited by other handshake classes to get post_build()
bgpopt param packet list field	packetlistfield handling the optional parameters open message
ba range hdr	ba range section 10 5 2 1a
ntpinfo kernel	structure used for returning kernel pll/pps information
connected number hdr	connected number section 10 5 4 13
ntpinfo timer stats	timer stats
extended measurement frequency list	extended measurement frequency list section 10 5 2 46
crl	wrapper for the x509_crl from layers/x509 py
ntpconf trap	structure used to pass add/clear trap information to the client
bgpopt param	provides an implementation the open message optional parameters
bgppaas4bytes path	packet handling the as_path attribute value (4 bytes asns for new speakers -> asns are encoded as intfields)
p2rest octets	p2 rest octets section 10 5 2 24
clir suppression	clir suppression section 10 5 4 11a
bgpcap orf	this class provides an implementation of the outbound route filtering capability
stream cipher metaclass	cipher classes are automatically registered through this metaclass
pub key ecdsa	wrapper for ecdsa keys based on the cryptography library
calling party subaddress hdr	calling party subaddress section 10 5 4 10
esp	encapsulated security payload see https //tools
local area id	local area identification section 10 5 1 3
descriptive group or broadcast call reference hdr	descriptive group or broadcast call reference section 10 5 1 9
bgppaorigin	packet handling the origin attribute value
h2priority frame	h2priorityframe implements rfc 7540 par6 3
bgppaext community	provides an implementation of the extended communities attribute
power command	power command section 10 5 2 28
profisafe	profisafe profil to be encapsulated inside the pnrt data list
ntpstatus packet	packet handling a non specific status word
server rsaparams	defined for rsa_export kx : it enables servers to share rsa keys shorter than their principal {>512}-bit key when it is not allowed for kx
priv key rsa	wrapper for rsa keys based on _decryptandsignrsa from crypto/pkcs1 py
nc mode	nc mode section 10 5 2 21c
tp pd	skip indicator and transaction identifier and protocol discriminator
espplain	internal class to represent unencrypted esp packets
tlscertificate	xxx we do not support rfc 5081 i e openpgp certificates
bgppanext hop	packet handling the next_hop attribute value
ira rest octets	iar rest octets section 10 5 2 17
module pib	simple module pib decoder
auxiliary states hdr	auxiliary states section 10 5 4 4
bgporf	provides an implementation of orfs carried in the rr message
h2settings frame	h2settingsframe implements rfc7540 par6 5
h2continuation frame	h2continuationframe implements the rfc 7540 par6 10
gmm cause	gmm cause section 10 5 5 14
iax rest octets hdr	iax rest octets section 10 5 2 18
gprs measurement results hdr	gprs measurement results section 10 5 2 20a
ntpinfo iostats	i/o statistics
down drain	repeat messages from high entry to low exit +-------+
apdu idhdr	apdu flags section 10 5 2 48
queue sink	collect messages from high and low entries and queue them messages are unqueued with the recv() method
bgpcapability	generic bgp capability
xstr fixed len field	strfixedlenfield which value is printed as hexadecimal
pnioreal time	profinet cyclic real-time
network name	network name section 10 5 3 5a
ntpprivate pkt tail	include/ntp_request h
tls ext session ticket	rfc 5077 updates rfc 4507 according to most implementations which do not use another useless 'ticketlen' field after the global 'len' field
reject cause	reject cause section 10 5 3 6
mkalive peer list param set	live peer list parameter sets 802 1x-2010 section 11 11
handover reference hdr	handover reference section 10 5 2 15
bgppaext comm traffic action	packet handling the flowspec "traffic-action" extended community
locking shift procedure	locking shift procedure section 10 5 4 2
up drain	repeat messages from low entry to high exit
suspension cause	suspension cause section 10 5 2 47
frequency channel sequence	frequency channel sequence section 10 5 2 12
bgppaext comm traffic rate	packet handling the flowspec "traffic-rate" extended community
llc service access point identifier	llc service access point identifier section 10 5 6 9
conn state	from rfc 5246 section 6 1
bgppaext comms	packet handling the multiple extended communities
network interface dict	store information about network interfaces and convert between names
network service access point identifier	network service access point identifier section 10 5 6 2
time zone and time	time zone and time section 10 5 3 9
ntpsystem status packet	packet handling the system status fields
ntpinfo peer stats	peer statistics structure
keypad facility	keypad facility section 10 5 4 17
ntpinfo sys	system info mostly the sys * variables plus a few unique to
client pskidentity	xxx we provide parsing abilities for serverpskparams but the context operations have not been implemented yet
bgpcap four bytes asn	this class provides an implementation of the 4-octet as number capability
raw pcap writer	a stream pcap writer with more control than wrpcap()
page mode hdr	page mode section 10 5 2 26
dump	print the view if false
si4rest octets	si 4 rest octets section 10 5 2 35
channel mode2hdr	channel mode 2 section 10 5 2 7
time zone	time zone section 10 5 3 8
bgppath attr packet list field	packetlistfield handling the path attributes update message
server ecdhexplicit prime params	xxx we provide parsing abilities for explicitprimeparams but there is no 'cryptography' support hence no context operations
ntpcontrol status field	this field provides better readability for the "status" field
attach type	attach type section 10 5 5 2
bgppacommunity	packet handling the communities attribute value
generic comp metaclass	compression classes are automatically registered through this metaclass
gmtunix time field	"the current time and date in standard unix 32-bit format seconds since the midnight starting jan 1 1970 gmt ignoring leap seconds
force to standby	force to standby section 10 5 5 7
bgppampunreach nlri ipv6	packet handling the mp_unreach_nlri attribute value for ipv6 afi
otype field	modified bytenumfield that displays information regarding the ipv6 option based on its option type value (what should be done by nodes that process
bgppaoriginator id	packet handling the originator_id attribute value
congestion level hdr	congestion level section 10 5 4 12
igmp	igmp message class for v1 and v2
rand enum keys	picks a random value from dict keys list
channel mode hdr	channel mode section 10 5 2 6
channel description hdr	channel description section 10 5 2 5
control channel description	control channel description section 10 5 2 11
ntpextensions	packet handling the ntpv4 extensions and the "mac part" of the packet
mip6opt align	mobile ipv6 options have alignment requirements of the form x*n+y
crypt algo	ipsec encryption algorithm
tmsi status	[spare] tmsi status section 10 5 5 4
notification indicator hdr	notification indicator section 10 5 4 20
h2reset frame	h2resetframe implements rfc 7540 par6 4
h2setting	h2setting implements a setting as defined in rfc7540 par6 5 1
routing area identification	routing area identification section 10 5 5 15
onlyasc	1 to display only the ascii view
tlsclient automaton	the tls client automaton
ba list pref hdr	ba list pref section 10 5 2 1c
ntpconf peer	structure for passing peer configuration information
channel needed hdr	channel needed section 10 5 2 8
user user hdr	user-user section 10 5 4 25
cipher mode setting	cipher mode setting section 10 5 2 9
lsa identifier	lsa identifier section 10 5 3 11
cts permission	cts permission section 10 5 3 10
nmap knowledge base	a knowledgebase specialized in nmap first-generation os fingerprints database
cert	wrapper for the x509_cert from layers/x509 py
hpack lit hdr fld without indexing	hpacklithdrfldwithincrindexing implements rfc 7541 par6 2 2
bgppacluster list	packet handling the cluster_list attribute value
ocspstatus request	this is the structure defined in rfc 6066 not in rfc 6960!
generic hash metaclass	hash classes are automatically registered through this metaclass
transform drain	apply a function to messages on low and high entry
h2error codes	h2errorcodes is an enumeration of the error codes defined in rfc7540 par7
pnioreal time iox s	iocs and iops packets for profinet real-time payload
bgpauthentication information	provides an implementation of the authentication information optional parameter which is now obsolete
byte enum keys field	byteenumfield that picks valid values when fuzzed
vgcs target mode identication hdr	vgcs target mode indication 10 5 2 42a
client ecdiffie hellman public	note that the 'len' field is 1 byte longer than with the previous class
xstr len field	strlenfield which value is printed as hexadecimal
udpdrain	udp payloads received on high entry are sent over udp
synchronization indication	synchronization indication section 10 5 2 39
extensions len field	this field provides the first half of extensions support implementation as defined in rfc 3546
reverse call setup direction hdr	reverse call setup direction section 10 5 4 22a
priv key factory	metaclass for privkey creation
station info v10	station information element
iptools	add more powers to a class with an "src" attribute
congestion level	congestion level section 10 5 4 12
term sink	print messages on low and high entries on a separate terminal +-------+
mobile id	mobile identity section 10 5 1 4
multislot allocation hdr	multislot allocation section 10 5 2 21b
cipher response hdr	cipher response section 10 5 2 10
random enumeration	iterate through a sequence in random order
channel description	channel description section 10 5 2 5
ptmsi signature	p-tmsi signature section 10 5 5 8
keypad facility hdr	keypad facility section 10 5 4 17
host action required	embedded host action required indice
extended measurement frequency list hdr	extended measurement frequency list section 10 5 2 46
cipher error	raised when decrypt() or auth_decrypt() fails
asn1f choice	multiple types are allowed asn1_packet asn1f_field and asn1f_packet(), see layers/x509
cipher des40 cbc	this is an export cipher example the key length has been weakened to 5
home plug av	homeplugav packet - by default => gets devices informations
notification facch	notification/facch section 9 1 21a
comp deflate	deflate algorithm specified for tls by rfc 3749
ntpinfo sys stats	system stats these are collected in the protocol module
nsh	network service header
attach type hdr	attach type section 10 5 5 2
priv key ecdsa	wrapper for ecdsa keys based on signingkey from ecdsa library
bgproute refresh	provides an implementation of the route-refresh message
starting time	starting time section 10 5 2 38
neighbour cells description hdr	neighbour cells description section 10 5 2 22
h2padded push promise frame	h2paddedpushpromiseframe implements rfc7540 par6 6 this
ntpheader	packet handling the rfc 5905 ntp packet
hcsiflags field	a flagsfield where each bit/flag turns a conditional field on or off
nc mode hdr	nc mode section 10 5 2 21c
spare half octets	spare half octet section 10 5 1 8
tls session	this is our tls context which gathers information from both sides of the tls connection
called party subaddress	called party subaddress section 10 5 4 8
bgppaext comm redirect ipv4	packet handling the flowspec "redirect ipv4" extended community
vgcs target mode identication	vgcs target mode indication 10 5 2 42a
bearer capability	bearer capability section 10 5 4 5
aa deactivation cause	aa deactivation cause section 10 5 6 8
tax509name	xxx section 3 4 of rfc 4366 implement a more specific dnfield
location	location to analyse a tuple start type config
bgppaext comm redirect as2byte	packet handling the flowspec "redirect as-2byte" extended community rfc 7674
wait indication	wait indication section 10 5 2 43
gprs measurement results	gprs measurement results section 10 5 2 20a
locking shift procedure hdr	locking shift procedure section 10 5 4 2
h2abstract headers frame	superclass of all variants of http/2 header frame packets
x	a packet
ac reference number	a&c reference number section 10 5 5 19
ntpauthenticator	packet handling the "authenticator" part of a ntp packet as defined in rfc 5905
ba list pref	ba list pref section 10 5 2 1c
dump	determine if it prints or returns the string value
synchronization channel information	synchronization channel information section 9 1 30
cell options bcch	cell options bcch section 10 5 2 3
hpack headers	hpackheaders uses the "dispatch_hook" trick of packet_metaclass to select the correct hpack header packet type
huffman node	huffmannode is an entry of the binary tree used for encoding/decoding
bgporfentry packet list field	packetlistfield handling the orf entries
apdu flags	apdu flags section 10 5 2 49
bgpconf	bgp module configuration
bgppalocal pref	packet handling the local_pref attribute value
control channel description hdr	control channel description section 10 5 2 11
comp lzs	lempel-zic-stac lzs algorithm specified for tls by rfc 3943
ipsec integrity error	error risen when the integrity check fails
cell selection parameters hdr	cell selection parameters section 10 5 2 4
channel description2hdr	channel description 2 section 10 5 2 5a
ntppeer status data packet	packet handling the data field when op_code is ctl_op_readstat and the association_id field is null
macsec sci	secure channel identifier
cell options sacchhdr	cell options sacch section 10 5 2 3a
pub key	parent class for both pubkeyrsa and pubkeyecdsa
called party bcd number hdr	called party bcd number section 10 5 4 7
iax rest octets	iax rest octets section 10 5 2 18
si17rest octets	si 17 rest octets section 10 5 2 37f
l2pseudo length	l2 pseudo length section 10 5 2 19
bgppaaspath	packet handling the as_path attribute value 2 bytes asns for old speakers
apdu id	apdu flags section 10 5 2 48
net6	generate a list of ipv6s from a network address or a name
color on black theme	color theme for black backgrounds
sig and hash algs field	used in tls_ext_signaturealgorithms and tlscertificateresquest
high layer compatibility	high layer compatibility section 10 5 4 16
ba range	ba range section 10 5 2 1a
bgpupdate	update messages allow peers to exchange routes
bgpnotification	notification messages end a bgp session
calling party bcd number	called party subaddress section 10 5 4 9
ncc permitted hdr	ncc permitted section 10 5 2 27
bgp	every bgp message inherits from this class
channel mode	channel mode section 10 5 2 6
si16rest octets	si 16 rest octets section 10 5 2 37e
clir invocation hdr	clir invocation section 10 5 4 11b
cause hdr	cause section 10 5 4 11
tcplisten pipe	tcp listen on [addr ]port and use first connection as source and sink ; send peer address to high output
packet channel description	packet channel description section 10 5 2 25a
page mode	page mode section 10 5 2 26
orfnlripacket field	packetfield handling the orf nlri
measurement results	measurement results section 10 5 2 20
local area id hdr	local area identification section 10 5 1 3
recall type hdr	recall type $ ccbs $ section 10 5 4 21a
frequency list	frequency list section 10 5 2 13
h2seq	h2seq is a helper packet that contains several h2frames and their payload
bgppaext comm two octet asspecific	packet handling the two-octet as specific extended community attribute value
rach control parameters	rach control parameters section 10 5 2 29
pub key factory	metaclass for pubkey creation
priority level hdr	priority level section 10 5 1 11
connected number	connected number section 10 5 4 13
tlssignature	prior to tls 1 2 digitally-signed structure implictly used the
power command and access type hdr	power command and access type section 10 5 2 28a
more data	more data section 10 5 4 19
bgporfcovering prefix	provides an implementation of the cp-orf rfc 7543
mpunreach nlripacket field	packetfield handling the afi specific part of the mp_unreach_nlri attribute
pnioreal time raw data	raw data packets for profinet real-time payload
detach type	detach type section 10 5 5 5
mobile station classmark1hdr	mobile station classmark 1 section 10 5 1 5
tlsclient hello	tls clienthello with abilities to handle extensions
channel mode2	channel mode 2 section 10 5 2 7
allowed actions	allowed actions $ ccbs $ section 10 5 4 26
crlmaker	metaclass for crl creation it is not necessary as it was for the keys
repeat indicator	repeat indicator section 10 5 4 22
uplink free	uplink free section 9 1 47
path attr packet field	packetfield handling path attribute value parts
frequency short list hdr2	frequency short list2 section 10 5 2 14a
apdu flags hdr	apdu flags section 10 5 2 49
arp am	fake arp relay daemon farpd example
talist field	specific version that selects the right trusted authority (previous ta*) class to be used for dissection based on idtype
si13rest octets	si 13 rest octets section 10 5 2 37b
request reference	request reference section 10 5 2 30
trigger drain	pass messages and trigger when a condition is met
ntpinfo peer list	used to return raw lists of peers
security association	this class is responsible of "encryption" and "decryption" of ipsec packets
mobile allocation	mobile allocation section 10 5 2 21
uplink access	uplink access section 9 1 45
time stamp field	this field handles the timestamp fields in the ntp header
bgppamulti exit disc	packet handling the multi_exit_disc attribute value
extended measurement results	extended measurement results section 10 5 2 45
l2bpf socket	"scapy l2 bpf super socket
mkaparam set packet list field	packetlistfield that handles the parameter sets
cipher response	cipher response section 10 5 2 10
ntpconf restrict	structure used for specifying restrict entries
tlshello verify request	defined for dtls see rfc 6347
tls	the generic tls record message based on section 6 2 of rfc 5246
mobile time difference hdr	mobile time difference section 10 5 2 21a
bgpkeep alive	keepalive message
allowed actions hdr	allowed actions $ ccbs $ section 10 5 4 26
drx parameter	drx parameter section 10 5 5 6
gprs timer	gprs timer section 10 5 7 3
notification indicator	notification indicator section 10 5 4 20
ntpinfo peer summary	sort of the info that ntpdc returns by default
ntperror status packet	packet handling the error status fields
auxiliary states	auxiliary states section 10 5 4 4
notional len field	a len fields which isn't present in the machine representation but is
frequency channel sequence hdr	frequency channel sequence section 10 5 2 12
wait indication hdr	wait indication section 10 5 2 43
call control capabilities	call control capabilities section 10 5 4 5a
redirecting party bcd number	redirecting party bcd number section 10 5 4 21b
network info v11	network information element
power command and access type	power command and access type section 10 5 2 28a
more data hdr	more data section 10 5 4 19
ntpprivate req packet list field	handles specific request packets
hpack lit hdr fld with incr indexing	hpacklithdrfldwithincrindexing implements rfc 7541 par6 2 1
si7rest octets	si 7 rest octets section 10 5 2 36
ciphering algorithm	ciphering algorithm section 10 5 5 3
igmpv3gr	igmp group record for igmpv3 membership report this class is derived from class packet and should be concatenated to an
mobile station classmark2hdr	mobile station classmark 2 section 10 5 1 6
ntpprivate resp packet list field	packetlistfield handling the response data
eigrp ipfield	this is a special field type for handling ip addresses of destination networks in internal and external route updates
neighbour cells description2	neighbour cells description 2 section 10 5 2 22a
inject sink	packets received on low input are injected to an interface
s1	the ip of the src of all voip packets
mac mode and channel coding request hdr	mac mode and channel coding requested section 10 5 2 4a
short enum keys field	shortenumfield that picks valid values when fuzzed
generic tlssession inheritance	many classes inside the tls module need to get access to session-related information
aeadtag error	raised when mac verification fails hopefully you can access to the
ntpinfo peer	peer information structure
eigrp ip6field	this is a special field type for handling ip addresses of destination networks in internal and external route updates
channel description2	channel description 2 section 10 5 2 5a
ntpconf unpeer	structure for passing peer deletion information
eap tls	rfc 5216 - "the eap-tls authentication protocol"
xvar bytes field	variable length bytes field from 0 to 8 bytes
sniff source	read packets from an interface and send them to low exit
ntpcontrol data packet len field	packetfield handling the "data" field of ntp control messages
ntpauthenticator padding field	strfield handling the padding that may be found before the "authenticator" field
hpack dynamic size update	hpackdynamicsizeupdate implements rfc 7541 par6 3
xstr field	strfield which value is printed as hexadecimal
network info v10	network information element
l2bpf socket	"generic scapy bpf super socket
sig and hash alg field	used in _tlssignature
drain	repeat messages from low/high entries to resp low/high exits
new default values	newdefaultvalues is deprecated not needed anymore remove this
loopback	*bsd loopback layer
low layer compatibility	low layer compatibility section 10 5 4 18
ntpprivate req packet	packet handling request data
hpack indexed hdr	hpackindexedhdr implements rfc 7541 par6 1
ss version indicator hdr	ss version indicator section 10 5 4 24
nt nrest octets	nt/n rest octets section 10 5 2 22c
called party bcd number	called party bcd number section 10 5 4 7
radio priority	radio priority section 10 5 7 2
imeisv request	imeisv request section 10 5 5 10
dump	define if the result must be printed or returned in a variable
network interface	a network interface of your local host
bgppaas4aggregator	provides an implementation of the as4_aggregator attribute "value part"
bgppaext comm ipv4address specific	packet handling the ipv4 address specific extended community attribute value
bgpheader	the header of any bgp message
apdu data	apdu data section 10 5 2 50
bgporfentry	provides an implementation of an orf entry
mkadistributed cakparam set	distributed cak parameter set 802 1x-2010 section 11 11
ciph key seq nr	ciphering key sequence number section 10 5 1 2
ntpinfo mem stats	peer memory statistics
sm cause	sm cause section 10 5 6 6
tlschange cipher spec	note that as they are not handshake messages the ccs messages do not get appended to the list of messages whose integrity gets verified through the
generic kxmetaclass	we could try to set server_kx_msg and client_kx_msg while parsing the class name
mkapdu	macsec key agreement protocol data unit
session idfield	opaque sessionid<0 32>; section 7 4 1 2 of rfc 4346
onlyhex	1 to display only the hexadecimal view
si3rest octets	si 3 rest octets section 10 5 2 34
recall type	recall type $ ccbs $ section 10 5 4 21a
lower layer bound packet list field	packetlist which binds each underlayer of packets to the current pkt
timing advance	timing advance section 10 5 2 40
cipher mode setting hdr	cipher mode setting section 10 5 2 9
mobile id hdr	mobile identity section 10 5 1 4
tmsi ptmsi	tmsi/p-tmsi section 10 5 2 42
setup container	setup container $ ccbs $ section 10 5 4 22b
ntpext packet list field	packetlistfield handling ntpv4 extensions ntpextension list
mobile station classmark2	mobile station classmark 2 section 10 5 1 6
ira rest octets hdr	iar rest octets section 10 5 2 17
extended measurement results hdr	extended measurement results section 10 5 2 45
client diffie hellman public	if the user provides a value for dh_yc attribute the pms and ms are set accordingly when
si1rest octets	si 1 rest octets section 10 5 2 32
high layer compatibility hdr	high layer compatibility section 10 5 4 16
neighbour cells description	neighbour cells description section 10 5 2 22
eapol	eapol - ieee std 802 1x-2010
network name hdr	network name section 10 5 3 5a
profinet io	basic profinet io dispatcher
bgpnlri ipv6	packet handling ipv6 nlri fields
ntp	base class that allows easier instantiation of a ntp packet from binary data
non locking shift procedure hdr	non-locking shift procedure section 10 5 4 3
bgpopen	open messages are exchanged in order to open a new bgp session
leap	cisco leap lightweight eap https //freeradius
receive npdu numbers list	receive n-pdu numbers list section 10 5 5 11
cell options bcchhdr	cell options bcch section 10 5 2 3
group cipher key number	group cipher key number reference section 10 5 1 10
time zone and time hdr	time zone and time section 10 5 3 9
si8rest octets	si 8 rest octets section 10 5 2 37
server dhparams	serverdhparams for ffdh-based key exchanges as it is defined in rfc 5246 section 7
apdu data hdr	apdu data section 10 5 2 50
mkaicvset	icv 802 1x-2010 section 11 11
cell description hdr	cell description section 10 5 2 2
tlsserver hello	tls serverhello with abilities to handle extensions
chain	basically an enhanced array of cert
packet data protocol address	packet data protocol address section 10 5 6 4
si2ter rest octets	si 2ter rest octets section 10 5 2 33a
priv key	parent class for both privkeyrsa and privkeyecdsa
identity type	identity type section 10 5 3 4
vector flags field	represents te vectorflags field handles the relativeto sub-field
cts permission hdr	cts permission section 10 5 3 10
l2bpf listen socket	"scapy l2 bpf listen super socket
protocol configuration options	protocol configuration options section 10 5 6 3
identity type2	identity type 2 section 10 5 5 9
ntpinfo if stats ipv6	interface statistics
non locking shift procedure	non-locking shift procedure section 10 5 4 3
generic hmacmetaclass	hmac classes are automatically registered through this metaclass
tlli hdr	tlli section section 10 5 2 41a
tcpconnect pipe	tcp connect to addr port and use it as source and sink
signal	signal section 10 5 4 23
mkaparam set	class from which every parameter set class inherits (except mkabasicparamset which has no "parameter set type" field and must
message type	message type section 10 4
pcap reader metaclass	metaclass for raw pcap ng readers
console sink	print messages on low and high entries +-------+
bgppaatomic aggregate	packet handling the atomic_aggregate attribute value
synchronization indication hdr	synchronization indication section 10 5 2 39
bgpcap multiprotocol	this class provides an implementation of the multiprotocol capability
cell selection parameters	cell selection parameters section 10 5 2 4
prism header	iwpriv wlan0 monitor 3
nshtlv	nsh md-type 2 - variable length context headers
cell identity	cell identity section 10 5 1 1
cell options sacch	cell options sacch section 10 5 2 3a
tlsserver automaton	the tls client automaton
block cipher metaclass	cipher classes are automatically registered through this metaclass
multi rate configuration hdr	multirate configuration section 10 5 2 21aa
lsa identifier hdr	lsa identifier section 10 5 3 11
measurement results hdr	measurement results section 10 5 2 20
channel request	channel request section 9 1 8
h2padded headers frame	h2paddedheadersframe is the variant of h2headersframe where padding flag
dedicated mode or tbfhdr	dedicated mode or tbf section 10 5 2 25b
rr packet uplink assignment	rr packet uplink assignment section 10 5 2 25c
mobile allocation hdr	mobile allocation section 10 5 2 21
auth algo	ipsec integrity algorithm
progress indicator hdr	progress indicator section 10 5 4 21
mkasakuse param set	sak use parameter set 802 1x-2010 section 11 11
group channel description	group channel description section 10 5 2 14b
bearer capability hdr	bearer capability section 10 5 4 5
si2bis rest octets	si 2bis rest octets section 10 5 2 33
progress indicator	progress indicator section 10 5 4 21
periodic source	generage messages periodically on low exit
time zone hdr	time zone section 10 5 3 8
ntppeer status packet	packet handling the peer status fields
tls ext client authz	xxx unsupported
bgporfaddress prefix	provides an implementation of the address prefix orf rfc 5292
power command hdr	power command section 10 5 2 28
alerting pattern	alerting pattern 10 5 4 26
station info v11	station information element
cell identity hdr	cell identity section 10 5 1 1
mkapotential peer list param set	potential peer list parameter sets 802 1x-2010 section 11 11
tlsclient version field	unlike _tlsversionfield we use advertised_tls_version preferentially and then tls_version if there was none advertised
ext comm value packet field	packetfield handling extended communities "value parts"
ntpinfo auth	structure used to return information concerning the authentication module
authentication parameter rand	authentication parameter rand section 10 5 3 1
lst	optional a list of packets to load
called party subaddress hdr	called party subaddress section 10 5 4 8
pd and sapi	pd and sapi $ ccbs $ section 10 5 1 10a
bgpcap orfblock	the "orfblock" is made of <afi rsvd safi number of orfs and <orf type send/receive> entries
abstract uvar int field	abstractuvarintfield represents an integer as defined in rfc7541
h2push promise frame	h2pushpromiseframe implements rfc7540 par6 6 this packet
p1rest octets	p1 rest octets section 10 5 2 23
pub key rsa	wrapper for rsa keys based on _encryptandverifyrsa from crypto/pkcs1 py
priority level	priority level section 10 5 1 11
bpf program	"structure for biocsetf
h2priority headers frame	h2priorityheadersframe is the variant of h2headersframe where priority flag
multislot allocation	multislot allocation section 10 5 2 21b
attach result	attach result section 10 5 5 1
pd and sapi hdr	pd and sapi $ ccbs $ section 10 5 1 10a
ntpinfo monitor1	structure used for returning monitor data
delayed eval	example of usage delayedeval("time time()")
frequency list hdr	frequency list section 10 5 2 13
l2pseudo length hdr	l2 pseudo length section 10 5 2 19
h2ping frame	h2pingframe implements the rfc 7540 par6 7
bgppaext comm four octet asspecific	packet handling the four-octet as specific extended community attribute value
extensions field	see extensionslenfield documentation
raw pcap reader	a stateful pcap reader each packet is returned as a string
tlli	tlli section section 10 5 2 41a
bgpinvalid data exception	raised when it is not possible to instantiate a bgp packet with the given data
type low field	field used to retrieve "dynamically" the right sub-type dict
cell channel description hdr	cell channel description section 10 5 2 1b
group channel description hdr	group channel description section 10 5 2 14b
mac mode and channel coding request	mac mode and channel coding requested section 10 5 2 4a
call state hdr	call state section 10 5 4 6
rach control parameters hdr	rach control parameters section 10 5 2 29
field	for more informations on how this work please refer to http //www
ntpinfo if stats ipv4	interface statistics
cm service type	cm service type section 10 5 3 3
bgpcap orfblock packet list field	handles lists of bgpcaporfblocks
starting time hdr	starting time section 10 5 2 38
call state	call state section 10 5 4 6
tlsmsg list field	this is the actual content of the tls record as a tls record may pack
aspath segment packet list field	packetlistfield handling as_path segments
multi rate configuration	multirate configuration section 10 5 2 21aa
tlssignature field	used for 'digitally-signed struct' in several serverkeyexchange and also in certificateverify
h2frame	h2frame implements the frame structure as defined in rfc 7540 par4 1
ms network capability	ms network capability section 10 5 5 12
location updating type	location updating type section 10 5 3 5
ext comms packet list field	packetlistfield handling a list of extended communities
bgppaext comm opaque	packet handling the opaque extended community attribute value
aeadcipher metaclass	cipher classes are automatically registered through this metaclass
ntpinvalid data exception	raised when it is not possible to instantiate a ntp packet with the given data
hmacerror	raised when hmac verification fails
invalid encoding exception	invalidencodingexception is raised when a supposedly huffman-encoded
h2frame payload	h2framepayload is an empty class that is a super class of all scapy
tlscertificate url	defined in rfc 4366 pkipath structure of section 8 is not implemented yet
rand enum	instances evaluate to integer sampling without replacement from the given interval
mkadistributed sakparam set	distributed sak parameter set 802 1x-2010 section 11 11
si6rest octets	si 6 rest octets section 10 5 2 35a
ntpextension	packet handling a ntpv4 extension
bgppaas4path	provides an implementation of the as4_path attribute "value part"
channel needed	channel needed section 10 5 2 8
server pskparams	xxx we provide some parsing abilities for serverpskparams but the context operations have not been implemented yet
rr cause	rr cause section 10 5 2 31
tlsserver params field	this is a dispatcher for the server*dhparams below used in tlsserverkeyexchange and based on the key_exchange
bgpnlripacket list field	packetlistfield handling nlri fields
user user	user-user section 10 5 4 25
calling party subaddress	calling party subaddress section 10 5 4 10
frequency short list hdr	frequency short list section 10 5 2 14
mkapeer list tuple	live / potential peer list parameter sets tuples 802 1x-2010 section 11 11
ntpcontrol	packet handling ntp mode 6 / "control" messages
ntpinfo control	structure used to return statistics from the control module
bgppampunreach nlri	packet handling the mp_unreach_nlri attribute value for non ipv6 afi
entropy	the entropy of each byte of the packet data
hpack literal string	hpackliteralstring is a string this class is used as a marker and
cell channel description	cell channel description section 10 5 2 1b
generic cipher suite metaclass	cipher suite classes are automatically registered through this metaclass
xleshort field	xshortfield which value is encoded in little endian
eos	simple "marker" to designate the end of string symbol in the huffman table
bgpfield ipv6	ipv6 field cidr
cert maker	metaclass for cert creation it is not necessary as it was for the keys
hpack str len field	hpackstrlenfield is a strlenfield variant specialized for http/2 hpack this variant uses an internal representation that implements hpackstringsinterface
h2window update frame	h2windowupdateframe implements the rfc 7540 par6 9
facility	facility section 10 5 4 15
gre pptp	enhanced gre header used with pptp
raw console sink	print messages on low and high entries +-------+
tlsnew session ticket	xxx when knowing the right secret we should be able to read the ticket
time difference hdr	time difference section 10 5 2 41
ncc permitted	ncc permitted section 10 5 2 27
authentication parameter sres	authentication parameter sres section 10 5 3 2
h2padded data frame	h2dataframe implements rfc7540 par6 1
ia rest octets	ia rest octets section 10 5 2 16
triggered message	send a preloaded message when triggered and trigger in chain
cell description	cell description section 10 5 2 2
network info confirmation v10	network information confirmation following the mac management version 1 0
alerting pattern hdr	alerting pattern 10 5 4 26
fdsource sink	use a file descriptor as source and sink
ah	authentication header see https //tools
call control capabilities hdr	call control capabilities section 10 5 4 5a
bpf insn	"the bpf instruction data structure
follow on proceed	follow-on proceed section 10 5 3 7
clir suppression hdr	clir suppression section 10 5 4 11a
asn1cert len field	this is mostly a 3-byte fieldlenfield
update result	update result section 10 5 5 17
timing advance hdr	timing advance section 10 5 2 40
flags field	handle flag type field make sure all your flags have a label
gprs resumption	gprs resumption section 10 5 2 14c
mobile time difference	mobile time difference section 10 5 2 21a
igmpv3	igmp message class for v3
bgpcap graceful restart	this class provides an implementation of the graceful restart capability
tlsencrypted content	when the content of a tls record more precisely a tlsciphertext could not be deciphered we use this class to represent the encrypted data
tls ext npn	defined in rfc-draft-agl-tls-nextprotoneg-03 deprecated in favour of alpn
server ecdhexplicit char2params	xxx we provide parsing abilities for char2params but there is no 'cryptography' support hence no context operations
encrypted pre master secret	pay attention to implementation notes in section 7 4 7 1 of rfc 5246
neighbour cells description2hdr	neighbour cells description 2 section 10 5 2 22a
h2data frame	h2dataframe implements rfc7540 par6 1
redirecting party subaddress	redirecting party subaddress section 10 5 4 21c
quality of service	quality of service section 10 5 6 5
channel request description	channel request description section 10 5 2 8a
access point name	access point name section 10 5 6 1
conf	this object contains the configuration of scapy
tmsi ptmsi hdr	tmsi/p-tmsi section 10 5 2 42
ipv46	this class implements a dispatcher that is used to detect the ip version while parsing raw ip pcap files
setup container hdr	setup container $ ccbs $ section 10 5 4 22b
bgppaipv6address specific ext comm	provides an implementation of the ipv6 address specific extended community attribute
low layer compatibility hdr	low layer compatibility section 10 5 4 18
ms radio access capability	ms radio access capability section 10 5 5 12a
bgppaext comm redirect as4byte	packet handling the flowspec "redirect as-4byte" extended community
signal hdr	signal section 10 5 4 23
repeat indicator hdr	repeat indicator section 10 5 4 22
ciph key seq nr hdr	ciphering key sequence number section 10 5 1 2
hpack magic bit field	hpackmagicbitfield is a bitfield variant that cannot be assigned another value than the default one
cause	cause section 10 5 4 11
h2headers frame	h2headersframe implements rfc 7540 par6 2 headers frame
bgppath attr	provides an implementation of the path attributes
bgpcap generic	this class provides an implementation of a generic capability
avswlanheader	iwpriv eth1 set_prismhdr 1
channel request description hdr	channel request description section 10 5 2 8a
mkabasic param set	basic parameter set 802 1x-2010 section 11 11
pcap writer	a stream pcap writer with more control than wrpcap()
net	generate a list of ips from a network address or a name
eap fast	rfc 4851 - "the flexible authentication via secure tunneling
gprs resumption hdr	gprs resumption section 10 5 2 14c
pad field	add bytes after the proxified field so that it ends at the specified
wrpcap sink	packets received on low input are written to pca file
sig and hash algs len field	used in tls_ext_signaturealgorithms and tlscertificateresquest
mobile station classmark1	mobile station classmark 1 section 10 5 1 5
ntpclock status packet	packet handling the clock status fields
tlsclient key exchange	this class mostly works like tlsserverkeyexchange and its 'params' field
bgppaext comm traffic marking	packet handling the flowspec "traffic-marking" extended community
bgppampreach nlri	packet handling the mp_reach_nlri attribute value for non ipv6 afi
network info confirmation v11	network information confirmation following the mac management version 1 1
tls ext pretty packet list	dummy extension used for server_name/alpn/npn for a lighter representation the final field is showed as a 1-line list rather than as lots of packets
ss version indicator	ss version indicator section 10 5 4 24
bgpfield ipv4	ipv4 field cidr
comp null	the default and advised compression method for tls doing nothing
ntpinfo loop	loop filter variables
asn1f bit string encaps	we may emulate simple string encapsulation with explicit_tag=0x04 but we need a specific class for bit strings because of unused bits etc
raw pcap ng reader	a stateful pcapng reader each packet is returned as a
rr cause hdr	rr cause section 10 5 2 31
dedicated mode or tbf	dedicated mode or tbf section 10 5 2 25b
clihigh feeder	send messages from python command line to high output +--------+
redirecting party bcd number hdr	redirecting party bcd number section 10 5 4 21b
connected subaddress	connected subaddress section 10 5 4 14
eap md5	rfc 3748 - "extensible authentication protocol eap "
clir invocation	clir invocation section 10 5 4 11b
facility hdr	facility section 10 5 4 15
