managed	specifies managed additional lock font-lock-face mode variable font properties
hooks	none non-nil point-entered defined hooks holds list effect library disabled intangible point-left remove variable run property scanned unloading change functions
global	set mode-line-modes point global turned sequences table mode-independent abbrevs which-func-mode contains feature construct appears maps emacs input minor keyboard else completely moving variable line holds commands non-nil default value abbrev keymap mode
dynamic	files function set non-nil generates alist dynamic library libraries implementing loading external compiled byte compiler
obarray	use read obarray standard intern variable
themes	list value themes emacs variable loaded
executing	currently string macro contains executing vector keyboard variable defines
prefix	terminal-specific load set help (getenv continuation argument raw prefix displays file wrap previous use fill terminal-initialization holds next current start init emacs text print defines function used nil (concat may initialization wish specifies every warning’s key variable buffer-local line editing generate non-nil "term"))) follows term-file-prefix value filling command warnings (load loads non-continuation
gc	floating-point end garbage normal seconds contains number collection elapsed hook session emacs far time variable run total
query	holds useful questions keymap list multi-buffer save-buffers-kill-emacs map-y-or-n-p unsaved extends hook (if tells special defines functions replacements additional y-or-n-p query-replace it’s confirming asking kill-buffer arguments keybindings emacs save kill-emacs particular query-replace-map responses buffer use modified) user save-some-buffers variable killing save-buffers-kill-terminal standard well commands kill-buffer-query-functions non-nil calls valid similar perform-replace appearance calling without providing changes order history
alt	hyper super name respectively meta stand alt modifier keysym
adjustment	set non-nil completely point text move turned feature value properties returns command sequences variable moving check loop
saved	buffer-local buffer value current read length auto-saved variable last saved
environment	describing parent process variables holds list one environment started emacs inherited variable strings
init	files none loading run name nil normal user’s holds (site-start hook init used emacs—or file variable says absolute
program	function variable’s run value program listing directory insert-directory generate
spec	specifies kinds make character actually invisible variable properties
resources	non-nil look effect frames emacs new variable x resources creating
sound	sound functions list called playing
predicate	function passes variable’s file completing-read whether certain predicate value decide occasions try-completion backup called files
string	set mode-line-modes number session allocated total use which-func-mode holds feature construct call split-string minor string nil far attention separators else characters particular variable line appears default value mode arrow display
multi	replacements query-replace-map useful additional multi-buffer holds keybindings keymap extends variable providing
focus	run gains normal frame focus loses hook emacs input
reordering	non-nil default value bidirectional emacs reordering performs variable buffer-local display
nonascii	non-ascii non-nil unconditionally quoting unibyte backslash prin1 print printed characters sequences variable strings functions
entries	specifies buffer-local buffer list displayed tabulated entries variable
magic	variable’s elements like form alist magic-mode-alist value except (regexp auto-mode-alist file mode works specify handled
level	parentheses brackets maximum value depth nesting variable printed
lisp	used lisp abbrev mode table local
button	specifies bar around extra items tool width add variable shadow margin
list	specifies function variable’s set point defined variables entries displayed symbols hook including names file go expressions reverting buffers auto-save whose would overlay normal character tabulated current terminating don’t listing command minor files run string tables buffer newline undo sort finished regular key position variable buffer-local data insert commands entry non-nil name whenever list arrow value called recording prior abbrev values mode warnings format visited changes display
gensym	uninterned non-nil creating detection see printing symbols variable enables
p	non-nil working value binds variable revert-buffer
vector	session far cells number vector emacs allocated total
-1	function non-nil yank text command value yank-pop uses delete-region variable instead previous inserted delete
defaults	function default major set modes may text list use value fontify read-regexp regular mode determine variable expressions specify
dir	assigned modification associated nil settings ignored variables holds alist times symbols directory names file variable directory-local one local class
fold	case non-nil case-sensitive means whether font-lock-keywords controls imenu-generic-expression ignore default regular case-insensitive value variable expressions expression matching sake
insertion	specifies window-point marker see insertion variable type types
cursor	specifies right displayed logical echo looks message area selected controls bitmaps window type buffer showing mapping variable actual appears buffer-local fringe cursor
abbrevs	set non-nil altering except system abbrevs variable defining
current	name raw buffer holds argument current active prefix command variable input method
version	major associated keyword versions package alist mapping value number :package-version version emacs listed provides integer variable run minor
new	functions elements nil read list minibuffer value standard add don’t variable new history
method	specifies function supported non-nil name buffer holds value current active methods variable input method defines
body	run-mode-hooks hook run normal
full	nil lisp objects emacs nearly memory variable otherwise
mule	value language information buffer holds coding system construct environment current mode variable input line method displays
sexp	scanning functions non-nil like forward-sexp pay attention syntax text properties
objects	session far number miscellaneous objects allocated total
active	active variable non-nil mark
path	files load search loading says string found character image holds list variable’s value locations environment separates variable path directories
change	run-mode-hooks kill-all-local-variables scan previously lock frame existing hook determine font size functions unmodified holds window state call modification mode function run nil normal buffer else fontify reason every variable configuration change runs buffer-local anything whenever region changed list either time changes called
search	specifies says replace expressions next font-lock-keywords matching whitespace sake controls imenu-generic-expression function string means regular variable regexp case search non-nil case-sensitive calls perform-replace whether value ignore default case-insensitive expression
38	function non-nil yank text command value yank-pop uses delete-region variable instead previous inserted delete
handlers	whose use elements presently handlers alist holds list inhibited certain variable (major-mode operation
33	function non-nil yank text command value yank-pop uses delete-region variable instead previous inserted delete
items	bar defined menu global local maps items followed normally shows
31	function non-nil yank text command value yank-pop uses delete-region variable instead previous inserted delete
changed	set non-nil altering except system abbrevs variable defining
37	function non-nil yank text command value yank-pop uses delete-region variable instead previous inserted delete
36	function non-nil yank text command value yank-pop uses delete-region variable instead previous inserted delete
35	function non-nil yank text command value yank-pop uses delete-region variable instead previous inserted delete
34	function non-nil yank text command value yank-pop uses delete-region variable instead previous inserted delete
action	display-buffer value priority action variable highest treated display
debugger	function debugger invoke value call variable
extra	specifies managed extra lock font-lock-face keyboard font completion additional current lets used keys “press” variable properties specify programs lisp command mode modifier
replace	specifies useful list multi-buffer query-replace-map map-y-or-n-p replace special defines use replacements additional y-or-n-p query-replace holds next valid extends arguments keybindings function responses search user variable regexp string commands calls perform-replace well keymap providing similar history
vc	control buffer’s buffer-local whether kind records maintained version buffer file variable visited vc-mode
buttons	raised bar form items tool variable non-nil moves mouse display
use	functions property non-nil text hard filling variable delete newlines
positive	handle lisp value emacs largest variable integer
negative	handle lisp value smallest emacs variable integer
next	says debugger next funcall call eval apply variable non-nil
call	says debugger next funcall call eval apply variable non-nil
memory	nil lisp objects emacs nearly memory variable otherwise
encode	default table translation encoding
prev	function index non-nil scanning buffer point “definition” value next put variable backward finds
type	specifies subprocesses variable see warning asynchronous looks insertion marker message displaying selected system controls window emacs type symbol indicating used format buffer showing communicate running operating device types buffer-local window-point value cursor
start	use set abbrev-start-location start buffer expanded value expand-abbrev marker abbrev position variable integer next
minor	major certain variables number variable bindings (mode whose describing holds indicate version emacs allows override minor elements form may alist key particular active integer line association commands specify modes keymaps list according value values mode
more	specifies use menu character next ask see variable line
sort	specifies sort buffer list value tabulated current key variable
flag	determines immediately overriding-terminal-local-map menu make storage defun inhibit-quit emacs pure function unless quits variable non-nil copy definition overriding-local-map bar whether value affect display
glyphless	displayed char-table value glyphless characters variable defines
known	list value themes emacs variable loaded
resize	bar show defined tool larger height frame’s items—but variable non-nil quarter resizes automatically
must	completions completing-read local required value one keymap uses exact match
this	commands executed this-command name except value records see command editor variable remapping occurs loop
setup	body runs run normal whenever emacs-startup-hook text minibuffer with-output-to-temp-buffer terminal hook emacs evaluating initializing variable new entered similar
modified	value whether holds modified construct current buffer mode variable line displays
paragraph	move specified functions fill-paragraph assumed next paragraph way forward direction fill-region provides buffer symbol left-to-right override variable buffer-local paragraphs value filling right-to-left
values	commands returned read list minibuffer value standard values evaluated emacs variable including expressions buffers printed
unread	read holds list waiting command variable input events
history	variable’s features defined well variables library represented extended names loaded expressions provided functions form query-replace add complex don’t input shell arguments files elements nil file-name read evaluate alist standard regular new variable recent commands default expression required list minibuffer value lisp associates faces buffer-name similar history
interprogram	provides communicating programs text transferring system window way variable using killed
prompt	specifies use menu character next ask see variable line
process	specifies subprocesses poor stream process resulting coding subprocess variable reads asynchronous files information use describing network depending contains controls environment program emacs systems call input type mode status used blocks communicating read communicate potentially alist else running performance device remote line one data process-file buffer-local modes indicates whether list nothing specifying small output changes strings
lock	specifies comment major set managed scan text move back syntax m-o font-lock-face determine “top keywords table font font-lock-keywords matching based use font-lock-multiline additional font-lock-fontify-block syntactic sake holds outside comments either add multiline choose lock call fontification level” arguments function string nil means buffer constructs given fontify case-insensitive fontifying position variable buffer-local search-based refontification properties specify syntactically non-nil modes face region list value strings try range regular command mode enclosing unfontifying highlight element property expression called automatically point
substring	obsolete accept four hook single another whose functions end wrapper start call arguments function return string argument members variable filter-buffer-substring actual work list value fun delete
motion	ignore functions forward-paragraph run point-entered hooks boundaries effect forward-sentence motion field intangible including certain variable non-nil property forward-word point-left
end	function non-nil holds defun finding variable end
syntactic	function comment use non-nil string syntactic given face determine variable element
ascii	case table set ascii character
charset	set defined list character value names
feature	functions defined hooks holds list library scanned remove variable unloading
vscroll	large functions rows non-nil vertical presence modify taller display height images window line-move example variable position scroll-up scroll-down scroll automatically
delay	specifies seconds image cache displayed number remain without variable
gcs	garbage far contains number session collections emacs variable done total
pure	far bytes storage number value pure variable allocated
separator	search says string found directories holds character environment separates variable path
map	help text global spaces keyboard alternative `(menu-item replacements completing-read menu character except terminal extends tool-bar-map override input local multi-buffer match input-decode-map query-replace-map alist preferred :filter affect exact tool-bar-make-keymap)) bar like perform-replace follows keymaps list ignore mode sparse contain translated completions map-y-or-n-p value special describing c-h keys reading full responses emulation key active commands providing bar") ,(purecopy completing allows according turn keymap usually major useful "tool variables one unbinds simply names another sequences overriding-terminal-local-map bindings use additional y-or-n-p contains describes emacs keybindings translate minor function shell built-in tool overriding-local-map part particular actual interpretations non-nil default read-no-blanks-input alists binds future values sent following property similar display required certain dynamically minibuffer file spc defines holds maps valid instead ordinary events (global-set-key map used electric may filenames uses user characters tool-bar-make-keymap variable derives [tool-bar] buffer’s modes overlay well command read-shell-command
max	load used image maximum emacs variable define size
after	run-mode-hooks files (site-start determine point text frame abnormal argument one hook file font contents functions loading make-frame insert-file-contents holds init call lock modification scan inserting mode function run nil normal buffer number fontify characters variable buffer-local inserted beginning default region list modified creates revert-buffer-function either called
disable	set non-nil completely point text move turned feature value properties returns command sequences variable moving check loop
data	files documentation name certain holds directory emacs text variable come finds
annotation	variable function non-nil value
types	current supported image contains list symbols potentially formats variable configuration type
a	function non-nil yank text command value yank-pop uses delete-region variable instead previous inserted delete
purify	function definition determines whether make storage defun pure variable copy
lines	entire area resizes normally long echo message displaying display
alias	list holds alist maps names variable alternative property
switch	functions associated command-line alist user-defined handler variable options
fundamental	used words abbrev mode fundamental table local buffers
fallback	handled except auto-mode-alist magic-mode-alist mode file works specify like
tty	runs selected normal started driver holds character terminal hook erase emacs system’s variable new initializing text
help	specifies locally see help rebind prefix functions c-h holds character current help-char print local function used form read evaluate display key variable strings characters non-nil whenever inside minibuffer value called keymap following help-form
vars	defvar_bool variables holds list variable type
autoload	comment whose string calls lisp autoload value syntax go emacs names file variable
kbd	contains regardless defined caused terminate executing keyboard recently defines end currently terminates run string normal reaching ended variable definition non-nil hook macro vector error prematurely
disabled	variable function value
filters	functions return string list obsolete accept argument single value another variable
keyboard	translate keys programs lisp “press” lets terminal-local characters keyboard variable table modifier
interpreter	specifies major modes use command scripts variable interpreter line ‘#!’ specify
pointer	specifies variable’s mouse text frame use shape value element indicates yanking style kill mouse-sensitive emacs variable “front” ring ordinarily pointer
before	inserting list frame (site-start hook stored contents functions loading make-frame holds init call modification emacs variables files run file-local normal buffer variable immediately applying calls default file-local-variables-alist modified creates revert-buffer-function
24	function non-nil yank text command value yank-pop uses delete-region variable instead previous inserted delete
write	hooks file contents functions output rather except writing much call location input function intended buffer write-region coding-system-for-read particular variable write-file-functions buffer’s non-nil like pertain list value applies visited works called
26	function non-nil yank text command value yank-pop uses delete-region variable instead previous inserted delete
27	function non-nil yank text command value yank-pop uses delete-region variable instead previous inserted delete
20	function non-nil yank text command value yank-pop uses delete-region variable instead previous inserted delete
21	function non-nil yank text command value yank-pop uses delete-region variable instead previous inserted delete
22	function non-nil yank text command value yank-pop uses delete-region variable instead previous inserted delete
23	function non-nil yank text command value yank-pop uses delete-region variable instead previous inserted delete
regexps	expressions regular list
28	function non-nil yank text command value yank-pop uses delete-region variable instead previous inserted delete
29	function non-nil yank text command value yank-pop uses delete-region variable instead previous inserted delete
window	specifies taller presence existing restored frame startup displaying height hook see changes insertion window-state-get images saved tells marker size functions rows set-window-configuration parameters redisplaying holds system created process window window-system emacs types example scroll-other-window call get scroll-down type used run vertical normal buffer alist object modify standard window-state-put reason cannot every line-move programs variable buffer-local scroll-up configuration scrolling current-window-configuration change buffer’s non-nil window-point using called lisp emacs-startup-hook changed list normally value display large terminal-local specifying time position subsequently similar scroll automatically first
multiline	set font-lock-multiline lock constructs try property add multiline variable font automatically
fontification	functions holds list redisplay needed emacs variable called
split	default split-string separators value
auto	specifies files major vertical show defined format turned raised environments frame’s char hook names file images table expressions moves mouse happen fill auto-save large use rows form presence display auto-fill-function taller contains character window current auto-fill-chars run arguments example scroll-down function used corresponding invoke normal buffer auto tool newline modify self-inserted—space self-inserting regular line-move characters position variable non-nil scroll-up height association bar commands buffer-local name language whenever items larger list value auto-saving recording patterns items—but mode scroll quarter resizes called automatically functions
alist	variable’s system-specific stores supported dynamic subprocess symbols interpreter expressions completion whose (name except auto-mode-alist bitmaps window program systems override input styles format displayed alist scaling syntax association like name settings keymaps list user-defined fringes mode works ‘#!’ specifies right methods library (mode alternative describing network command-line libraries buffer provides current available processing implementing key active definition commands actual package fringe allows according :package-version streams faces options major variables coding logical one names table bindings use handled contains system imenu-generic-expression indicate handler emacs listed indicators type minor files corresponding form magic-mode-alist external (face particular line specify modifiers keyword versions value cursor values property associated defined certain (regexp file defines functions depending holds maps elements file-local may mapping running regular scripts variable class buffer-local modes element patterns command specifying keysym
separators	default split-string separators value
9	function non-nil yank text command value yank-pop uses delete-region variable instead previous inserted delete
effects	files remote whether indicates call variable changes process-file
not	functions file find-file-noselect list value nonexistent find-file passed variable called name
resource	specifies look instance x-get-resource application variable name
echo	run nil area whenever normal displayed controls echo cursor hook reason variable message appears cleared—either
term	terminal-specific load set non-nil nil (getenv (concat "term"))) follows initialization init value wish terminal-initialization may term-file-prefix emacs file (load variable loads
name	specifies function file-name-coding-system holds encoding process certain coding variable’s symbols names file operation buffer-name auto-save whose use loading described x-get-resource would visiting section contains system accepts current instance program emacs arguments assuming “pretty” files read-file-name used return presently nil tables buffer earlier buffer’s file-name invoked found variable non-nil major look definition search buffer-local name imenu-prev-index-position-function handlers leave list value auto-saving recording abbrev inhibited values mode faces visited history point
revert	specifies inserting list revert-buffer tabulated contents use working prior revert-buffer-function reverting function updated run normal buffer variable insert non-nil hook default revert modified value binds
events	generated received terminal—not macros read holds list number far waiting command keyboard variable input total counting events
fringes	appear text window fringes margins normally display
mode	variable’s show text displayed identify interpreter expressions whose which-func-mode except controls environment window override input local alist records words vc-mode association like runs name lisp keymaps list default mode identifies works ‘#!’ specifies set frame used value (mode overwrite describing communicating current may version method default-directory run emulation key active appears commands language allows according keymap control major subprocesses “pretty” variables emacsclient coding hook maintained auto-mode-alist frames table bindings use handled contains system construct indicate minor kill-all-local-variables corresponding form magic-mode-alist else particular remote line specify kind anything whether modified alists values visited (major-mode displays run-mode-hooks function mode-line-modes process certain (regexp file information holds buffers status elements normal buffer effect regular scripts variable buffer’s buffer-local modes patterns abbrev command fundamental
arrow	specifies use attention string nil indicates variables holds list feature value marker variable’s call arrow particular variable position line overlay display
debug	debugging condition-case set says debugger echo funcall displays apply message next matching errors area caught debug-on-message current call emacs status invoke never records regular eval variable non-nil normally command enter expression interactive
found	functions file find-file-noselect list value nonexistent find-file passed variable called name
side	files remote whether indicates call variable changes process-file
suffixes	files representations name indicate lisp list image alist mapping source extensions indicating file compiled variable emacs types suffixes
activate	run normal hooks mark inactive respectively active becomes
coding	specifies operations file-name-coding-system set saving stream subprocesses coding argument subprocess i/o variable names file decoding use applies network depending rather much encoding system writing window program and—on systems input reading except files used return format buffer synchronous write-region format-time-string alist else records running part x nothing non-nil like overriding buffer-local name coding-system-for-read buffer-file-coding-system messages value only—keyboard streams specifying error output works
series	begin programs bind next say warning series variable
hard	functions property non-nil text hard filling variable delete newlines
wrap	every non-nil start continuation wrap prefix emacs displays variable buffer-local line defines
used	operations files set name subprocesses far bytes storage coding system value number i/o used pure variable allocated
margins	appear text window fringes margins normally display
extract	function definition would non-nil name imenu-prev-index-position-function point value leave assuming variable return
event	program set sequence frame counting mouse event special holds terminal menus explicitly resulting events read records part key input variable directed last whether lisp keymap command loop
special	functions defined hooks holds list remove library keymap unloading variable scanned events special
out	run normal frame focus loses hook emacs input
category	specifies property symbol character char-table value char-tables see unicode variable general_category
network	specifies use network coding alist system streams variable
rep	indicate representations list file suffixes
re	specifies function search calls perform-replace next variable regexp replace
7	function non-nil yank text command value yank-pop uses delete-region variable instead previous inserted delete
print	abbreviated quoted list backslash used syntax detection see ‘\f’ sequences elements functions brackets holds feature forms printing formfeeds reader print shared across nesting circular internally non-ascii newline creating means unibyte print-circle number printed characters bool-vector variable using structure symbols parentheses non-nil calls unconditionally quoting ‘\n’ multibyte maximum value prin1 uninterned depth vector continuously implement enables strings e
adaptive	poor blocks resulting read potentially subprocess reads emacs systems performance small output data
resume	runs normal hook emacs suspension variable resuming
args	command-line list value emacs arguments passed variable yet processed
undo	variable’s text previous current yank-pop instead function nil buffer undo uses variable non-nil inserted commands buffer-local bind list value command delete-region yank normally delete
standard	stream encoding defined argument table displaying functions holds decoding read window emacs print input neither used nil buffer use standard uses variable translation default value output display stream—the
cookie	comment whose string lisp value syntax variable
emulation	use modes holds list alists keymap emulation variable
backed	buffer’s says whether account backed buffer file variable buffer-local
byte	function set ignored list variables dynamic null detecting string loading defvar_bool holds type files generates compiled variable byte compiler non-nil region bytes value encoding
beginning	function move non-nil point holds defun comments back strings finding outside syntactically “top variable position beginning level”
generate	comment whose string lisp value syntax variable
indent	function variable’s used indent cut commands value current variable short various indentation indent-for-tab-command line indent-region
messages	specifies generating locale messages use system error variable
filter	function whose functions delete actual start work obsolete value four hook accept call wrapper members variable end fun filter-buffer-substring arguments
length	elements list maximum value number print vector bool-vector variable
iso	ignored non-nil string encoding region escape value iso-2022 sequences variable detecting
first	run whenever normal buffer unmodified changed previously hook state variable
major	function kill-all-local-variables runs run run-mode-hooks anything normal major else hook version emacs integer number
suspend	runs normal suspending hook emacs suspension variable resuming
features	current features list value symbols session emacs variable loaded
variables	ignored list variables hook stored expressions given nil holds emacs local files directory-local finishes file-local alist regular variable immediately applying calls settings file-local-variables-alist values buffer-local
misc	session far number miscellaneous objects allocated total
number	internally used buffer-local nil buffer holds number nonexistent feature current directory vector device print-circle file variable visited printing implement
blink	function whenever character value syntax arguments parenthesis variable close inserted called
hook	caused terminate focus existing ended stored including questions keyboard with-output-to-temp-buffer loading menu suspending actually terminal init going kill-buffer initializing input gains kills every immediately runs bar emacs-startup-hook list loses mark inactive executes cleared—either function inserting frame happen errors nil make-frame displaying normal state asking new quitting kill-emacs run reaching respectively killing reason hooks ask configuration change commands anything changed file-local-variables-alist minibuffer creates prior changes exited regardless garbage previously variables (site-start echo hook message reverting auto-save terminated area redisplaying unmodified window tabulated emacs editor terminates entered kill-all-local-variables finishes becomes body delayed else suspension line active handling applying default modified evaluating error prematurely similar display loop run-mode-hooks files process contents redisplay end post-command-hook arguments resuming text temporary file-local warnings buffer update collection variable calls whenever macro revert-buffer-function command time order
done	garbage far contains number session collections emacs variable done total
message	matching entire set debugger area resizes normally long echo regular emacs expression enter message debug-on-message displaying display displays
size	load image saved size functions displaying holds current read window emacs define used buffer reason cannot auto-saved variable last buffer-local non-nil changed list maximum value length normally changes called
script	specifies whose code blocks name classification script symbol space character char-table value according belongs unicode variable script-specific standard
system	operations variable’s system-specific synchronous subprocess i/o displaying much except writing window program systems input indicating return string format alist records using name overriding like lisp only—keyboard terminal-local x works specifies set locale frame startup network decoding reading write-region error standard coding-system-for-read operating output configuration created messages streams first hardware/software file-name-coding-system saving encoding coding one nothing names use system window-system emacs type files generating format-time-string else part non-nil gnu buffer-file-coding-system value formatting values applies subprocesses stream argument file tells depending rather holds and—on used buffer symbol running variable buffer-local programs element specifying time keysym
2	function non-nil yank text command value yank-pop uses delete-region variable instead previous inserted delete
final	bar defined menu global local maps items followed normally shows
buffering	poor blocks resulting read potentially subprocess reads emacs systems performance small output data
shell	commands shell names completing list used keymap command arguments file part read-shell-command history
tool	specifies raised "tool show defined dynamically global height items area moves `(menu-item binds frame’s mouse border extra width add tool-bar-map drawn (global-set-key function map around form tool non-nil :filter tool-bar-make-keymap variable bar shadow derives [tool-bar] tool-bar-make-keymap)) actual ,(purecopy default follows larger value ignore turn items—but bar") margin quarter resizes display automatically
continuous	non-nil calls means number print continuously across
repeatable	executed recently part command input variable stores event
translation	input-decode-map used like encoding default self-inserting decoding translated keymap another table variable input translation translate inserted events characters
11	function non-nil yank text command value yank-pop uses delete-region variable instead previous inserted delete
10	function non-nil yank text command value yank-pop uses delete-region variable instead previous inserted delete
13	function non-nil yank text command value yank-pop uses delete-region variable instead previous inserted delete
12	function non-nil yank text command value yank-pop uses delete-region variable instead previous inserted delete
15	function non-nil yank text command value yank-pop uses delete-region variable instead previous inserted delete
14	function non-nil yank text command value yank-pop uses delete-region variable instead previous inserted delete
17	function non-nil yank text command value yank-pop uses delete-region variable instead previous inserted delete
16	function non-nil yank text command value yank-pop uses delete-region variable instead previous inserted delete
19	function non-nil yank text command value yank-pop uses delete-region variable instead previous inserted delete
18	function non-nil yank text command value yank-pop uses delete-region variable instead previous inserted delete
alists	use modes holds list alists keymap emulation variable
future	full electric keymap value used command mode variable future
stale	specifies function needs whether value reverting buffer call variable check
pre	function redisplay run normal hook command editor executes loop
register	variable (name elements alist form
remapping	whose elements form alist value (face variable
null	ignored non-nil string encoding region bytes value variable detecting null
border	specifies bar area tool height variable drawn border
contents	specifies function use like insert buffer hooks pertain buffer’s updated value reverting write-file-functions location file particular variable visited works contents intended
without	it’s non-nil buffer save-buffers-kill-emacs modified) save-some-buffers without asking (if particular variable save tells user
build	built value indicates emacs time variable
overwrite	whether effect controls mode variable overwrite
begin	function nil—in parser non-nil string buffer equivalent earlier outside comment state words parenthesis position moves
printer	function insert point newline value terminating including variable entry called
multiple	variable set emacs automatically
electric	full electric keymap value used command mode variable future
warnings	run post-command-hook warnings process list normal displayed delayed value display current hook finished command variable emacs order loop
buffer	variable’s text save-buffers-kill-emacs displayed four questions saved whose it’s character desktop window going device save updated return string format read alist records insert overriding name list save-some-buffers unfontifying identifies specifies abbreviated set says (if revert obsolete displaying truename elements abbrev-start-location buffers visiting with-output-to-temp-buffer temporary current state asking scroll-other-window symbol body run nonexistent killing undo members buffer-name invisible filter-buffer-substring properties kill-buffer-query-functions actual ask times length action history changes automatically user saving display-buffer coding number hook another table writing read-only use working contains system wrapper priority start confirming call kill-buffer function unsaved part particular last highest account non-nil whether buffer-file-coding-system appearance value binds evaluating fun visited (major-mode property treated display delete computing argument accept states single file revert-buffer work tells contents functions end make holds check arguments used kinds nil normal buffer reverting write-region needs auto-saving fontifying auto-saved variable modified) buffer’s buffer-local calls whenever actually backed scroll without time directory order
chars	specifies number environments char session table allocated total self-inserted—space auto-fill-function character char-table far string invoke printable newline characters variable language whether value
most	handle lisp value smallest emacs largest variable integer
position	function index holds non-nil scanning buffer mouse-position point “definition” overlay value next indicates put display call arrow variable backward finds marker
class	specifies associated name settings holds alist x-get-resource symbols application variable class look
icon	specifies compute name title iconified frame explicitly specified variable
doc	functions contains name variables holds built-in "doc" directory preloaded file contain variable strings documentation
clear	run nil area whenever normal echo hook reason message cleared—either
face	specifies comment certain determine element whose use syntactic arguments function elements string form alist given scaling (face variable non-nil list value face faces history
abbrev	set text mode-specific symbols used marker table (mode buffers mode-independent whose use expand-abbrev next current start call location abbrev-symbol arguments function elements abbrev-start-location form tables buffer conversion expansion words variable integer exact recent case abbreviation buffer-local lisp local expanded list value abbrevs abbrev values mode fundamental position
nonsticky	rear-stickiness default text holds alist various variable properties defines
yank	function variable’s non-nil yank-pop text delete-region uses command value element indicates yanking kill instead variable “front” ring previous inserted yank delete
show	specifies function non-nil help normal buffer displaying strings temporary display hook variable run with-output-to-temp-buffer called
text	specifies rear-stickiness read-from-minibuffer text minibuffer shape including strip table mouse defines read-string conversion giving pointer holds boundaries field various certain input local used nil returning alist use expansion variable ignore forward-sentence exact properties recent case forward-paragraph non-nil default expanded list mouse-sensitive motion abbrev values mode property forward-word functions
syntax	nil—in comment code regardless words point constituents parser abnormal back syntax hook “top table moves syntax-propertize-function string move use stretch holds specified outside comments imenu-generic-expression current state text override fontification equivalent store function non-ascii earlier run says buffer symbol processing alist syntax-table characters position variable applying parsing properties modifiers non-nil treats calling level” prior syntactically parenthesis scan-sexps strings
spaces	search says whitespace regular variable non-nil expression
hack	applying calls file-local variables file-local-variables-alist hook stored emacs immediately finishes
keywords	non-nil case-insensitive search-based means sake font-lock-keywords syntactic list value keywords regular lock variable highlight based font expression matching fontification
font	specifies comment major set managed scan text move back syntax certain m-o font-lock-face determine “top keywords table font font-lock-keywords matching based use font-lock-multiline additional font-lock-fontify-block syntactic sake holds outside comments either add multiline arguments lock call fontification level” choose function string nil means buffer enclosing constructs given scaling case-insensitive fontifying position variable buffer-local search-based refontification properties specify syntactically fontify non-nil modes face region list value strings try range regular command mode faces unfontifying highlight element property expression called automatically point
find	functions set buffer-local file visiting buffer literally find-file-noselect list value nonexistent behave find-file passed variable non-nil save-buffer makes called name
completion	available variable’s stores completions point text abnormal one unbinds confirmation simply spaces try-completion table expressions spc completion passes functions asks binds extra current emacs compute local checks match function predicate used filenames regular uses significant variable determines exact properties specify case non-nil completing-read minibuffer-complete-and-exit hook considered completing required list minibuffer value exiting whether keymap command sparse contain styles
access	functions used non-nil name computing text symbol holds list variable’s value variable property properties
indicator	specifies buffer-local fringe displayed mapping logical bitmaps indicators window fringes variable actual
parameters	specifies inherits currently process frame window-state-get saved functions set-window-configuration parameters selected window window-state-put newly get alist standard variable current-window-configuration non-nil created list specifying subsequently restored
title	specifies compute name title iconified frame one explicitly specified variable
menu	specifies followed defined global ask see affect overriding-terminal-local-map contents use menu character next maps local shows run normal redisplay update variable non-nil line overriding-local-map bar hook items value redisplaying normally display
cache	specifies holds associated variables displayed number one assigned names file cache modification local image seconds alist variable class times remain without directory
3	function non-nil yank text command value yank-pop uses delete-region variable instead previous inserted delete
terminal	buffer’s use keymaps non-nil overlay text holds abnormal overriding-local-map hook keymap run mode variable instead delete-terminal property local minor
only	specifies actual buffer-local may search-based depending whether lock syntactic modified value buffer font-lock-keywords buffers characters variable non-nil font fontification read-only based
inherited	specifies inherits selected parameters created frame currently list variable newly
invocation	executable invoked name nil holds directory program emacs cannot variable determined
8	function non-nil yank text command value yank-pop uses delete-region variable instead previous inserted delete
circle	reading non-nil detection printing variable shared enables structures structure circular
local	text abbreviation spaces affect expressions completing-read menu except local match input-decode-map directory-local alist preferred immediately exact bar settings keymaps list stored mode sparse contain translated ignored read-no-blanks-input completions built-in alternative nil overlay current reading given key unbinds interpretations completing file-local-variables-alist minibuffer keymap usually variables one hook simply names sequences overriding-terminal-local-map table use describes emacs minor function shell finishes buffer’s part applying default non-nil mode-specific value values property similar display files file spc holds instead used file-local buffer filenames regular uses variable overriding-local-map buffer-local calls required command read-shell-command
info	value language information buffer holds coding system construct environment current mode variable input line method displays
original	commands this-command except value see command remapping occurs
symbols	far number symbols session emacs allocated total
bar	specifies bars followed "tool follows defined dynamically global raised height hook turn `(menu-item buffers redisplay derives bar") width redisplaying border extra moves maps add contents tool-bar-map [tool-bar] drawn local shows function map run around form normal tool non-nil update :filter tool-bar-make-keymap variable actual shadow items measured pixels tool-bar-make-keymap)) buffer’s bar ,(purecopy default always area value display ignore binds menu margin mouse (global-set-key normally scroll
bytes	far bytes storage number value pure variable allocated
unfontify	function unfontifying use buffer region
processed	variable line command processed value
x	specifies hyper text frame mouse-sensitive shape style frames alt mouse use application pointer instance emacs new resources creating respectively effect variable super look non-nil name ordinarily x-get-resource meta stand x modifier keysym
fixed	non-nil buffer normally changed window cannot variable buffer-local displaying size
ignored	files given variables holds list values variable local
bars	bar show defined tool larger height frame’s items—but variable non-nil quarter resizes automatically
propertize	function code non-nil prior stretch text calling abnormal syntax-table syntax hook run syntax-propertize-function specified variable applying parsing properties store
locale	specifies encoding locale coding argument use system decoding window time input and—on generating return format format-time-string variable messages value only—keyboard formatting values error x
frame	specifies inherits selected frame abnormal one hook specified event use parameters make-frame currently current window explicitly input newly run normal records variable compute directed last name created default list minibuffer creates identifies
startup	handling run normal hook command arguments line
detection	ignored non-nil string encoding region sequences bytes value iso-2022 escape variable detecting null
num	keyboard received variable’s terminal—not far holds number value macros generated session emacs processed key sequences variable input total counting events
arg	used holds argument value next current raw prefix command variable editing previous
locals	assigned modification associated settings variables holds alist times symbols directory names file variable one local class
deactivate	non-nil enabled mark returns transient command editor sets variable deactivates loop mode
lexical	files instead non-nil lisp dynamic lexical binding evaluated emacs using variable buffer-local buffers
filename	spaces filenames keymap simply sparse contain unbinds spc
outside	appear text window fringes margins normally display
identification	buffer frame displayed current window variable identifies
props	specifies managed additional lock font-lock-face mode variable font properties
progress	commands loading non-nil working nil binds process bind value revert-buffer emacs undo file variable normally otherwise
extend	code scan lock abnormal syntax hook determine font syntax-propertize-function call mode function run nil fontify variable parsing buffer-local region calling prior either
25	function non-nil yank text command value yank-pop uses delete-region variable instead previous inserted delete
nonmacro	received terminal—not far holds number macros generated keyboard variable input total counting events
printable	specifies whether character char-table value printable variable
key	specifies variable’s system-specific one another sequences alternative holds except tabulated current describes input translate events sort input-decode-map used buffer alist preferred usually key variable interpretations like keysym list value element keymap translated similar
nonmenu	last sequence read holds events menus part resulting key variable input counting mouse event
floats	far number session emacs allocated total floats
commands	require-match commands confirmation confirm-after-completion completing-read argument holds list minibuffer exiting ask emacs variable cause
last	operations files executed stores sequence defined text frame coding argument one i/o raw prefix set keyboard recently counting mouse event previous terminal conversion holds system current menus explicitly emacs location input recent abbrev-symbol events resulting directed program used altered read never expansion last-command records part key variable exact like case definition last name programs lisp macro expanded value whether abbrev command subprocesses loop
region	code scan lock abnormal syntax hook determine font syntax-propertize-function functions cut call mode function used run nil write-region use fontify fontifying variable buffer-local parsing indent-region short non-nil region list value calling prior either unfontifying
minibuffer	specifies shell variable’s locally whenever completions read-from-minibuffer read-string frame names built-in argument one rebind ask see confirmation simply spaces file strip try-completion table spc help completion passes functions asks completing holds window current default run emacs text input entered reading cause checks match function require-match predicate used confirm-after-completion help-form nil normal unbinds object use filenames part uses variable non-nil returning exact properties read-no-blanks-input commands determines completing-read minibuffer-complete-and-exit hook whether local inside required list minibuffer value exiting binds keymap command sparse contain read-shell-command exited history
sensitive	specifies use mouse mouse-sensitive shape text variable pointer
consed	vector cons string objects far cells number intervals miscellaneous symbols session emacs characters allocated total strings floats
selective	variable enables buffer-local display selective
exec	gnu string invoke programs intended contains value directory emacs variable come name
expression	specifies imenu non-nil lisp evaluate list finding regular arguments variable definitions expressions history
load	specifies function variable’s features process well image abnormal locations library hook associates names file loaded indicate provided use loading described source section alternate load eval-region defined emacs instead variables indicating files expression-reading run nil read compiled earlier alist functions variable representations search non-nil name lisp directories required list value found suffixes otherwise
bell	specifies emacs bell” non-nil “ring
connection	subprocesses used communicate controls device asynchronous variable type
header	specifies buffer displaying header every windows variable line local display
eviction	specifies seconds image cache displayed number remain without variable
table	code text char-table symbols unicode keyboard displaying completion whose character window belongs script-specific local columns words syntax abbreviation internally name lisp list vector terminal-local mode translated specifies set see elements (mode buffers glyph space abbrevs comments decoding current neither tables screen char-tables print-circle standard general_category minibuffer implement automatically classification encoding table use script occupy emacs translate form translation case non-nil default fontification mode-specific value printing values property display defined according ascii mode-independent holds feature used blocks buffer symbol self-inserting characters variable inserted buffer’s buffer-local strings abbrev fundamental width
quit	quit determines set unless nil quit-flag whether quits value inhibit-quit emacs immediately variable non-nil
configuration	hardware/software run name gnu existing frame holds system standard hook window every normal time variable configuration change string
raise	raised bar form items tool variable non-nil moves mouse display
create	specifies function use creating index buffer variable
mark	text active m-o inactive saved deactivates font-lock-fontify-block arguments mark current list returns editor hooks marks choose function run normal buffer respectively enclosing transient variable buffer-local refontification former becomes recent non-nil enabled value range command mode sets called loop first
pi	mathematical (3 pi constant
4	function non-nil yank text command value yank-pop uses delete-region variable instead previous inserted delete
direction	direction buffer-local buffer assumed symbol left-to-right specified value right-to-left paragraphs variable
enable	function ignored variable’s directory-local file nil whether certain variables buffer’s value current text decide occasions variable representation specifies backup called files
39	function non-nil yank text command value yank-pop uses delete-region variable instead previous inserted delete
installation	subdirectories lib-src non-nil look within etc directory
case	set table expressions ascii matching completion sake font-lock-keywords character controls imenu-generic-expression default means regular significant variable case non-nil case-sensitive considered value ignore whether case-insensitive expression
inhibit	ignored set point-entered encoding hooks escape forward-sentence disabled intangible including sequences frames expressions null operation read-only presently whose use depending holds boundaries field iso-2022 emacs buffers certain quit-flag ignore resources creating run string nil quit may effect bytes regular characters new variable determines detecting change actual none forward-paragraph non-nil look handlers whether region list modified value motion inhibited x property forward-word point-left functions
defining	variable macro defined non-nil keyboard
compile	files function set non-nil generates compiled dynamic loading byte compiler
error	specifies function use errors non-nil command return control emacs variable handle loop
property	rear-stickiness variable’s used non-nil name default list symbol holds alist value maps various names text variable alternative property properties defines
margin	specifies right bar around extra items tool character units cell width add variable (a margin left
styles	available styles stores completion list variable
cons	cons far cells number session emacs allocated total
binding	files instead non-nil lisp dynamic lexical binding evaluated emacs using variable buffer-local buffers
parse	scanning functions non-nil like forward-sexp pay attention syntax text properties
in	process frame displayed focus echo hook file message loading working area controls emacs input run gains nil normal undo variable appears commands non-nil normally value cursor binds bind revert-buffer otherwise
mouse	function non-nil value mouse-position call variable
ring	specifies variable’s text indicates kill sequences ring saved holds former current emacs marks recent recently buffer bell” yanking variable buffer-local killed “front” “ring non-nil list value element first
redisplay	function redisplay run
generic	specifies imenu non-nil list finding regular variable definitions expressions
make	run normal make-frame frame abnormal creates hook
defun	function non-nil holds defun finding variable end beginning
1	function non-nil yank text command value yank-pop uses delete-region variable instead previous inserted delete
fixnum	handle lisp value smallest emacs largest variable integer
modification	none non-nil hooks disabled variable run change
fontified	variable’s used non-nil name text symbol value property
status	status debugging current records command variable interactive
extended	commands extended list names history arguments
keys	variable’s far number value session emacs processed key sequences
levels	severity list levels meaning warning order defines
user	files none holds says name nil user’s init used emacs—or file variable absolute
characters	specifies buffer’s text current variable representation
expand	function expand-abbrev value expansion call arguments variable
macro	contains regardless defined caused terminate executing keyboard recently defines end currently terminates run string normal reaching ended variable definition non-nil hook macro vector error prematurely
client	variable frames used identify emacsclient
command	variable’s executed stores help prefix executes yet previous except input unrecognized return read evaluate alist records name like lisp list user-defined quitting processed including specifies set see extended run event errors command-line current waiting print occurs recently never key represented commands last completing keymap interactive options one hook names terminated use this-command handler emacs editor passed function shell form part line handling non-nil value prematurely loop history control debugging associated argument file handle remapping functions holds complex arguments events status used altered normal last-command variable recent programs command read-shell-command
relief	specifies bar items tool width variable shadow
termination	error run prematurely normal macro reaching terminate ended end hook caused terminates keyboard regardless
keysym	hyper super name respectively meta stand alt modifier keysym
left	specifies (a non-nil command-line character fringe list value pixels cell width arguments variable left margin yet processed
quoted	abbreviated non-nil quoted means syntax forms reader print using e
numbering	non-nil calls means number print continuously across
shape	specifies use text frame ordinarily mouse-sensitive shape style emacs variable mouse pointer
intervals	session far number intervals emacs allocated total
kill	variable’s text save-buffers-kill-terminal unsaved indicates kill questions sequences appearance ring calling functions holds run actually confirming asking kill-buffer arguments emacs kill-emacs recently kills normal buffer ask killing yanking variable “front” standard killed going kill-buffer-query-functions calls hook list value element changes order first
unicode	specifies property symbol character char-table value char-tables see unicode variable general_category
32	function non-nil yank text command value yank-pop uses delete-region variable instead previous inserted delete
newlines	functions property non-nil text hard ‘\n’ newline filling ‘\f’ formfeeds printed characters variable delete strings newlines
cut	provides communicating text programs system window way variable using killed
point	specifies set point-entered point text move abnormal hook see intangible insertion sequences marker table check completion functions feature returns hooks type used run turned effect completely moving variable compute properties types non-nil window-point completing list value command point-left property loop
desktop	elements non-nil buffer alist desktop state file variable buffer-local (major-mode save saved
add	functions elements nil read list minibuffer value standard add don’t variable new history
location	use set abbrev-start-location start buffer expanded value expand-abbrev marker abbrev location position variable integer next recent
allow	read-from-minibuffer nil read-string text returning minibuffer strip variable input properties
input	specifies program variable’s methods stream supported argument active session sequences keyboard total event defines current functions terminal—not keys macros describes holds character terminal buffer add explicitly emacs don’t input lisp method sent function elements inserted nil read translated self-inserting number records generated part uses key new variable non-nil translation standard table ordinary received characters last name default list minibuffer value events whether keymap command processed far history counting stream—the
save	specifies it’s saving (if save-buffers-kill-emacs coding hook via names file happen saved tells auto-save use format system emacs-save-session-functions desktop current state asking emacs save supports files used run normal buffer modified) user particular variable non-nil overriding buffer-local name whenever buffer-file-coding-system auto-saving recording save-some-buffers without called
match	completions completing-read local required value one keymap uses exact match
real	set altered like programs lisp never last-command emacs variable
format	specifies defined frame one states header warning numbers file specified message displaying use type title contains tabulated explicitly buffer-local print local image format buffer alist mapping every variable floating-point line data types definition compute name windows iconified list auto-saving extensions visited display
read	specifies load poor file eval-region accepts coding subprocess performance reads may expressions read-only use buffers completing-read depending alternate system actually buffer emacs arguments read-file-name determine shared reading structures circular function expression-reading blocks default read evaluate potentially systems synchronous regular characters instead variable buffer-local data must actual non-nil input read-regexp lisp work list modified value whether resulting small output enables called history
elapsed	floating-point garbage seconds contains number collection elapsed far session emacs time variable total
30	function non-nil yank text command value yank-pop uses delete-region variable instead previous inserted delete
insert	specifies variable’s point text argument one contents use insert-file-contents inserted reverting program listing insert-directory function updated run buffer number characters variable beginning generate insert list value directory called
overriding	major text display-buffer overriding-terminal-local-map bindings use overlay menu holds priority override instead local minor overriding-local-map key particular variable affect highest bar buffer’s non-nil modes keymaps allows value keymap mode action property treated display
d	function non-nil yank text command value yank-pop uses delete-region variable instead previous inserted delete
signal	condition-case errors debugger invoke caught never normally
ignore	case completion functions non-nil parameters considered value standard process window significant variable
boolean	defvar_bool variables holds list variable type
output	specifies floating-point functions nil stream default use value argument print numbers variable output stream—the
right	specifies right non-nil fringe character units cell width variable margin pixels
play	sound functions list called playing
library	files alist dynamic library libraries implementing external
truename	abbreviated buffer-local nil buffer holds current truename file variable visited
erase	selected started driver holds character terminal erase emacs system’s variable
escape	ignored encoding sequences backslash ‘\f’ escape functions iso-2022 formfeeds print quoting non-ascii unibyte string newline printed characters variable detecting non-nil unconditionally region ‘\n’ multibyte value prin1 strings
5	function non-nil yank text command value yank-pop uses delete-region variable instead previous inserted delete
glyph	non-nil value current variable table glyph
for	specifies encoding synchronous subprocess file table use rather system decoding much input reading except coding self-inserting coding-system-for-read characters variable translation inserted non-nil like default applies translated output works
confirm	argument ask require-match completing-read holds emacs cause checks function confirmation confirm-after-completion variable commands determines asks minibuffer-complete-and-exit whether list minibuffer value exiting binds
literally	set non-nil visiting buffer literally value behave save-buffer file variable buffer-local makes
normal	specifies function use auto-fill-function auto turned variable fill
customize	associated keyword versions package alist mapping :package-version emacs listed provides
exit	require-match commands confirmation confirm-after-completion whenever completing-read normal argument holds list minibuffer exiting ask exited emacs variable run cause hook
rescale	variable specifies scaling faces certain
regexp	function default search non-nil whitespace may list use value read-regexp regular arguments determine variable says expressions expression history
post	function terminated commands errors run garbage normal non-nil end including collection hook command editor prematurely variable executes value quitting loop
paste	provides programs text transferring system window way variable using killed
properties	scanning extra forward-sexp text syntax strip completion read-string functions read-from-minibuffer giving pay holds current values used nil returning attention input variable properties specify non-nil like default list minibuffer command property
8.4	function non-nil yank text command value yank-pop uses delete-region variable instead previous inserted delete
session	via saving emacs-save-session-functions hook state emacs supports called
on	condition-case set says debugger echo funcall displays apply message next matching errors area caught debug-on-message call emacs invoke never regular eval variable non-nil normally enter expression
package	associated keyword versions package alist mapping :package-version emacs listed provides
of	function move non-nil point “top holds defun comments back strings finding outside syntactically position variable end beginning level”
completing	function completing-read work value actually variable called must
fringe	specifies right actual width non-nil fringe displayed mapping logical bitmaps cursor indicators window fringes variable buffer-local type pixels left
multibyte	specifies regardless constituents backslash syntax sequences table functions current text print non-ascii says symbol printed characters representation variable buffer’s non-nil treats unconditionally quoting multibyte strings scan-sexps prin1
backup	function files variable’s non-nil file whether certain value inhibited decide occasions variable backups backup called
block	function non-nil font-lock-fontify-block text m-o range command choose enclosing variable refontification called arguments
image	specifies load variable’s cache image supported displayed number symbols file size contains current potentially emacs type define files used seconds alist mapping locations variable configuration types search name list maximum value remain without extensions formats
float	mathematical specifies e floating-point (2 (3 print numbers variable constant pi
annotate	call functions list write-region
frames	variable set emacs automatically
tabulated	specifies sort point displayed hook including reverting normal tabulated current terminating function run format buffer newline key entries variable data insert buffer-local list value prior entry called
area	run nil area whenever normal displayed controls echo cursor hook reason variable message appears cleared—either
initial	used parent created process startup variables holds list value environment started window-system emacs inherited variable frame first
custom	list value themes emacs variable loaded
decode	function keymap keys holds character decoding terminal default describes sequences variable table ordinary translation sent
width	specifies bars right (a buffers width character char-table cell occupy units local columns screen variable measured pixels buffer’s non-nil always fringe value margin scroll left
emacs	major via associated version number indicates hook questions saving functions built holds emacs-save-session-functions state asking emacs listed provides supports minor arguments kill-emacs run kills normal alist mapping killing variable integer line standard save-buffers-kill-terminal handling name keyword versions package value calling :package-version command time calls called
invisibility	specifies kinds make character actually invisible variable properties
forward	functions fill-region provides fill-paragraph move forward override filling paragraph way variable next
paren	function whenever character value syntax arguments parenthesis variable close inserted called
translate	terminal-local characters keyboard variable table translate
function	comment variable’s help text move syntax mouse-position prefix expressions font previous cut completing-read alternate character outside actually yank-pop window choose override input updated return string read auto preferred words using killed insert name perform-replace interpretations revert leave default filling either enclosing unfontifying specifies scanning list back used paragraphs close read-regexp alternative index errors font-lock-fontify-block auto-fill-function warnings comments current may state various provides assuming method mode run creating equivalent delete-region given expansion translated syntax-table key element put regexp beginning properties “ring definition commands actual imenu-prev-index-position-function region accepts display stretch range regular indentation usually finds load nil—in point applying replace specified indent-for-tab-command determine sequences table reverting use would expand-abbrev filter-buffer-substring system next describes call way read-file-name forward emacs store function fill-region transferring search fontify indent line refontification must auto-fill-chars non-nil whether work “definition” value paragraph syntactically similar called loop delete control generate scan eval-region lock parser turned input-decode-map needs m-o “top handle moves check contents fill redisplay end syntactic holds defun keymap arguments finding instead level” expression-reading nil communicating buffer earlier functions self-inserting bell” fontifying uses variable inserted indent-region short buffer-local calls programs whenever except face fill-paragraph command parenthesis position backward strings yank
form	rebind functions used non-nil help form whenever evaluate inside locally character minibuffer value current read see help-char variable help-form
6	function non-nil yank text command value yank-pop uses delete-region variable instead previous inserted delete
delayed	run post-command-hook warnings process list normal displayed delayed value display current hook finished command variable emacs order loop
fontify	function functions computing buffer text region holds list use fontifying variable properties
e	mathematical function e yank (2 text delete-region command value yank-pop uses instead variable non-nil constant previous inserted delete
line	specifies default-directory variable’s contains show process frame coding argument mode indent-for-tab-command header prefix identify displays frames displaying yet defines information functions command-line function holds system construct environment start window emacs unrecognized passed input local method arguments status used communicating buffer displayed various every emacsclient variable buffer-local line non-continuation indent commands handling remote modes language windows non-nil current list modified value whether command processed indentation identifies subprocesses display
count	buffer-local buffer displayed number times records window variable
modifiers	keys programs lisp “press” lets keyboard variable modifier
temp	body run normal buffer displaying hook evaluating temporary with-output-to-temp-buffer
default	specifies rear-stickiness stream text frame coding subprocess variable defines use network giving holds current window various systems input split-string buffer alist separators else nothing properties buffer-local default list minibuffer value values directory output property
cells	vector cons far cells number session emacs allocated total
up	buffer’s says whether account backed buffer file variable buffer-local
bidi	direction non-nil buffer default assumed symbol left-to-right specified value bidirectional right-to-left emacs reordering performs paragraphs variable buffer-local display
display	specifies defined display-buffer displayed number variable table displaying buffers defines char-table priority window emacs performs neither used buffer standard records selective glyphless reordering characters bidirectional non-nil highest buffer’s buffer-local last default value times time action enables treated display automatically
delete	hook run abnormal delete-terminal
char	specifies selected code classification displayed ask see erase names unicode alternative defines whose use script menu holds character char-table next terminal width belongs emacs script-specific screen columns blocks started driver symbol alist standard maps glyphless characters variable line name space list according value system’s property occupy
as	non-ascii non-nil treats regardless constituents symbol syntax characters table variable scan-sexps says
warning	specifies series prefix warning message displaying defines use severity format next text fill type function begin warnings meaning levels warning’s variable generate non-nil programs bind list say value filling order
at	completion functions used compute point abnormal completing list value hook text table
file	variable’s text autoload go whose loading point reverting init updated presently format alist records insert name settings lisp follows list found loads suffixes specifies abbreviated set says truename emacs—or operation nil visiting literally section (concat current may behave initialization terminal-initialization file-name nonexistent beginning process-file search handlers (load accepts auto-saving changes save-buffer load terminal-specific file-name-coding-system saving (getenv encoding user’s coding number one device names writing auto-save use described contains system indicate emacs passed read-file-name call function part remote none non-nil whether wish value recording visited called history files process certain argument states indicates term-file-prefix file contents absolute functions insert-file-contents holds arguments used file-local buffer write-region earlier find-file characters variable representations inserted buffer-local calls "term"))) makes inhibited directory find-file-noselect
operation	certain operation inhibited presently handlers
fill	specifies text move turned environments char prefix paragraphs table fill use auto-fill-function character next auto-fill-chars arguments provides override function fill-region way invoke auto newline self-inserted—space self-inserting forward warning’s characters variable non-nil buffer-local language value fill-paragraph filling paragraph called functions
imenu	specifies scanning point “definition” syntax put table expressions next matching imenu use would index controls imenu-generic-expression current assuming finding function return creating means buffer processing alist override regular variable name case definition modifiers non-nil case-sensitive imenu-prev-index-position-function whether leave list value ignore default definitions backward finds
functions	variable’s code text syntax four questions syntax-propertize-function completion whose loading writing window kill-buffer location hooks unrecognized parsing scrolling name like list calling works frame abnormal obsolete command-line make-frame find-file-noselect state asking supports kill-emacs run nonexistent killing reason members standard beginning properties delete-terminal kill-buffer-query-functions pertain called creates prior changes via saving point number one hook wrapper table size start redisplaying emacs-save-session-functions save-buffers-kill-terminal needed confirming emacs passed call function argument particular sound handling compute appearance value fun visited completing delete computing unsaved accept file contents functions end insert-file-contents holds arguments modification used intended buffer write-region redisplay find-file characters variable inserted write-file-functions buffer’s calls playing order
index	specifies scanning point variable index use would next assuming function return creating buffer put definition non-nil name imenu-prev-index-position-function “definition” value leave backward finds
field	ignore functions non-nil certain boundaries forward-sentence motion field including variable forward-paragraph forward-word
other	buffer’s non-nil scroll scroll-other-window window variable tells
lookup	scanning functions non-nil like forward-sexp pay attention syntax text properties
buffers	specifies buffer-local string would buffer go don’t file listing variable visited display buffers name
ns	function used read-no-blanks-input built-in minibuffer keymap variable local
truncate	entire area resizes normally long echo message displaying display
symbol	non-ascii non-nil treats regardless constituents symbol syntax characters table variable scan-sexps says
update	redisplay run normal whenever menu list update hook buffer redisplaying bar changes contents
generated	calls lisp autoload value go emacs names file variable
variable	specifies variable’s overlay variables list value arrow position
remote	default-directory used remote show whether current buffer variable
unload	functions defined hooks holds list library scanned remove variable unloading
overlay	specifies use attention string nil indicates variables holds list feature value marker variable’s call arrow particular variable position line overlay display
persistent	set-window-configuration parameters get alist window-state-put specifying window-state-get variable subsequently saved current-window-configuration restored
strings	far number session emacs allocated total strings
inhibited	variable backups inhibited non-nil
time	specifies use buffer-local built indicates buffer displayed value records window formatting values time variable last locale emacs
directory	specifies files variable’s holds associated certain variables within built-in one assigned names file go times buffers intended functions invoked nil would contains determined generate current program emacs don’t listing modification insert-directory local preloaded function subdirectories gnu run string invoke buffer class alist executable finds variable non-nil come strings look lib-src buffer-local name programs default documentation value "doc" etc cannot text contain directory visited display
noninteractive	non-nil batch running emacs mode variable
scroll	specifies bars tells buffers functions redisplaying holds scrolling width window emacs scroll-other-window call local object variable measured pixels buffer’s non-nil always list value scroll
