find-buffer-visiting	visiting
read-file-name	read
window-scroll-bars	scroll
find-charset-string	string
object	object
button-activate	activate
kill-append	append
4.3	4.3
place	place
sentence-end-double-space	end
list-charset-chars	chars
set-process-plist	plist
processp	processp
-min-by	by
field-string	field
process-list	list
-split-on	split
move-to-left-margin	left
capitalize-region	capitalize
write-abbrev-file	write
-replace-at	at
oldname	oldname
fringe	fringe
substitute-command-keys	keys
items?	items?
gid	gid
18.2	18.2
selective-display-ellipses	display
insert-buffer-substring	buffer
fill-column	column
file-expand-wildcards	wildcards
-replace-at	replace
-sort	
undo	undo
read-char-exclusive	exclusive
unload-feature	feature
make-category-table	table
first	first
help-event-list	list
2.7	2.7
set-char-table-extra-slot	slot
x-server-vendor	vendor
tabulated-list-print	print
byte-position	byte-position
21.3	21.3
delete-process	process
find-file-other-window	find
auto-mode-list	auto-mode-list
-tree-map	
visiting	visiting
face-font-registry-alternatives	face
make-backup-file-name-function	name
set-window-prev-buffers	prev
window-line-height	window
adjust-window-trailing-edge	window
set-default-file-modes	file
register-read-with-preview	read
by	by
previous-single-char-property-change	char
face-font-registry-alternatives	font
file-name-nondirectory	file
14	14
recent-auto-save-p	auto
create	create
number-or-markers	number-or-markers
text	text
ewoc-get-hf	ewoc
notifications-get-capabilities	capabilities
focus-frame	focus-frame
tabulated-list-init-header	tabulated
count-words	count
ewoc	ewoc
window-min-width	min
none?	none?
insert-register	insert
glyph	glyph
define-obsolete-function-alias	alias
file-newer-than-file-p	file
set-frame-selected-window	frame
unpack	unpack
smie-down-list	list
insert-abbrev-table-description	table
lax-plist-put	plist
x-parse-geometry	parse
completion-styles	styles
recompile	recompile
recenter	recenter
next	next
ewoc-refresh	refresh
read-buffer-completion-ignore-case	completion
accessible	accessible
fceiling	fceiling
insert-directory	insert
restore-buffer-modified-p	buffer
make-syntax-table	make
beginning-of-buffer	buffer
contextual	contextual
terminal	terminal
read-input-method-name	input
file-name-directory	file
face-font-registry-alternatives	registry
make-obsolete	obsolete
activate	activate
below	below
-grade-up	
time-to-day-in-year	year
match-substitute-replacement	substitute
18.5	18.5
no-confirm	no-confirm
window-total-width	total
set-char-table-extra-slot	table
switch-to-prev-buffer	prev
display-message-or-buffer	display
page-delimiter	delimiter
-let*	let*
defun-prompt-regexp	prompt
current-left-margin	margin
pop-to-buffer	pop
maps	maps
set-syntax-table	table
fboundp	fboundp
inhibit-eol-conversion	inhibit
serial-process-configure	serial
window-fringes	fringes
s-append	append
self-insert-command	self
word-search-forward-lax	lax
click	click
generate-new-buffer-name	buffer
resize	resize
noforce	noforce
marker-insertion-type	insertion
regexp-opt-charset	charset
base64-encode-string	encode
vertical	vertical
yes-or-no-p	yes
clear-visited-file-modtime	visited
make-translation-table-from-alist	from
input-pending-p	input
user-mail-address	user
help-setup-xref	xref
infix	infix
8.4	8.4
defaults	defaults
auto-save-timeout	save
next-single-property-change	change
current-left-margin	left
-update-at	
buffer-chars-modified-tick	buffer
-when-let	let
user-mail-address	address
reindent-then-newline-and-indent	indent
lisp	lisp
delimiter	delimiter
current-message	message
fringes	fringes
string-match-p	p
recent	recent
standard-syntax-table	standard
set-left-margin	margin
lisp_object	lisp_object
following-char	following
y-or-n-p-with-timeout	with
up	up
face-inverse-video-p	video
boundary	boundary
run-hooks	hooks
tree	tree
set-fringe-bitmap-face	bitmap
minibuffer-auto-raise	minibuffer
self-insert-command	command
window-prev-buffers	prev
-drop-last	
debugger-args	debugger-args
enable-local-eval	eval
set-face-bold	face
user-real-uid	real
maximize-window	window
find-coding-systems-for-charsets	systems
gc-cons-threshold	threshold
barf-if-buffer-read-only	only
focus-follows-mouse	mouse
move-to-window-line	line
file-locked-p	p
ellipses	ellipses
complete	complete
category-set-mnemonics	category
switch-to-buffer-other-frame	switch
unibyte-string	string
make-backup-file-name	file
face-documentation	documentation
supports	supports
exit-recursive-edit	recursive
overflow-newline-into-fringe	into
flat	flat
set-window-fringes	set
3	3
reporter	reporter
-splice	
image-animate-timer	timer
movement	movement
get-window-with-predicate	window
default-boundp	boundp
s2	s2
bool-vector-p	bool
parents	parents
same-window-regexps	regexps
match-string	match
auto-save-default	default
any?	any?
cancel-change-group	cancel
digit	digit
run-hook-with-args-until-success	success
smie-config-guess	smie
seconds-to-time	time
7.13	7.13
smie-config-save	smie
describe-current-display-table	describe
count-current	count-current
string-lessp	lessp
make-auto-save-file-name	save
other-window	other
sort-subr	subr
transient-mark-mode	mark
set-default-file-modes	default
mouse-on-link-p	p
screen	screen
file-name-absolute-p	file
hf	hf
kill-ring-max	kill
6	6
config	config
left	left
create-file-buffer	buffer
orfn	orfn
bobp	bobp
intern	intern
get-byte	byte
keyboard	keyboard
yank-excluded-properties	excluded
coding-system-change-text-conversion	change
make-help-screen	make
delq	delq
search-backward	search
selected	selected
recursion-depth	depth
helper	helper
window-scroll-bars	window
params	params
8	8
notifications	notifications
minibuffer-prompt-width	prompt
window-pixel-left	window
window-total-height	window
posn-col-row	posn
add-hook	add
fill-column	fill
forward-line	line
s-match-strings-all	all
byte-compile-dynamic-docstrings	dynamic
-orfn	orfn
display-buffer-below-selected	selected
button-end	button
eop	eop
edebug-unwrap-results	results
s-upcase	upcase
category-table-p	table
skip-chars-forward	chars
adaptive-fill-first-line-regexp	regexp
max-specpdl-size	max
number-or-marker1	number-or-marker1
s-collapse-whitespace	whitespace
find-file-wildcards	find
point-marker	point
insert-buffer-substring	substring
marker-position	position
adaptive-fill-function	adaptive
abbrev	abbrev
window-prev-buffers	window
month	month
scroll-down-aggressively	down
width	width
-sum	sum
frame-resize-pixelwise	frame
menubar	menubar
autoload-do-load	do
display-mm-dimensions-alist	alist
unhandled-file-name-directory	unhandled
rigidly	rigidly
listify-key-sequence	listify
previous-overlay-change	change
set-transient-map	set
next-matching-history-element	matching
8.6	8.6
find-coding-systems-region	find
select-frame-set-input-focus	focus
featurep	featurep
load-library	load
set-window-configuration	window
beginning-of-line	of
custom-theme-set-faces	theme
event-end	end
set-terminal-coding-system	set
image-type-available-p	image
pixel	pixel
success	success
bufferp	bufferp
set-frame-height	frame
fill-value	fill-value
map-keymap	keymap
locked	locked
regexps	regexps
following-char	char
fill-region	fill
window-valid-p	valid
bindat-unpack	unpack
user-real-login-name	real
resume	resume
make-symbolic-link	link
nosqueeze	nosqueeze
activate-change-group	group
partially	partially
after	after
undo-boundary	boundary
make-category-table	make
widen	widen
constrain	constrain
activate-change-group	activate
sum	sum
make-vector	vector
process-file-shell-command	process
window-left-child	child
find-coding-systems-for-charsets	charsets
window-scroll-bars	bars
set-process-sentinel	sentinel
frame-height	height
not-this-window	not-this-window
time-to-day-in-year	day
overlays	overlays
ring-elements	elements
smie-down-list	smie
global-key-binding	global
face-remap-set-base	set
19.1	19.1
define-key	define
-some-->	some
Helper-help	Helper
combination	combination
zlib-available-p	zlib
-split-with	split
listname	listname
gc	gc
zip	zip
hack-dir-local-variables	dir
smie-rule-parent	parent
set-frame-selected-window	window
move-overlay	move
-sort	sort
display-buffer-at-bottom	buffer
destroy-fringe-bitmap	bitmap
set-fringe-bitmap-face	fringe
package-upload-buffer	package
set-process-filter	process
set-char-table-extra-slot	extra
s-dashed-words	s
symbol-name	symbol
some	some
small	small
point-min-marker	min
window-configuration-frame	frame
ppss	ppss
sorted	sorted
barf-if-buffer-read-only	barf
marker	marker
use-local-map	local
-some	
buffer-swap-text	swap
minimize-window	window
version	version
minor-mode-key-binding	mode
starts	starts
hash-table-rehash-threshold	threshold
autoload-do-load	autoload
properties	properties
switch-to-visible-buffer	visible
make-symbol	make
set-char-table-range	char
else	else
set-window-vscroll	set
auto-save-visited-file-name	file
get-pos-property	pos
height	height
set-minimum	set-minimum
scroll-preserve-screen-position	position
make-backup-file-name-function	make
coordinates	coordinates
window-valid-p	p
char-table-extra-slot	char
enable-command	command
if	if
minibuffer-window-active-p	p
window-edges	window
backward-delete-char-untabify	untabify
universal-argument	universal
group	group
window-left-column	column
pos	pos
2	2
number-to-string	string
set-window-buffer	set
scroll-down-aggressively	aggressively
sentence-end-double-space	double
read-char-exclusive	char
time	time
format	format
file-executable-p	p
kbd	kbd
ding	ding
date-leap-year-p	year
display-buffer-in-previous-window	previous
buffer-swap-text	text
frame-pixel-height	frame
x-server-vendor	x
s-count-matches	count
abbrev-file-name	abbrev
edebug-print-level	level
time-add	time
infile	infile
void-text-area-pointer	void
call	call
-when-let*	when
previous-frame	previous
display-buffer-pop-up-window	display
process-tty-name	name
next-frame	next
redirect-frame-focus	redirect
face-font-family-alternatives	family
ring-elements	ring
-each-while	
frame-pixel-height	height
frequent	frequent
do-not-terminate	do-not-terminate
imagemagick-types-inhibit	types
backward-sexp	backward
define-key-after	define
advice-add	add
image-type-available-p	type
pop-up-frames	pop
-count	count
sort-numeric-fields	fields
make-backup-file-name-function	function
find-backup-file-name	find
x-get-resource	resource
delims	delims
locate-library	locate
button-start	button
combine-and-quote-strings	and
only-global-abbrevs	only
insert-abbrev-table-description	description
x-popup-menu	x
ceiling	ceiling
emacs-pid	emacs
read-key	read
bold	bold
button-type	type
overlays-in	overlays
bool-vector-intersection	bool
smie-rule-sibling-p	smie
next-history-element	history
gap-size	gap
font-lock-remove-keywords	keywords
number-or-marker-p	marker
on	on
/	/
subst-char-in-region	subst
beginning-of-line	beginning
19	19
backward-delete-char-untabify	delete
-elem-indices	indices
describe-prefix-bindings	prefix
s-titleized-words	words
each	each
truncate-partial-width-windows	partial
-fixfn	
17.11	17.11
create-lockfiles	lockfiles
initial-scratch-message	initial
cons-cell	cons-cell
set-file-times	times
y-limit	y-limit
display-buffer-below-selected	below
posix	posix
button-has-type-p	has
frame-parameter	parameter
split-window-sensibly	window
shr-insert-document	document
create-fontset-from-fontset-spec	fontset
get-internal-run-time	internal
bars	bars
redirect	redirect
define-abbrev-table	define
ignore-auto	ignore-auto
find-file	file
compare-fn	compare-fn
emacs-init-time	emacs
set-buffer	buffer
obarray	obarray
sep	sep
set-default-file-modes	modes
process-mark	mark
require-final-newline	final
vertical-motion	motion
package-archives	archives
car-safe	car
window-text-pixel-size	window
expand-abbrev	expand
numbers-or-markers	numbers-or-markers
void	void
s-pad-right	right
file-in-directory-p	directory
display-backing-store	store
passwd	passwd
abbrev-get	abbrev
current-local-map	current
-partition	
switch-to-prev-buffer	to
beginning	beginning
delete-to-left-margin	to
inverse-video-p	inverse-video-p
signal	signal
send-string-to-terminal	terminal
indent-code-rigidly	rigidly
plist-put	put
display-buffer-use-some-window	window
window-body-size	size
tty-color-approximate	tty
2.3	2.3
font-lock-list	font-lock-list
bool-vector-count-population	bool
mm	mm
smie-close-block	block
read-buffer	buffer
scroll-up	up
normal-mode	normal
more-numbers-or-markers	more-numbers-or-markers
small-temporary-file-directory	small
executable-find	find
file-precious-flag	precious
syntaxes	syntaxes
make	make
window-configuration-p	p
15	15
custom-set-variables	set
file-name-extension	name
string-match-p	match
insert-text-button	insert
previous-single-char-property-change	previous
window-total-height	total
obsolete-face	obsolete-face
copy-alist	alist
window-text-pixel-size	text
prefix	prefix
write	write
parse-sexp-ignore-comments	comments
gap-size	size
command-remapping	remapping
after-find-file	file
11	11
tabname	tabname
window-min-height	height
run-hook-with-args	args
face-differs-from-default-p	default
17.6	17.6
window-next-sibling	window
min-width	min-width
hack	hack
display-mm-dimensions-alist	display
smie-config-guess	config
edebug-print-length	print
max-char	char
just	just
4.1	4.1
syntax-ppss-toplevel-pos	ppss
ewoc-location	ewoc
-tree-reduce	
special-variable-p	variable
user-mail-address	mail
while	while
sensibly	sensibly
interactive-form	interactive
window-min-size	window
time-to-day-in-year	in
s-pad-right	pad
bold-p	bold-p
convert-standard-filename	filename
upcase-region	upcase
file-name-sans-extension	file
sort-lines	sort
unused	unused
ewoc-set-hf	set
switch-to-buffer-other-window	buffer
run-hook-with-args	with
syntax-ppss-toplevel-pos	pos
-select-by-indices	select
eval	eval
file-newer-than-file-p	than
s-uppercase?	uppercase?
unwrap	unwrap
signal-process	signal
backward-char	char
minibuffer-prompt	minibuffer
read-quoted-char	read
recenter-redisplay	redisplay
equal	equal
site-run-file	file
cadr	cadr
pixels-p	pixels-p
ok	ok
current-global-map	map
set-window-prev-buffers	buffers
prepare	prepare
recursive	recursive
s-trim-right	s
key-binding	binding
fixup-whitespace	fixup
tab-to-tab-stop	to
arguments	arguments
number-or-marker2	number-or-marker2
tab	tab
smie-config-save	save
window-combination-limit	combination
into	into
group-real-gid	group
read-coding-system	system
transformer	transformer
final	final
waiting-for-user-input-p	input
copy-abbrev-table	copy
delete-auto-save-file-if-necessary	auto
character-set	character-set
7.1.2	7.1.2
sibling	sibling
colon	colon
copy-directory	copy
charsetp	charsetp
file-modes-symbolic-to-number	symbolic
inactive	inactive
local-variable-if-set-p	set
fringe-bitmaps-at-pos	fringe
numeric?	numeric?
commandp	commandp
filter-buffer-substring	buffer
ask-user-about-supersession-threat	threat
start-file-process-shell-command	start
check	check
process-get	process
make-translation-table-from-vector	translation
completing	completing
face-differs-from-default-p	p
downcase-word	word
hash-table-count	hash
defined-colors	colors
line-number-at-pos	number
suffix	suffix
set-file-selinux-context	context
window-inside-edges	window
small-temporary-file-directory	directory
find-file	find
select	select
frame-pixel-height	pixel
display-save-under	save
delete-indentation	delete
recenter-positions	recenter
indent-tabs-mode	tabs
theme	theme
maybe	maybe
gv	gv
window-pixel-height	pixel
global-set-key	set
substitute-in-file-name	name
set-face-inverse-video	set
window-full-height-p	window
load-prefer-newer	load
display-graphic-p	display
xref	xref
precious	precious
add-to-ordered-list	list
this-command-keys	command
overlay-properties	overlay
jit-lock-register	lock
terminal-list	list
find-file-name-handler	file
gc-cons-threshold	cons
window-pixel-width	window
find-file-hook	file
user-error	user
with-temp-message	temp
sentence-end	end
read-buffer-function	buffer
rear-advance	rear-advance
eval-buffer	eval
start-file-process	start
set-case-syntax-pair	set
-keep	
class	class
ok-if-already-exists	ok-if-already-exists
word-search-forward-lax	search
open	open
file-accessible-directory-p	directory
abbrev-put	abbrev
set-window-parameter	parameter
-distinct	
conversion	conversion
selective-display-ellipses	selective
string-or-char	string-or-char
linked	linked
insert-buffer-substring-no-properties	insert
smie-merge-prec2s	prec2s
custom	custom
sel	sel
read-from-minibuffer	from
play-sound-file	file
geometry	geometry
buffer-substring	buffer
set-left-margin	set
expand-file-name	name
read-minibuffer	read
nowarn	nowarn
time-to-day-in-year	time
sort	sort
read-buffer-completion-ignore-case	buffer
repeat-count	repeat-count
help-map	help-map
debug-ignored-errors	errors
auto	auto
bool-vector-subsetp	bool
posix-looking-at	looking
ignore	ignore
discard-input	discard
substitute-key-definition	definition
site-run-file	run
x-popup-menu	popup
-partial	
s-split-words	split
-is-infix?	is
set-default	set
-drop-while	
insert-before-markers-and-inherit	inherit
read-directory-name	name
shrink-window-if-larger-than-buffer	larger
tabulated-list-print	tabulated
cons	cons
rename	rename
set-face-bold	bold
prompt	prompt
conservatively	conservatively
with-temp-message	message
sin	sin
parse-partial-sexp	sexp
abbrev-file-name	file
smie	smie
-cons*	cons*
def	def
easy-menu-define	define
one	one
log	log
-when-let	
field	field
merge-face-attribute	merge
bool-vector-count-population	population
nomodes	nomodes
paragraph-start	paragraph
backward-word	backward
abort	abort
move-to-window-line	to
-if-let	let
file	file
set-process-datagram-address	set
prepare-change-group	group
iteratefn	iteratefn
make-text-button	button
dom	dom
find-coding-systems-string	coding
7.1.1	7.1.1
cycle	cycle
inherit	inherit
insert-for-yank	for
indent-rigidly	rigidly
find-image	image
window-live-p	window
set-window-vscroll	vscroll
set-advertised-calling-convention	set
throw	throw
get-largest-window	largest
libxml-parse-xml-region	region
current-active-maps	current
switch-to-visible-buffer	switch
cons*	cons*
underline	underline
one-window-p	window
display-buffer-at-bottom	bottom
process-query-on-exit-flag	on
custom-theme-p	theme
-applify	
display-table-slot	slot
in	in
play-sound-file	sound
completion-table-with-cache	with
type-of	of
from-string	from-string
warning-suppress-types	types
6.6	6.6
undo-strong-limit	limit
ask-user-about-supersession-threat	user
-sum	
scroll-left	left
tag	tag
set-fontset-font	set
smie-rule-bolp	rule
fixup-whitespace	whitespace
fold	fold
set-window-buffer	buffer
accept-defaults	accept-defaults
custom-theme-p	p
tab-width	tab
-replace-last	last
syntax-table-p	syntax
ask	ask
reset	reset
match-substitute-replacement	match
emacs-uptime	emacs
debug-on-entry	on
set-advertised-calling-convention	advertised
-reduce-from	reduce
default-justification	justification
eol-coding	eol-coding
dump-emacs	emacs
kill-new	kill
auto-save-list-file-prefix	auto
recursion-depth	recursion
pop-up-windows	windows
handle	handle
justify	justify
-reduce-r-from	reduce
copy-sequence	sequence
restore-buffer-modified-p	p
constrain-to-field	field
parse-partial-sexp	parse
consp	consp
coding-system-charset-list	list
easy-menu-define	menu
get-largest-window	window
match-beginning	beginning
file-accessible-directory-p	file
next-screen-context-lines	context
delete-dups	dups
set-fontset-font	font
edebug-print-level	edebug
exit	exit
field-string	string
1-	1
s-upper-camel-case	s
file-regular-p	file
coding-system-change-text-conversion	coding
window-parameters	window
caar	caar
check-coding-system	check
s-collapse-whitespace	collapse
s-upcase	s
bidi-string-mark-left-to-right	left
display-table-slot	display
make-obsolete	make
-slice	slice
preview	preview
window-text-pixel-size	pixel
assoc-string	assoc
preceding-char	preceding
notifications-get-capabilities	notifications
pop-up-frames	up
edge	edge
down-list	list
term	term
ewoc-set-hf	ewoc
face-remap-remove-relative	remove
requirements	requirements
make-obsolete-variable	variable
size	size
edebug-on-error	edebug
indirect-variable	variable
total	total
yank-excluded-properties	properties
read-color	color
tool-bar-local-item-from-menu	bar
copy-overlay	overlay
try-completion	completion
buffer-end	buffer
recent-auto-save-p	p
toplevel	toplevel
map-keymap	map
-take	
parse	parse
charset	charset
face-font-family-alternatives	face
make-keymap	keymap
warning-suppress-types	warning
make-frame-on-display	on
docstring	docstring
paren	paren
hash-table-size	size
inhibit-eol-conversion	eol
face-remap-remove-relative	relative
scan-lists	lists
privileged	privileged
set-keymap-parent	keymap
default-frame-alist	frame
number-or-marker-p	p
-group-by	
ends	ends
-tree-reduce	reduce
edebug-continue-kbd-macro	macro
modify-syntax-entry	entry
frame-height	frame
macro-only	macro-only
marker-buffer	marker
remove-from-invisibility-spec	spec
expression	expression
ewoc-get-hf	get
21.2	21.2
-is-infix?	infix?
remove-function	remove
edebug-print-length	length
backward-char	backward
clear-visited-file-modtime	file
&rest	&rest
replace	replace
y-or-n-p-with-timeout	n
face-id	id
re-search-backward	search
window-pixel-width	pixel
arg-descriptor	arg-descriptor
-map-first	
push-button	button
display-selections-p	p
config1	config1
enable-recursive-minibuffers	minibuffers
event-modifiers	modifiers
make-help-screen	screen
insert-buffer-substring-no-properties	no
ring-remove	remove
call-process-shell-command	command
completion-table-with-cache	table
fill-paragraph	paragraph
register-read-with-preview	with
window-pixel-height	height
window-valid-p	window
posn-timestamp	posn
require	require
tool-bar-add-item	tool
overlays-at	overlays
backward-only	backward-only
window-left-column	left
ewoc-nth	ewoc
make-local-variable	make
file-executable-p	file
list-load-path-shadows	shadows
yank-handled-properties	yank
indicate-buffer-boundaries	indicate
set-case-syntax-delims	set
indent-for-tab-command	for
keep-backup-version	keep-backup-version
words-include-escapes	escapes
doc	doc
25	25
temporary-file-directory	directory
s-replace-all	replace
substitute-command-keys	substitute
kill-buffer	buffer
window-frame	window
symbol-plist	symbol
only-in-line	only-in-line
object1	object1
quit-restore-window	restore
previous-char-property-change	previous
left-margin	left
eql	eql
ewoc-nth	nth
describe-bindings	describe
file-modes	file
multibyte	multibyte
unlock-buffer	buffer
switch-to-buffer-other-frame	other
abort-recursive-edit	edit
called-interactively-p	p
string-to-char	char
10.5	10.5
s-trim	trim
listify-key-sequence	key
button-put	put
string-or-null-p	string
bool-vector-union	vector
kill-ring-max	ring
smie-rule-sibling-p	rule
frame-or-window	frame-or-window
window-fringes	window
7.1.7	7.1.7
erase	erase
file-modes-symbolic-to-number	file
-interpose	
-product	product
save-buffer	save
use-global-map	map
mark-marker	marker
bindat-unpack	bindat
edebug-setup-hook	edebug
34	34
make-auto-save-file-name	file
uptime	uptime
string-to-multibyte	string
zerop	zerop
view	view
-find-last-index	
byte-code-function-p	p
interactive	interactive
bidi-string-mark-left-to-right	string
push-mark	push
preserve-extended-attributes	preserve-extended-attributes
copy-directory	directory
fit-window-to-buffer-horizontally	window
window-system	system
set-case-syntax-delims	delims
user-real-uid	uid
edebug-all-forms	all
iterate	iterate
window-display-table	display
run-at-time	run
recenter-top-bottom	top
kill-ring-max	max
register	register
s-mixedcase?	s
keymap-prompt	prompt
set-marker	set
remove-function	function
s-lines	s
file-name-completion	file
force-mode-line-update	mode
font	font
word-search-backward-lax	search
minibuffer-prompt-end	minibuffer
keywordp	keywordp
face-differs-from-default-p	from
unload	unload
window-min-size	min
pointer	pointer
current-minor-mode-maps	maps
ip	ip
6.7	6.7
set-process-sentinel	set
2.6	2.6
15.2	15.2
sans	sans
find-charset-region	region
completion-auto-help	help
fill	fill
mouse-movement-p	movement
deftheme	deftheme
windowp	windowp
-list	
locate-file	locate
beginning-of-defun	of
scroll-up	scroll
find-file-other-window	other
edebug-on-error	error
new	new
error	error
edebug-sit-for-seconds	for
user-real-login-name	login
string2	string2
hack-dir-local-variables	variables
sort-numeric-base	numeric
translation	translation
default-file-modes	modes
current-indentation	current
-if-let*	let*
process-file-shell-command	file
delete-field	delete
lockfiles	lockfiles
s-left	left
set-window-fringes	window
delete-file	file
window-system	window
describe-mode	mode
-tree-seq	seq
deactivate-mark	deactivate
insert-button	button
md5	md5
run-hook-with-args-until-failure	run
input-pending-p	p
-remove-first	first
put-charset-property	charset
face-remap-remove-relative	remap
preserve-uid-gid	preserve-uid-gid
getenv	getenv
string-to-syntax	string
end-of-line	of
posn-object-x-y	object
-select-columns	
end1	end1
switch	switch
file-directory-p	file
help-char	char
end-of-defun	end
string-to-char	to
-when-let	when
find-file-hook	find
s-matched-positions-all	positions
set-mouse-position	set
window-body-size	window
switch-to-buffer-other-window	to
emacs-uptime	uptime
this-command-keys-vector	keys
make-backup-file-name	backup
string	string
set-face-stipple	set
value1	value1
21	21
hash-table-count	count
face-all-attributes	all
fit-window-to-buffer-horizontally	fit
forward-list	forward
atom	atom
row	row
edebug-sit-for-seconds	sit
coding-system	coding-system
-select-column	select
next-overlay-change	overlay
same-window-p	p
face-differs-from-default-p	face
set-process-datagram-address	datagram
delete-trailing-whitespace	delete
ref	ref
s-lowercase?	s
char-table	char-table
ifname	ifname
window-parameters	parameters
delete-minibuffer-contents	minibuffer
display-table	display-table
translations	translations
window-pixel-height	window
errors	errors
-cycle	
insert-button	insert
12.3	12.3
end-of-buffer	buffer
find-file-hook	hook
custom-add-frequent-value	frequent
dotimes	dotimes
file-precious-flag	file
default-boundp	default
clear-this-command-keys	command
7.7	7.7
remove-from-invisibility-spec	from
-max-by	
include	include
listify	listify
-find-last-index	find
get-buffer	buffer
geom	geom
map-charset-chars	chars
coding-system-p	coding
map-char-table	map
reseat	reseat
code-point	code-point
tq-create	tq
-drop	
pending	pending
char-syntax	char
popup	popup
font-get	get
fold-wildcards	fold-wildcards
file-readable-p	readable
appendp	appendp
edebug-print-circle	circle
find-file-read-only	read
forward-sexp	forward
delete-auto-save-file-if-necessary	if
window-line-height	height
point-marker	marker
bindings	bindings
paragraph-separate	paragraph
file-selinux-context	file
state	state
text-char-description	description
s-word-wrap	word
file-locked-p	file
visible-ok	visible-ok
base-name	base-name
notifications-get-capabilities	get
set-input-method	input
max-specpdl-size	specpdl
s-match-strings-all	match
input	input
datagram	datagram
read-file-name-completion-ignore-case	read
more	more
window-scroll-bar-width	bar
file-extended-attributes	attributes
highest	highest
pop-up-frame-alist	pop
run-hook-with-args-until-failure	with
s-numeric?	s
batch-byte-compile	byte
string1	string1
-fix	
recenter-top-bottom	recenter
bar	bar
coding-system-p	system
under	under
file-readable-p	file
9.3	9.3
s1	s1
word-search-backward-lax	word
set-window-start	start
identity	identity
backup-by-copying-when-mismatch	backup
skip-chars-backward	skip
button-activate	button
font-put	font
-separate	separate
olp	olp
upload	upload
base64	base64
set-charset-priority	set
family	family
-on	on
format-insert-file	insert
assoc	assoc
file-exists-p	p
make-obsolete-variable	obsolete
remove-from-invisibility-spec	invisibility
char-to-string	char
hash-table-weakness	table
boundaries	boundaries
event-click-count	count
add-face-text-property	text
adjust-window-trailing-edge	edge
->>	>>
-zip-fill	zip
alias	alias
c	c
s-dashed-words	dashed
smie-bnf->prec2	>prec2
char-table-p	char
argument	argument
load-prefer-newer	prefer
edebug-on-error	on
beginning-of-buffer	of
keyboard-coding-system	coding
bool-vector-p	p
from-file	from-file
bytes	bytes
make-frame	make
make-frame-invisible	make
this-command-keys-vector	vector
wrap	wrap
clone	clone
max-lisp-eval-depth	depth
byte-recompile-directory	recompile
file-notify-rm-watch	file
find-file-noselect	noselect
mnemonics	mnemonics
window-min-height	window
-union	union
-last-item	item
find-file-read-only	only
tabulated-list-init-header	init
button	button
bool-vector-union	bool
use-local-map	map
smie-rule-sibling-p	p
bindat-raw	bindat-raw
selinux	selinux
smie-rule-sibling-p	sibling
custom-add-frequent-value	value
define-alternatives	define
sort-fold-case	case
window-bottom-divider-width	divider
match-beginning	match
standard-case-table	case
fit-window-to-buffer-horizontally	horizontally
unhandled-file-name-directory	directory
make-string	make
file-directory-p	p
beginning-of-buffer	beginning
truncate-partial-width-windows	truncate
previous-complete-history-element	element
setter	setter
describe-buffer-case-table	describe
child	child
face-all-attributes	attributes
propname	propname
image-type-available-p	available
erase-buffer	erase
truncate-partial-width-windows	windows
reindent	reindent
5.1	5.1
overlayp	overlayp
current-window-configuration	current
display-supports-face-attributes-p	p
inhibit-startup-screen	screen
frame-current-scroll-bars	current
-zip-with	with
set-file-modes	modes
adaptive-fill-regexp	adaptive
display-message	display-message
get-char-property-and-overlay	property
read-variable	read
4	4
pid	pid
goto-char	char
special-form-p	p
remote-file-name-inhibit-cache	name
including	including
decode-coding-string	coding
desc	desc
-reduce-r-from	from
insert-buffer-substring-no-properties	substring
read-file-name-completion-ignore-case	completion
find-coding-systems-region	coding
-prodfn	
read-passwd	passwd
invert-face	invert
system	system
nomessage	nomessage
next-char-property-change	change
18.3	18.3
window-parameter	parameter
current-justification	current
set-file-extended-attributes	file
nondirectory	nondirectory
indirect-function	function
grade	grade
19.3	19.3
completion-in-region	in
process-type	type
frame-current-scroll-bars	frame
delete-indentation	indentation
smie-rule-parent-p	parent
live	live
plist-get	plist
scroll-preserve-screen-position	preserve
define-key	key
invalidate	invalidate
string-as-unibyte	string
rename-buffer	buffer
selected-window	selected
float-time	float
format-string	format-string
substitute-key-definition	substitute
imagemagick-types	imagemagick
window-current-scroll-bars	scroll
byte	byte
set-process-plist	set
ring-p	ring
custom-initialize-delay	custom
local-unset-key	unset
undefined	undefined
make-symbolic-link	symbolic
equal-including-properties	equal
dashed	dashed
>>	>>
discard	discard
gv-define-simple-setter	setter
after-save-hook	hook
byte-to-position	position
fundamental-mode	fundamental
cut	cut
package-upload-buffer	upload
jit-lock-register	jit
actual	actual
insert-file-contents-literally	literally
enter	enter
-tree-mapreduce-from	from
undo-limit	limit
define-obsolete-function-alias	function
insert-buffer-substring-as-yank	as
s	s
13	13
face-attribute	face
shell-quote-argument	shell
speed	speed
10	10
define-abbrev	abbrev
indirect	indirect
with	with
mapreduce	mapreduce
line-number-at-pos	line
modify-syntax-entry	syntax
information	information
destroy	destroy
bus	bus
jit-lock-unregister	jit
13.5	13.5
smie-rule-parent-p	smie
define-abbrev-table	abbrev
-last	
subr	subr
window-configuration-frame	window
tabulated-list-print	list
-any?	
set-keymap-parent	parent
universal	universal
all-completions	all
display-backing-store	display
window-prev-buffers	buffers
set	set
-partition-by	
read-file-name-completion-ignore-case	name
abbrev-table-p	p
bindat-get-field	bindat
s-starts-with?	starts
user-login-name	login
make-frame-on-display	display
operator	operator
last	last
max-height	max-height
percentage	percentage
uc	uc
horizontally	horizontally
window-absolute-pixel-edges	window
backtrace-frame	backtrace
selective	selective
find-file-other-window	window
face-font-family-alternatives	font
remove-text-properties	text
open-termscript	open
end-of-line	line
window-absolute-pixel-edges	absolute
fix-return	fix-return
file-extended-attributes	extended
footer	footer
eval-expression-print-length	print
completion-in-region	completion
primitive	primitive
window-parent	window
setq-local	local
generate-new-buffer-name	name
justify-current-line	line
selected-frame	selected
display-supports-face-attributes-p	face
-lambda	
tool-bar-add-item	bar
scroll-up-command	command
timeout	timeout
tool-bar-add-item	item
current-global-map	global
terminal-parameters	parameters
elem	elem
play	play
rename-file	file
auto-coding-alist	auto
display-mm-width	mm
17.2	17.2
recent-keys	recent
perform-replace	perform
tables	tables
delete-to-left-margin	margin
-tree-map-nodes	map
alternatives	alternatives
exit-recursive-edit	edit
base64-decode-region	base64
display-graphic-p	graphic
split	split
number-sequence	number
smie-config-guess	guess
assoc-default	default
process-live-p	live
display-color-cells	cells
describe-display-table	display
mail	mail
encode	encode
window-left-child	left
process-get	get
display-mm-dimensions-alist	dimensions
find-operation-coding-system	find
scroll-bar-event-ratio	ratio
1value	1value
handler	handler
button-start	start
eval-minibuffer	eval
smie-rule-parent	smie
insert-text-button	button
move-overlay	overlay
vectorp	vectorp
help-buffer	buffer
set-transient-map	transient
next-single-property-change	property
interactive-call	interactive-call
elt	elt
upcase-initials	initials
memory-use-counts	use
s-present?	s
system-name	name
minor	minor
set-window-prev-buffers	window
shell-quote-argument	argument
find-coding-systems-string	string
append-to-file	append
s-split-up-to	up
text-char-description	char
t1	t1
indent-relative-maybe	indent
current	current
set-char-table-range	set
13.4	13.4
inherit-input-method	inherit-input-method
add	add
previous-overlay-change	overlay
find-operation-coding-system	coding
point	point
nocopy	nocopy
justify-current-line	current
get-buffer-window	buffer
capitalize	capitalize
subrp	subrp
s-reverse	s
-find-indices	indices
display-buffer-pop-up-frame	frame
approximate	approximate
window-display-table	window
byte-code-function-p	function
lc	lc
s-titleized-words	titleized
set-case-syntax	case
display-backing-store	backing
small-temporary-file-directory	temporary
autoloadp	autoloadp
next-char-property-change	next
set-default-file-modes	set
display-buffer-base-action	display
set-case-syntax-pair	case
base64-encode-region	region
previous-window	window
indent-for-tab-command	indent
sort-numeric-base	base
union	union
string-equal	string
refresh	refresh
8.3	8.3
no-redraw-on-reenter	on
set-process-query-on-exit-flag	flag
beforep	beforep
read-minibuffer	minibuffer
custom-unlispify-remove-prefixes	remove
ewoc-create	ewoc
subst-char-in-region	char
nconc	nconc
replace-regexp-in-string	regexp
lexical	lexical
undo-boundary	undo
to-eop	to-eop
inhibit-startup-echo-area-message	startup
link	link
extra	extra
pattern	pattern
maximize-window	maximize
y	y
backward-delete-char-untabify	char
-tree-seq	
move-to-window-line	window
8.7	8.7
set-buffer-modified-p	p
tty-color-clear	clear
fit-frame-to-buffer	fit
indent-according-to-mode	mode
dir-locals-set-class-variables	class
spec	spec
minibuffer-message	message
>prec2	>prec2
-partition-all	
s-numeric?	numeric?
from-map	from-map
facep	facep
window-in-direction	direction
underline-minimum-offset	minimum
edebug-unwrap-results	edebug
minibufferp	minibufferp
memory-use-counts	counts
to	to
edebug-print-length	edebug
blink-matching-open	matching
7.14	7.14
keyseq-text	keyseq-text
completing-read	read
charset-after	after
read-command	read
set-terminal-coding-system	terminal
char-table-extra-slot	slot
string-to-char	string
grammar	grammar
backup-by-copying-when-linked	backup
get-window-with-predicate	predicate
space	space
auto-coding-functions	coding
set-right-margin	margin
process-running-child-p	p
-partition	partition
current-idle-time	idle
supertype	supertype
read-file-name	file
suspend	suspend
notifications-get-server-information	notifications
group-gid	group
file-precious-flag	flag
plist	plist
human	human
auto-coding-functions	auto
line-beginning-position	line
matching	matching
blank	blank
continue-echo	continue-echo
progress-reporter-update	progress
selections	selections
color	color
-last	last
-same-items?	
set-category-table	table
coordinates-in-window-p	coordinates
continue-process	continue
reindent-then-newline-and-indent	then
-contains?	contains?
indent-according-to-mode	according
tab-to-tab-stop	tab
36	36
s-trim-right	right
matches	matches
insert-file-contents	file
use-global-map	global
substring-no-properties	substring
thing-at-point	at
package-upload-buffer	buffer
lock-buffer	lock
set-mouse-position	position
present?	present?
adjust-window-trailing-edge	adjust
cells	cells
focus-follows-mouse	follows
clear-this-command-keys	keys
setenv	setenv
process-query-on-exit-flag	process
file-modes	modes
make-variable-buffer-local	local
window-min-height	min
define-category	define
make-syntax-table	syntax
define-generic-mode	mode
1.1	1.1
filter-buffer-substring	filter
waiting-for-user-input-p	p
event-modifiers	event
-filter	filter
directory	directory
minibuffer-contents-no-properties	minibuffer
active-minibuffer-window	minibuffer
x-bitmap-file-path	x
posn-window	posn
set-fringe-bitmap-face	set
blink-matching-delay	delay
find-font	font
window-at	at
titleized	titleized
t2	t2
-replace-last	
delete-frame	delete
previous-single-char-property-change	property
configurations	configurations
file-name-absolute-p	absolute
indent-for-tab-command	command
run-hook-with-args-until-failure	hook
window-edges	edges
delete-file	delete
set-char-table-range	table
22	22
make-auto-save-file-name	make
posn-object-width-height	width
/=	/=
visited-file-modtime	file
snarf	snarf
goto-char	goto
-some-->	
set-keyboard-coding-system	keyboard
put	put
copy-region-as-kill	region
-fix	fix
indirect-variable	indirect
forward-line	forward
file-acl	acl
rigid	rigid
notifications-close-notification	close
delete-and-extract-region	region
subsetp	subsetp
base64-decode-region	region
local-set-key	set
controlling-tty-p	controlling
divisor	divisor
point-min-marker	point
keymapp	keymapp
current-frame-configuration	configuration
current-buffer	current
help-event-list	event
sxhash	sxhash
button-has-type-p	p
start	start
screens	screens
capabilities	capabilities
no-redraw-on-reenter	reenter
set-advertised-calling-convention	convention
read-command	command
minibuffer-selected-window	selected
absolute	absolute
next-screen-context-lines	lines
infix?	infix?
completion	completion
fit-frame-to-buffer-margins	frame
keymap	keymap
window-minibuffer-p	p
insert-before-markers-and-inherit	markers
id-format	id-format
s-uppercase?	s
window-in-direction	window
gv-define-setter	gv
x-get-resource	get
ok-if-exists	ok-if-exists
call-process-shell-command	call
read-from-string	from
insert-buffer	insert
substitute-command-keys	command
syntax-table-p	table
delete-auto-save-files	save
bitmap	bitmap
window-prev-sibling	window
get-char-property-and-overlay	char
standard-category-table	category
read-kbd-macro	read
read-char-choice	choice
help-event-list	help
pretty-printer	pretty-printer
selected-window	window
file-name-absolute-p	p
narrow-to-region	narrow
replacements	replacements
void-text-area-pointer	area
init-value	init-value
locate-file	file
recenter-redisplay	recenter
quietly	quietly
-partition-by-header	header
echo	echo
preceding-char	char
frame-parameters	parameters
face-remap-reset-base	face
process-running-child-p	process
reindent-then-newline-and-indent	newline
window-body-size	body
set-buffer-auto-saved	buffer
39	39
-table-flat	flat
start-file-process-shell-command	file
-tree-mapreduce-from	
has	has
describe-current-display-table	current
bidi-string-mark-left-to-right	to
set-process-query-on-exit-flag	set
untabify	untabify
string-match	string
floor	floor
current-name	current-name
file-directory-p	directory
minibuffer-window-active-p	window
enable-local-variables	variables
time-value	time-value
blink-matching-delay	blink
wildcard	wildcard
read-from-minibuffer	minibuffer
number-or-marker-p	number
previous-single-char-property-change	single
notification	notification
mark	mark
set-face-underline	face
titleize	titleize
coding-system-change-text-conversion	conversion
buffer-file-name	name
color-defined-p	defined
blink-matching-delay	matching
buffer-offer-save	buffer
switch-to-buffer-other-window	switch
margins	margins
small-temporary-file-directory	file
bindat-get-field	get
transient	transient
mouse-movement-p	p
9.4	9.4
s-match-strings-all	s
face-remap-reset-base	reset
switch-to-buffer-preserve-window-point	switch
base64-encode-region	base64
no-redraw-on-reenter	redraw
differs	differs
9	9
function-get	get
sort-regexp-fields	sort
process-send-string	send
minibuffer-depth	minibuffer
-difference	difference
ffloor	ffloor
copy-contents	copy-contents
auto-coding-alist	alist
major-mode	major
process-mark	process
translate	translate
2.4	2.4
kill-process	kill
buffer-disable-undo	buffer
frame-parameters	frame
imenu-add-to-menubar	add
window-start	start
member-ignore-case	member
auto-save-timeout	auto
current-input-mode	mode
2.11	2.11
10.3	10.3
edebug-sit-for-seconds	seconds
copy-file	copy
integer-or-marker-p	integer
smie-config	smie
strings	strings
read-key-sequence-vector	key
hash-table-size	hash
map	map
display-warning	warning
4.7	4.7
describe-prefix-bindings	bindings
file-accessible-directory-p	accessible
current-active-maps	maps
window-left-column	window
find-charset-string	charset
insert-before-markers	insert
skip-syntax-forward	skip
remap	remap
supported	supported
yank-excluded-properties	yank
read-file-name-completion-ignore-case	file
nbutlast	nbutlast
element	element
edebug-all-forms	forms
current-fill-column	fill
ewoc-get-hf	hf
display-pixel-width	pixel
copy-region-as-kill	as
mask	mask
event	event
frame-resize-pixelwise	pixelwise
backup-by-copying-when-mismatch	by
derived-mode-p	mode
scroll-up-command	scroll
custom-theme-set-faces	custom
adjust-window-trailing-edge	trailing
word	word
scroll-conservatively	conservatively
timestamp	timestamp
process-id	process
ints-or-markers	ints-or-markers
x-server-version	version
regexp-opt	opt
read-buffer-completion-ignore-case	case
config2	config2
move-to-left-margin	margin
display-buffer-use-some-window	use
change	change
expand-file-name	file
color-defined-p	color
tool	tool
s-word-initials	s
match-form	match-form
-slice	
tool-bar-local-item-from-menu	tool
count	count
17.1	17.1
applify	applify
allow-empty	allow-empty
frame-pointer-visible-p	p
28	28
char-table-parent	parent
-reduce-from	from
load	load
sequences	sequences
file-newer-than-file-p	p
style-variant-p	style-variant-p
forms	forms
abbrev-prefix-mark	mark
s-trim-right	trim
get-lru-window	lru
make-translation-table-from-alist	translation
help-setup-xref	setup
batch-byte-compile	batch
button-type-subtype-p	p
defvar-local	defvar
port	port
backup-by-copying-when-linked	by
terminal-live-p	terminal
full	full
window-prev-sibling	prev
12.5	12.5
x-get-resource	x
counts	counts
user-login-name	user
previous-property-change	property
deactivate-mark	mark
keywords	keywords
minimize	minimize
debug-ignored-errors	ignored
s-chop-suffix	suffix
length	length
indent-according-to-mode	indent
get-byte	get
smie-setup	smie
void-text-area-pointer	text
universal-argument	argument
file-relative-name	file
tabulated-list-init-header	header
do-auto-save	save
tabulated	tabulated
-update-at	at
ewoc-goto-node	node
display-graphic-p	p
specpdl	specpdl
iconify-frame	iconify
sign	sign
yes-or-no-p	or
newline-and-indent	and
terminal-parameters	terminal
list-load-path-shadows	path
nochange-regexp	nochange-regexp
package-archives	package
6.5	6.5
eval-expression-debug-on-error	eval
describe-current-display-table	display
mark-ring-max	mark
millisec	millisec
-fixfn	fixfn
read-buffer	read
s-present?	present?
raise-frame	frame
display-buffer-pop-up-frame	buffer
than	than
window-current-scroll-bars	bars
s-ends-with?	s
17.7	17.7
dimensions	dimensions
17.5	17.5
get-internal-run-time	get
make-frame-invisible	invisible
reindent-then-newline-and-indent	and
backup-by-copying-when-privileged-mismatch	when
display-mm-width	display
point-min	point
asin	asin
string-or-null-p	or
previous-window	previous
memory-use-counts	memory
product	product
clear-visited-file-modtime	clear
Snarf-documentation	documentation
fixfn	fixfn
member	member
read-input-method-name	name
count-screen-lines	count
integerp	integerp
hooks	hooks
generic	generic
indent-code-rigidly	code
ewoc-data	ewoc
bool-vector-intersection	intersection
oldmap	oldmap
bindat-idx	bindat-idx
fill-region	region
symbolic	symbolic
regexp-opt	regexp
tool-bar-local-item-from-menu	from
executable-find	executable
re-search-backward	re
-remove-last	
waiting-for-user-input-p	for
norecord	norecord
x-popup-dialog	popup
locale	locale
leap	leap
backup-by-copying-when-privileged-mismatch	backup
advice-remove	advice
-partition-by	partition
-select-columns	columns
insert-text-button	text
get-internal-run-time	time
exclusive	exclusive
end-of-line	end
category-table-p	category
process-attributes	attributes
read-key-sequence-vector	sequence
abbrev-insert	insert
-drop-while	while
read-quoted-char	quoted
custom-set-variables	variables
disable-command	disable
s-upper-camel-case	case
find-charset-region	charset
is	is
overlay-end	end
debug-on-event	on
count-lines	lines
1.2	1.2
local-set-key	local
ewoc-invalidate	invalidate
modify-syntax-entry	modify
from-buffer-or-name	from-buffer-or-name
dividend	dividend
skip	skip
scroll-bar-event-ratio	event
display-buffer-base-action	buffer
lax	lax
-pad	pad
switch-to-buffer-other-frame	to
make-local-variable	local
backup-file-name-p	p
maphash	maphash
rgb	rgb
insertion	insertion
get-buffer	get
-elem-index	index
system-groups	system
window-scroll-bar-width	scroll
load-library	library
format-insert-file	format
inverse	inverse
trim	trim
fname	fname
ewoc-enter-first	first
forward-button	forward
self	self
move	move
faces	faces
-iterate	
item	item
standard-case-table	standard
auto-save-list-file-prefix	list
varlist	varlist
decode-char	decode
smie-rule-next-p	rule
pos-visible-in-window-p	window
gap-position	gap
forward-button	button
window-combination-limit	limit
filename	filename
window-tree	tree
car	car
nextrecfun	nextrecfun
autoload	autoload
display-color-p	display
window-child	window
insert-before-markers-and-inherit	and
integer-or-marker-p	p
insert-for-yank	insert
set-face-bold	set
mark-even-if-inactive	mark
overlay-buffer	buffer
debug	debug
define-obsolete-face-alias	face
echo-keystrokes	echo
-butlast	butlast
put-text-property	put
normal	normal
overlay-end	overlay
warning-suppress-types	suppress
memq	memq
insert-file-contents	insert
make-button	make
18.4	18.4
find-coding-systems-string	systems
gap-position	position
page	page
charset-after	charset
global-set-key	key
string-as-unibyte	unibyte
face-differs-from-default-p	differs
byte-to-position	byte
subexp	subexp
adaptive-fill-regexp	regexp
quietly-read-abbrev-file	quietly
adaptive-fill-function	function
enable-local-eval	enable
read-char-exclusive	read
compare	compare
serial-term	serial
scroll-bar-mode	mode
substitute	substitute
button-label	button
p	p
process-file-shell-command	shell
function-list	function-list
process-status	status
syntax-ppss	syntax
26	26
get-char-property-and-overlay	and
table	table
current-minor-mode-maps	current
x-limit	x-limit
set-window-start	window
count-lines	count
call-interactively	call
set-display-table-slot	display
remember-pos	remember-pos
global-set-key	global
previous-overlay-change	previous
file-attributes	file
file-modes-symbolic-to-number	to
startkeyfun	startkeyfun
-rotate	rotate
file-name-sans-extension	extension
words-include-escapes	include
make-help-screen	help
stop-process	stop
fields	fields
narrow-to-region	to
newname	newname
dedicated	dedicated
eval-buffer	buffer
window-pixel-left	pixel
backup-buffer	backup
hash-table-rehash-threshold	hash
notifications-notify	notifications
shr-insert-document	shr
this-command-keys-vector	this
acl	acl
subfeature	subfeature
find-backup-file-name	name
window-total-width	width
add-name-to-file	file
frame-visible-p	p
function-object	function-object
time-subtract	subtract
process-query-on-exit-flag	query
end-of-defun	defun
window-header-line-height	header
to-code	to-code
x-display-list	display
set-text-properties	text
image-current-frame	current
file-readable-p	p
set-face-attribute	attribute
-count	
kill-append	kill
display-pixel-width	display
switch-to-next-buffer	to
-remove-last	last
next-single-property-change	single
find-file	find-file
adjust	adjust
site-run-file	site
load-average	average
dir-locals-set-class-variables	locals
posn	posn
dump	dump
shrink-window-if-larger-than-buffer	than
rehash	rehash
window-bottom-divider-width	window
dired-kept-versions	versions
set-file-extended-attributes	set
read-from-minibuffer	read
-clone	clone
file-name-sans-extension	name
font-lock-remove-keywords	remove
string=	string=
font-lock-remove-keywords	lock
image-flush	flush
get-internal-run-time	run
indent-code-rigidly	indent
invisible-p	p
round	round
setcar	setcar
5	5
assq-delete-all	all
search-forward	forward
tq-create	create
2.1	2.1
put-charset-property	property
indent-tabs-mode	indent
looking-back	looking
help-char	help
gv-define-setter	setter
cancel	cancel
require-final-newline	require
window-configuration-p	window
x-bitmap-file-path	file
member-ignore-case	case
font-xlfd-name	name
fundamental-mode	mode
s-matched-positions-all	s
substring-no-properties	properties
hash-table-weakness	hash
delete-horizontal-space	space
replace-match	replace
matched	matched
format-args	format-args
byte-compile-dynamic-docstrings	compile
word-search-forward	forward
unlispify	unlispify
stringp	stringp
replacement	replacement
buffer2	buffer2
s-word-wrap	s
set-buffer-multibyte	set
juxt	juxt
remove	remove
posn-point	posn
advice-remove	remove
window-display-table	table
process-send-string	string
mode-only	mode-only
file-symlink-p	symlink
minibuffer-complete-and-exit	complete
fix	fix
inhibit-startup-echo-area-message	echo
char	char
make-translation-table-from-alist	table
start1	start1
use-mouse-action	use-mouse-action
buffer-live-p	buffer
dir-locals-set-class-variables	dir
squeeze-after	squeeze-after
s-split-up-to	s
definitions	definitions
special-variable-p	special
positions	positions
truncate-partial-width-windows	width
encode-coding-region	encode
libxml	libxml
push	push
display-mouse-p	display
find-file-noselect	file
move-to-window-line	move
find-file-literally	find
controlling-tty-p	tty
add-to-invisibility-spec	add
help-line	help-line
-reduce-r-from	r
context	context
ewoc-delete	delete
window-dedicated-p	dedicated
destroy-fringe-bitmap	fringe
number-to-string	to
backup	backup
string-equal	equal
set-fringe-bitmap-face	face
make-string	string
delete-terminal	delete
backing	backing
ewoc-goto-node	goto
unregister	unregister
delimited-flag	delimited-flag
hack-dir-local-variables	local
allowed	allowed
numberp	numberp
standard	standard
auto-save-visited-file-name	visited
wildcards	wildcards
set-frame-width	set
-on	
set-buffer-modified-p	modified
posn-area	posn
process-exit-status	status
remove-text-properties	remove
-update-at	update
play-sound-file	play
find-coding-systems-for-charsets	coding
kill-read-only-ok	only
font-get	font
-iterate	iterate
kept-new-versions	new
string-to-syntax	syntax
selected-frame	frame
file-in-directory-p	in
terminal-live-p	live
12	12
syntax-ppss	ppss
local-key-binding	local
set-process-buffer	process
file-expand-wildcards	expand
missing-ok	missing-ok
header	header
completion-auto-help	completion
33	33
buffer-size	buffer
divider	divider
end-of-defun	of
window-next-buffers	next
special-mode	special
case-fold	case-fold
charset-plist	charset
newdef	newdef
-partition-by-header	partition
frame-live-p	live
indicate-buffer-boundaries	boundaries
omit-nulls	omit-nulls
excluded	excluded
global	global
erase-buffer	buffer
groups	groups
dir-locals-set-class-variables	set
command	command
gethash	gethash
get-lru-window	get
read-buffer-completion-ignore-case	read
10.4	10.4
map-y-or-n-p	p
mark-even-if-inactive	even
select-frame-set-input-focus	set
default-input-method	method
buffer-enable-undo	undo
dir-locals-set-class-variables	variables
imenu-add-to-menubar	to
-split-on	
process-send-eof	send
markers	markers
-first	first
next-char-property-change	char
special-form-p	form
write-abbrev-file	file
current-active-maps	active
read-string	string
subtract	subtract
make-frame-on-display	make
next-window	window
backup-buffer	buffer
-first	
system-name	system
undo-strong-limit	undo
previous-history-element	history
minibuffer-selected-window	window
compare-buffer-substrings	compare
terminal-parameter	terminal
history	history
edebug-trace	edebug
find-coding-systems-for-charsets	for
describe-current-display-table	table
frame-resize-pixelwise	resize
create-file-buffer	file
libxml-parse-xml-region	xml
zone	zone
insert-for-yank	yank
compare-buffer-substrings	substrings
remote	remote
shrink-window-if-larger-than-buffer	shrink
23	23
auto-save-visited-file-name	name
vconcat	vconcat
font-lock-remove-keywords	font
branch	branch
variable	variable
smie-down-list	down
overlay-recenter	overlay
substitute-in-file-name	in
split-window-sensibly	sensibly
unhandled-file-name-directory	name
switch-to-buffer-preserve-window-point	buffer
reverse	reverse
minor-mode-key-binding	minor
right	right
object2	object2
modes	modes
find-backup-file-name	backup
local-unset-key	key
set-category-table	set
saved	saved
buffer-offer-save	offer
-grade-up	grade
fit-frame-to-buffer	to
minibuffer-complete-and-exit	exit
feature	feature
match-end	end
-max-by	max
same	same
day	day
paragraph-start	start
bitmaps	bitmaps
syntax-table	syntax
delete-minibuffer-contents	delete
char-syntax	syntax
switches	switches
documentation	documentation
switch-to-buffer-other-window	window
-dotimes	
shadows	shadows
buffer-name	buffer-name
tab-width	width
edebug-all-forms	edebug
backtrace-frame	frame
-map-first	first
string-match	match
marker-buffer	buffer
clear-visited-file-modtime	modtime
face-italic-p	p
reduce	reduce
substitute-key-definition	key
set-window-dedicated-p	dedicated
posn-actual-col-row	actual
set-mouse-position	mouse
detect	detect
and	and
send-string-to-terminal	send
access-type	access-type
-partition-all-in-steps	partition
path	path
y-or-n-p-with-timeout	y
push-button	push
region-beginning	region
match-data	match
mouse-position	position
minibuffer-complete-and-exit	minibuffer
adaptive-fill-mode	adaptive
gap	gap
bool-vector-subsetp	subsetp
before	before
display-buffer-base-action	action
temporary-file-directory	file
advice-mapc	mapc
char-table-subtype	subtype
dired-kept-versions	kept
no-enable	no-enable
generate	generate
uid	uid
posn-actual-col-row	posn
-any?	any?
window-state-put	state
imenu-add-to-menubar	menubar
separate	separate
pretend	pretend
window-state-get	get
17.9	17.9
redraw	redraw
skip-chars-backward	chars
struct	struct
scroll-right	scroll
auto-save-timeout	timeout
find-coding-systems-region	systems
s-split-up-to	to
window-margins	margins
vars-vals	vars-vals
-filter	
no-remap	no-remap
advertised	advertised
decode-coding-string	decode
set-category-table	category
display-color-cells	color
tool-bar-local-item-from-menu	local
face-italic-p	italic
window-vscroll	vscroll
comments	comments
current-minor-mode-maps	minor
field-end	field
kill-new	new
use-local-map	use
parameter	parameter
tool-bar-local-item-from-menu	menu
sequencep	sequencep
process-tty-name	process
posix-looking-at	at
unlock	unlock
1.8	1.8
syntax-descriptor	syntax-descriptor
set-file-acl	file
fundamental	fundamental
sit-for	for
24	24
edebug-continue-kbd-macro	edebug
user	user
-find-last-index	index
-elem-index	elem
only-global-abbrevs	global
-zip	zip
number	number
make-obsolete-variable	make
time-less-p	p
balance-windows-area	balance
save	save
convert-standard-filename	standard
index	index
start-file-process-shell-command	command
delete-terminal	terminal
hash	hash
insert-abbrev-table-description	abbrev
process-send-string	process
file-in-directory-p	file
string-to-unibyte	unibyte
display-mouse-p	p
glyph-char	char
backward-sexp	sexp
case-table-p	case
coordinates-in-window-p	p
set-process-query-on-exit-flag	query
node	node
define-abbrev	define
skip-chars-forward	skip
completion-boundaries	boundaries
-some-->	>
find-operation-coding-system	operation
visited-file-modtime	modtime
word-search-forward-lax	word
rm	rm
charset-plist	plist
pos-visible-in-window-p	pos
get-buffer-window	get
list	list
backup-by-copying-when-mismatch	copying
s-with	s
ewoc-goto-node	ewoc
count-screen-lines	lines
file-modes-symbolic-to-number	modes
scroll-right	right
recursive-edit	edit
set-process-datagram-address	address
chars	chars
user-error	error
mouse	mouse
file-in-directory-p	p
posix-search-forward	posix
image	image
start-file-process	file
less?	less?
package	package
display-color-cells	display
trace	trace
set-case-syntax-pair	syntax
noerror	noerror
window-at	window
append-to-file	to
open-termscript	termscript
outside-margins	outside-margins
char-width	width
quietly-read-abbrev-file	abbrev
cache	cache
set-right-margin	right
garbage	garbage
pop-up-frame-function	up
-split-with	
flatten	flatten
display-buffer-use-some-window	some
select-window	select
run-hook-with-args-until-success	args
read-input-method-name	read
inhibit-startup-echo-area-message	message
batch-byte-compile	compile
x-display-list	x
with?	with?
status	status
derived-mode-p	derived
s-slice-at	at
select-frame-set-input-focus	frame
set-marker-insertion-type	set
yank-pop	pop
s-truncate	truncate
fill-context-prefix	fill
all?	all?
resource	resource
file-regular-p	regular
fit-window-to-buffer-horizontally	to
locate	locate
17	17
max-width	max-width
posn-object-width-height	height
down	down
base64-encode-region	encode
set-char-table-range	range
initial	initial
minibuffer-complete-word	word
fill-individual-paragraphs	fill
window-frame	frame
byte-code-function-p	byte
make-translation-table-from-vector	vector
integer	integer
window-pixel-edges	edges
y-or-n-p-with-timeout	timeout
ewoc-data	data
shr	shr
s-capitalize	s
coordinates-in-window-p	in
find-coding-systems-region	region
load-file	file
file-truename	truename
login	login
-zip-fill	fill
presence	presence
bindat-get-field	field
display-pixel-height	display
stop-before	stop-before
buffer-modified-tick	tick
raise	raise
uppercase?	uppercase?
read-file-name	name
31	31
21.1	21.1
edebug	edebug
args	args
-replace-last	replace
imenu	imenu
front-advance	front-advance
-difference	
ignore-case	ignore-case
smie-rule-next-p	next
read-key-sequence-vector	read
less	less
capitalize-region	region
same-window-p	same
delete-and-extract-region	delete
encode-time	encode
display-pixel-height	height
delete-and-extract-region	extract
delta	delta
upcase	upcase
remq	remq
insert-before-markers-and-inherit	insert
kill-region	kill
extensions	extensions
lookup	lookup
s-capitalized?	capitalized?
divisors	divisors
set-marker	marker
-group-by	group
make-translation-table-from-vector	make
pop-to-buffer	buffer
string-to-unibyte	string
format-network-address	format
completion-ignored-extensions	extensions
provide	provide
set-buffer-auto-saved	saved
location	location
overlay-buffer	overlay
window-left-child	window
current-buffer	buffer
set-marker-insertion-type	insertion
undo-limit	undo
make-indirect-buffer	indirect
rotate	rotate
tty	tty
register-read-with-preview	register
button-put	button
scroll-bar-event-ratio	scroll
waiting-for-user-input-p	user
yank-handled-properties	handled
sort-fold-case	sort
predicate	predicate
memory-limit	limit
19.6	19.6
describe-display-table	table
rules-function	rules-function
set-marker-insertion-type	marker
-split-on	on
provide-theme	theme
remove-text-properties	properties
coding-system-change-text-conversion	text
find-file-read-only	file
kill	kill
put-text-property	text
floatp	floatp
val	val
minor-mode-key-binding	binding
block	block
make-text-button	text
regexp	regexp
-take	take
set-char-table-extra-slot	char
special-form-p	special
previous-char-property-change	property
s-count-matches	matches
max-lisp-eval-depth	lisp
add-name-to-file	add
previous-history-element	element
set-window-prev-buffers	set
dash	dash
indent-tabs-mode	mode
-keep	keep
setq-local	setq
word-search-backward-lax	backward
arglist	arglist
invert	invert
20	20
file-selinux-context	context
defvar-local	local
define-obsolete-face-alias	obsolete
unhandled-file-name-directory	file
edebug-test-coverage	test
find-charset-string	find
flag	flag
looking-back	back
time-less-p	less
-interpose	interpose
set-face-stipple	stipple
kept-new-versions	versions
pop-up-windows	up
get-buffer-create	create
parse-sexp-ignore-comments	parse
set-keyboard-coding-system	system
fit-window-to-buffer	window
cdr-safe	safe
arrayp	arrayp
s-pad-left	left
minibuffer-inactive-mode	inactive
mapc	mapc
-last-item	last
fill-paragraph	fill
x-server-version	x
string-prefix-p	p
escape-from-edge	escape-from-edge
new-alias	new-alias
set-window-configuration	configuration
skip-chars-forward	forward
swap	swap
set-buffer	set
read-file-name-completion-ignore-case	ignore
key-description	description
fringe-bitmaps-at-pos	pos
number-of-newlines	number-of-newlines
process-file	process
compare-buffer-substrings	buffer
find-file-name-handler	find
redirect-frame-focus	frame
where	where
apply-partially	partially
modify-frame-parameters	frame
5.3.1	5.3.1
minibuffer-window	window
dir	dir
make-backup-file-name-function	backup
window-parent	parent
current-window-configuration	configuration
get-register	get
no-line-break	no-line-break
minibuffer-complete-word	minibuffer
parameters	parameters
map-y-or-n-p	n
try	try
clear-image-cache	cache
this-command-keys	keys
switch-to-buffer-other-frame	frame
function-name	function-name
-find-indices	
process-query-on-exit-flag	flag
rename-file	rename
s-truncate	s
undo-strong-limit	strong
font-spec	font-spec
interactive-form	form
read-kbd-macro	macro
listify-key-sequence	sequence
smie-precs->prec2	>prec2
smie-precs->prec2	precs
string-match-p	string
-juxt	juxt
display-buffer-below-selected	display
hash-table-rehash-threshold	rehash
display-color-p	p
find	find
set-process-filter	filter
posn-window	window
font-spec	spec
redraw-display	display
-mapcat	
regular	regular
jit-lock-unregister	lock
copy-file	file
even	even
paragraph	paragraph
kill-read-only-ok	kill
-each-indexed	
defined	defined
unzip	unzip
sentence	sentence
edebug-print-circle	print
buffer-live-p	live
count-screen-lines	screen
delete-frame	frame
face	face
edebug-on-quit	on
list-charset-chars	charset
19.9	19.9
pos-visible-in-window-p	visible
display-buffer-use-some-window	display
unintern	unintern
rassq-delete-all	rassq
form	form
recent-auto-save-p	recent
load-theme	theme
invisibility	invisibility
string-to-syntax	to
fit-window-to-buffer-horizontally	buffer
print	print
font-put	put
remove-images	images
type-of	type
switch-to-next-buffer	next
smie-rule-separator	separator
local-key-binding	key
current-idle-time	current
make-auto-save-file-name	auto
set-window-parameter	set
pos-visible-in-window-p	p
forward-list	list
enable-local-eval	local
trash	trash
shrink-window-if-larger-than-buffer	if
largest	largest
backup-by-copying-when-mismatch	mismatch
files	files
7.12	7.12
copy-sequence	copy
run-hook-with-args-until-success	until
signal-process	process
make-hash-table	table
map-y-or-n-p	y
expand	expand
set-keyboard-coding-system	set
bindat-ip-to-string	to
resume-tty	tty
decode-coding-string	string
set-frame-width	frame
unbury	unbury
lookup-key	lookup
standard-syntax-table	syntax
file-newer-than-file-p	newer
beep	beep
auto-save-default	auto
face-inverse-video-p	face
entry	entry
-cut	cut
expansion	expansion
escapes	escapes
posnp	posnp
eval-expression-debug-on-error	error
abbrev-table-p	abbrev
posix-search-forward	forward
ring-insert	ring
process-put	put
window-next-buffers	window
null	null
kill-read-only-ok	ok
lookup-key	key
transient-mark-mode	mode
window-next-buffers	buffers
debug-on-quit	on
+	+
remote-file-name-inhibit-cache	remote
%	%
memory	memory
activate-change-group	change
restore	restore
lock-buffer	buffer
start2	start2
backward-list	list
condition	condition
time-to-day-in-year	to
until	until
progress-reporter-done	done
search-forward	search
find-file-name-handler	name
button-has-type-p	button
frame-auto-hide-function	hide
read-directory-name	read
require-match	require-match
quietly-read-abbrev-file	read
set-process-query-on-exit-flag	process
19.2	19.2
fit-frame-to-buffer-margins	to
emacs	emacs
attributes	attributes
read-kbd-macro	kbd
arg	arg
lines	lines
insert-file-contents-literally	file
define-button-type	type
new-pos	new-pos
get-char-property-and-overlay	overlay
quietly-read-abbrev-file	file
exec	exec
-min-by	
scalable-fonts-allowed	fonts
remote-file-name-inhibit-cache	cache
initial-buffer-choice	buffer
buf	buf
derived-mode-p	p
define-generic-mode	generic
modified	modified
col	col
delete-to-left-margin	left
set-keyboard-coding-system	coding
horizontal	horizontal
overflow	overflow
adaptive-fill-regexp	fill
emacs-pid	pid
save-buffer	buffer
default-frame-alist	alist
byte-code-function-p	code
17.3	17.3
temporary-file-directory	temporary
process-send-eof	eof
file-exists-p	exists
unbury-buffer	unbury
s-titleized-words	s
replace-regexp-in-string	replace
active-minibuffer-window	window
char-table-subtype	table
blink	blink
default-value	value
process-running-child-p	child
fill-region-as-paragraph	paragraph
boundp	boundp
serial-term	term
window-min-width	width
scroll-left	scroll
frame-current-scroll-bars	scroll
notifications-close-notification	notification
set-file-acl	acl
ask-user-about-supersession-threat	ask
marker-insertion-type	type
s-titleize	s
substitute-in-file-name	substitute
s-pad-left	s
auto-save-list-file-prefix	file
string-bytes	bytes
looking-at-p	looking
compare-window-configurations	compare
backward-list	backward
modify	modify
children	children
inhibit-quit	inhibit-quit
same-window-buffer-names	names
s-collapse-whitespace	s
s-slice-at	s
graphic	graphic
lists	lists
6.1	6.1
color-values	color
ewoc-goto-prev	prev
of	of
sort-numeric-base	sort
docstrings	docstrings
convert-standard-filename	convert
command-line	command
-all?	all?
s-split-up-to	split
minibuffer-complete-word	complete
switch-to-next-buffer	switch
function-get	function
bindat-ip-to-string	ip
completing-read	completing
record-flag	record-flag
running	running
x-popup-dialog	x
switch-to-visible-buffer	to
image-current-frame	frame
previous-single-char-property-change	change
-drop	drop
coding-system-charset-list	system
version-control	control
17.10	17.10
debug-on-entry	debug
upper	upper
insert-register	register
defun	defun
eof	eof
-partition-all-in-steps	in
unlock-buffer	unlock
merge-face-attribute	attribute
set-input-method	set
custom-initialize-delay	initialize
set-process-query-on-exit-flag	on
event-click-count	event
set-process-buffer	set
window-header-line-height	line
call-process-shell-command	shell
y-or-n-p-with-timeout	p
initial-frame-alist	initial
button-has-type-p	type
window-vscroll	window
-product	
words-include-escapes	words
kind	kind
face-italic-p	face
suffixes	suffixes
offer	offer
read-regexp	read
after-save-hook	save
bindat-ip-to-string	bindat
make-button	button
case-replace	case
tool-bar-add-item	add
find-operation-coding-system	system
add-face-text-property	property
min	min
balance-windows-area	area
process-running-child-p	running
split-window-keep-point	window
date	date
discard-input	input
read-regexp	regexp
decode-char	char
jit	jit
s-concat	concat
cancel-change-group	change
delete-and-extract-region	and
set-face-inverse-video	video
27	27
file-name-extension	file
string-to-multibyte	multibyte
display-buffer-pop-up-frame	pop
define-abbrev-table	table
tool-bar-local-item-from-menu	item
quit-window	quit
copy-region-as-kill	copy
adaptive-fill-mode	fill
recent-keys	keys
add-face-text-property	face
set-transient-map	map
current-fill-column	current
s-reverse	reverse
set-mouse-pixel-position	mouse
replace-buffer-in-windows	in
gv-define-simple-setter	simple
defvaralias	defvaralias
help-text	help-text
run-at-time	at
13.1	13.1
smie-rule-parent-p	rule
mark-marker	mark
delete-field	field
unload-feature	unload
data	data
r	r
page-delimiter	page
char-table-subtype	char
steps	steps
s-word-initials	initials
try-completion	try
visited	visited
font-family-list	family
fun	fun
insert-file-contents	contents
write-abbrev-file	abbrev
with-temp-message	with
fit-window-to-buffer	fit
char-to-string	string
check-timers	check-timers
coordinates-in-window-p	window
pop-up-frames	frames
set-charset-priority	priority
results	results
window-resizable	window
12.11	12.11
truename	truename
enable	enable
fill-nobreak-predicate	fill
-take-last	
process-tty-name	tty
all-completions	completions
previous-complete-history-element	previous
inhibit-startup-screen	inhibit
-each-while	while
region-beginning	beginning
field-end	end
before-save-hook	before
rule	rule
create-fontset-from-fontset-spec	spec
define-key-after	after
6.8	6.8
tool-bar-add-item-from-menu	menu
compile	compile
set-buffer-modified-p	set
cdr	cdr
custom-theme-p	custom
2.5	2.5
-last-item	
read-buffer-completion-ignore-case	ignore
2.2	2.2
buffer-offer-save	save
set-default	default
only-global-abbrevs	abbrevs
supersession	supersession
re-search-forward	forward
local-unset-key	local
max-lisp-eval-depth	max
destroy-fringe-bitmap	destroy
set-display-table-slot	slot
ewoc-refresh	ewoc
-applify	applify
completion-table-with-cache	completion
2.8	2.8
case-table	case-table
stop-process	process
-tree-mapreduce-from	mapreduce
make-local-variable	variable
line-number-at-pos	at
18	18
yank-handled-properties	properties
prepare-change-group	change
hack-local-variables	local
abort-recursive-edit	recursive
default	default
action-alist	action-alist
>	>
tty-color-define	define
display-message-or-buffer	message
-unfold	unfold
detect-coding-region	region
rassq-delete-all	delete
filename1	filename1
run	run
describe	describe
current-left-margin	current
ask-user-about-supersession-threat	about
face-all-attributes	face
limit	limit
case-table-p	p
display-supports-face-attributes-p	supports
replace-buffer-in-windows	replace
switch-to-prev-buffer	switch
executable	executable
copy-tree	tree
display-buffer-pop-up-frame	display
volume	volume
window-total-width	window
mapcat	mapcat
format-network-address	address
color-supported-p	color
tty-color-clear	tty
redraw-display	redraw
goto	goto
exists	exists
delete-process	delete
type	type
-tree-map-nodes	tree
display-buffer-in-previous-window	display
standard-category-table	table
lax-plist-put	lax
file-accessible-directory-p	p
current-minor-mode-maps	mode
next-history-element	element
user-real-uid	user
-each-indexed	indexed
old-pos	old-pos
list-load-path-shadows	list
clear-this-command-keys	clear
3.3	3.3
make-byte-code	code
find-buffer-visiting	find
delay	delay
image-mask-p	mask
edebug-print-circle	edebug
face-attribute	attribute
-grade-up	up
custom-add-frequent-value	add
disable-theme	disable
set-window-start	set
backup-by-copying-when-linked	when
combine	combine
x-bitmap-file-path	path
scroll-down-aggressively	scroll
auto-save-visited-file-name	auto
s-slice-at	slice
mark-ring-max	max
frame-auto-hide-function	auto
write-file	write
tq-close	close
systems	systems
enable-local-variables	local
b	b
folder	folder
frame-current-scroll-bars	bars
inhibit-startup-echo-area-message	inhibit
s-wrap	wrap
vecp	vecp
3.4	3.4
scroll-step	step
read-char	char
copy-hash-table	table
copying	copying
then	then
file-name-completion	completion
read	read
ewoc-delete	ewoc
window-bottom-divider-width	bottom
colors	colors
get-process	get
1	1
x-display-list	list
interpose	interpose
set-frame-height	height
fit-frame-to-buffer-margins	buffer
scratch	scratch
run-hook-with-args	run
category	category
other	other
looking	looking
alist	alist
address	address
local-variable-if-set-p	local
styles	styles
integer-or-marker-p	marker
imagemagick-types-inhibit	imagemagick
posn-at-x-y	x
edebug-test-coverage	edebug
edebug-continue-kbd-macro	kbd
padding	padding
hack-dir-local-variables	hack
posn-timestamp	timestamp
s-replace	s
newer	newer
set-window-display-table	window
plist-member	plist
gv-define-setter	define
file-name-directory	directory
sentence-end-double-space	space
revert	revert
message	message
cdr-safe	cdr
overlay	overlay
delete-horizontal-space	horizontal
device	device
process-exit-status	process
notifications-close-notification	notifications
initial-buffer-choice	choice
range	range
string-prefix-p	string
smie-prec2->grammar	smie
buffer-file-name	file
tq	tq
equal-including-properties	properties
gv-define-simple-setter	gv
display-buffer-use-some-window	buffer
nodisp	nodisp
match-end	match
smie-rule-separator	rule
coding-system-charset-list	charset
window-min-width	window
indices	indices
down-list	down
buffer-disable-undo	undo
edebug-sit-for-seconds	edebug
17.4	17.4
current-input-mode	current
dired-kept-versions	dired
end2	end2
hash-table-size	table
double	double
take	take
user-real-login-name	name
backup-by-copying	backup
next-button	next
scroll-step	scroll
window-body-height	height
file-selinux-context	selinux
n	n
delete-region	delete
x2	x2
require-final-newline	newline
-cycle	cycle
truncate	truncate
hash-table-rehash-threshold	table
x1	x1
parse-colon-path	path
vertical-motion	vertical
clear-image-cache	clear
redirect-frame-focus	focus
window-resizable	resizable
objects	objects
parent	parent
force-mode-line-update	force
set-file-selinux-context	file
ewoc-goto-prev	goto
must-suffix	must-suffix
decode-coding-region	region
6.2	6.2
actor	actor
ring-ref	ring
set-syntax-table	set
-zip-with	
process-sentinel	process
decode-time	decode
stop-comment	stop-comment
buffer-chars-modified-tick	modified
disable	disable
hash-table-p	p
-reduce-from	
attribute-alist	attribute-alist
larger	larger
process-list	process
posn-actual-col-row	row
notifications-notify	notify
signature	signature
switch-to-buffer-preserve-window-point	to
posn-image	posn
balance	balance
-take-last	last
run-hook-with-args-until-failure	args
init	init
circle	circle
add-to-invisibility-spec	to
time-add	add
display-buffer-in-previous-window	buffer
string-or-null-p	null
set-syntax-table	syntax
x-parse-geometry	geometry
year	year
37	37
file-regular-p	p
blink-matching-open	blink
format-insert-file	file
area	area
display-buffer-pop-up-window	buffer
notifications-get-server-information	information
word-search-forward-lax	forward
x-server-version	server
1-	
create-lockfiles	create
run-hooks	run
indent-according-to-mode	to
opt	opt
s-word-initials	word
window-body-height	body
skip-syntax-forward	forward
dont-downcase-last	dont-downcase-last
invisible	invisible
top	top
startup	startup
string-bytes	string
advice	advice
delete-minibuffer-contents	contents
or	or
collect	collect
capitalized?	capitalized?
noauto	noauto
makehash	makehash
posn-object	posn
yes-or-no-p	no
regexp-quote	regexp
insert-buffer-substring-no-properties	properties
display-buffer-pop-up-window	up
princ	princ
set-file-extended-attributes	attributes
minibuffer-selected-window	minibuffer
extract	extract
file-exists-p	file
30	30
ring-p	p
delete-auto-save-file-if-necessary	necessary
backup-by-copying-when-linked	linked
remove-hook	hook
-cut	
x	x
previous-complete-history-element	history
bolp	bolp
1.4	1.4
define-obsolete-face-alias	alias
backup-by-copying-when-privileged-mismatch	copying
insert-buffer-substring-as-yank	buffer
file-name-sans-versions	sans
set-window-display-table	set
copy-tree	copy
load-average	load
tty-color-clear	color
completion-ignored-extensions	ignored
quit-window	window
char-table-p	table
restore-buffer-modified-p	modified
process-file-shell-command	command
switch-frame-ok	switch-frame-ok
category-set-mnemonics	mnemonics
prefer	prefer
backward-word	word
narrow-to-region	region
period	period
ewoc-location	location
window-state-get	window
get-pos-property	property
symlink	symlink
fetch-bytecode	fetch
butlast	butlast
window-tree	window
subtype	subtype
after-find-file-from-revert-buffer	after-find-file-from-revert-buffer
button-type-subtype-p	button
default-input-method	default
key-binding	key
advice-add	advice
completion-auto-help	auto
downcase-word	downcase
x-parse-geometry	x
paragraph-separate	separate
use	use
stop	stop
8.5	8.5
logxor	logxor
set-buffer-modified-p	buffer
shr-insert-document	insert
bool-vector-union	union
set-face-attribute	set
make-byte-code	make
select-frame-set-input-focus	input
delete-auto-save-files	files
-select-column	column
process-file	file
eval-expression-debug-on-error	on
void-text-area-pointer	pointer
switch-to-buffer-other-window	other
8.2	8.2
selective-display-ellipses	ellipses
fill-nobreak-predicate	nobreak
font-at	font
minibuffer-auto-raise	auto
-tree-mapreduce-from	tree
configuration	configuration
local-variable-if-set-p	variable
bidi	bidi
display-buffer-pop-up-frame	up
posn-object-x-y	x
display-selections-p	selections
setq	setq
text-coding	text-coding
keyboard-coding-system	system
skip-chars-backward	backward
describe-prefix-bindings	describe
process-status	process
switch-to-buffer-preserve-window-point	point
next-matching-history-element	next
ring-insert	insert
make-translation-table-from-alist	alist
buffer-swap-text	buffer
subclass	subclass
21.4	21.4
window-resize	resize
coding-system-list	list
format-seconds	format
adaptive-fill-first-line-regexp	fill
overlay-put	put
l	l
-reduce-r	r
start-file-process-shell-command	shell
make-vector	make
in-map	in-map
no-message	no-message
-partition-all	all
prodfn	prodfn
set-file-modes	file
relative	relative
rassq-delete-all	all
read-key-sequence-vector	vector
terminal-parameter	parameter
get-buffer-create	buffer
eval-expression-print-length	expression
image-animate-timer	image
about	about
*	*
same-window-p	window
invisible-p	invisible
custom-unlispify-remove-prefixes	custom
killp	killp
other-buffer	buffer
quit-restore-window	window
just-one-space	space
window-full-height-p	full
booleanp	booleanp
visited-file-modtime	visited
display-buffer-in-previous-window	in
s-replace	replace
window-state-put	put
looking-at-p	p
remove-from-invisibility-spec	remove
lazy	lazy
window-body-height	window
minimize-window	minimize
s-count-matches	s
find-file-other-window	file
maximize	maximize
scroll-preserve-screen-position	scroll
max-specpdl-size	size
max-lisp-eval-depth	eval
priority	priority
setplist	setplist
field-beginning	field
operation	operation
describe-mode	describe
set-char-table-extra-slot	set
exec-suffixes	suffixes
read-from-string	read
scroll-bar-mode	scroll
terminal-list	terminal
pop-up-frame-alist	frame
set-window-parameter	window
end-of-buffer	end
minibuffer-prompt	prompt
assq-delete-all	delete
set-buffer-auto-saved	set
-flatten-n	n
sit	sit
pixelwise	pixelwise
symbol-value	symbol
set-process-query-on-exit-flag	exit
find-coding-systems-string	find
newline-and-indent	newline
buffers	buffers
control	control
define-obsolete-function-alias	define
kept-new-versions	kept
advice-mapc	advice
end	end
exec-path	exec
describe-syntax	syntax
same-window-buffer-names	window
serial-process-configure	configure
add-to-list	list
help-buffer	help
posn-object-x-y	posn
20.2	20.2
overlay-recenter	recenter
greedy	greedy
make-backup-file-name-function	file
view-register	register
window-text-pixel-size	size
substring	substring
readable	readable
event-end	event
pop-to-buffer	to
keystrokes	keystrokes
-find-indices	find
calling	calling
add-to-ordered-list	ordered
put-text-property	property
rawfile	rawfile
edebug-unwrap-results	unwrap
make-frame-on-display	frame
string-to-multibyte	to
set-mouse-pixel-position	position
nosuffix	nosuffix
force	force
collapse	collapse
display-mm-dimensions-alist	mm
current-time	time
fset	fset
run-hook-with-args	hook
keymap-prompt	keymap
file-notify-rm-watch	notify
line-beginning-position	position
face-documentation	face
sort-lines	lines
image-flush	image
according	according
extended	extended
list-fonts	fonts
plist-get	get
format-network-address	network
minibuffer-prompt-width	width
whole	whole
insert-before-markers	before
smie-close-block	close
subexp-depth	subexp-depth
keymaps	keymaps
new-char	new-char
fetch-bytecode	bytecode
bindat-ip-to-string	string
window-dedicated-p	window
mouse-on-link-p	link
read-color	read
regexp-opt-charset	opt
min-height	min-height
coverage	coverage
thing	thing
primitive-undo	undo
filter	filter
barf	barf
smie-prec2->grammar	>grammar
double-click-time	time
auto-save-list-file-prefix	prefix
s-match	s
-select-by-indices	
versions	versions
major-mode	mode
member-ignore-case	ignore
file-name-nondirectory	nondirectory
posn-at-x-y	posn
s-trim	s
eval-expression-debug-on-error	debug
seq	seq
local-variable-if-set-p	if
frame-live-p	p
order	order
after-find-file	after
s-chop-suffix	chop
initial-buffer-choice	initial
safe	safe
modifiers	modifiers
clear	clear
list1	list1
backup-file-name-p	file
buffer-modified-tick	modified
macro	macro
just-one-space	just
prec2s	prec2s
reg	reg
word-search-forward	word
frames	frames
cddr	cddr
make-hash-table	make
underline-minimum-offset	underline
image-mask-p	p
string-or-null-p	p
expt	expt
how	how
window-top-line	line
next-single-char-property-change	next
waiting	waiting
partial	partial
29	29
indent-relative-maybe	maybe
get-window-with-predicate	with
make-backup-file-name	name
dynamic	dynamic
byte-compile-dynamic-docstrings	docstrings
get-process	process
backup-file-name-p	name
-concat	concat
auto-coding-functions	functions
delete-dups	delete
run-hook-with-args-until-failure	failure
buffer-file-name	buffer
minibuffer-window-active-p	active
special-mode	mode
ewoc-enter-before	ewoc
set-marker-insertion-type	type
beg	beg
line-number-at-pos	pos
process-attributes	process
delete-auto-save-files	auto
edebug-print-level	print
help	help
s-word-wrap	wrap
map-charset-chars	charset
edebug-trace	trace
write-char	write
edebug-global-break-condition	break
defun-prompt-regexp	defun
buffer-disable-undo	disable
compare-window-configurations	window
define-generic-mode	define
dump-emacs	dump
-reduce-r	
buffer-name	buffer
image-animate-timer	animate
process-send-region	region
count-words	words
set-face-underline	set
ftruncate	ftruncate
-drop-last	last
combine-and-quote-strings	combine
standard-syntax-table	table
window-top-line	window
ewoc-prev	prev
fill-context-prefix	prefix
make-frame	frame
queue	queue
ewoc-enter-first	enter
-select-columns	select
copy-hash-table	hash
lowercase?	lowercase?
minibuffer-prompt-end	end
keyword-list	keyword-list
read-variable	variable
initial-frame-alist	alist
integer1	integer1
previous-char-property-change	change
string-as-unibyte	as
color-defined-p	p
-not	
describe-buffer-case-table	table
buffer1	buffer1
fringe-bitmaps-at-pos	at
font-face-attributes	font
indentation	indentation
load-prefer-newer	newer
bool-vector-p	vector
justify-current-line	justify
forward	forward
distinct	distinct
edebug-on-quit	quit
fixup	fixup
defvar	defvar
posn-area	area
s-match-strings-all	strings
window-absolute-pixel-edges	edges
edebug-global-break-condition	global
from	from
font-at	at
bytecode	bytecode
posn-actual-col-row	col
update	update
locals	locals
edges	edges
preserve-modes	preserve-modes
old-char	old-char
sequence	sequence
buffer-string	buffer
lock	lock
continue-process	process
zlib-available-p	available
!cdr	!cdr
keep	keep
file-notify-rm-watch	watch
file-name-sans-versions	name
window-total-height	height
s-match	match
-replace-at	
called-interactively-p	called
define-package	package
edebug-setup-hook	hook
regexp-flag	regexp-flag
parse-sexp-ignore-comments	ignore
copy-region-as-kill	kill
coding-system-list	system
add-to-list	add
define-package	define
make-variable-buffer-local	make
network-interface-info	network
buffer-substring	substring
revert-buffer	buffer
add-to-invisibility-spec	spec
match-data	data
marker-position	marker
read-input-method-name	method
jit-lock-register	register
fit-frame-to-buffer	frame
mouse-on-link-p	on
full-directory-p	full-directory-p
mark-ring-max	ring
-partition-all	partition
descriptor	descriptor
obsolete	obsolete
custom-set-variables	custom
read-buffer-function	function
perform-replace	replace
smie-config	config
delete-overlay	overlay
-if-let	if
scalable	scalable
slice	slice
minibuffer-message	minibuffer
upcase-region	region
set-advertised-calling-convention	calling
posn-image	image
read-file-name-completion-ignore-case	case
file-name-sans-versions	versions
display-buffer-no-window	no
select-window	window
keyboard-quit	keyboard
set-input-method	method
make-temp-name	temp
process-live-p	p
looking-at-p	at
version-control	version
coding-system-list	coding
image-current-frame	image
-union	
warning-suppress-log-types	suppress
y-or-n-p-with-timeout	or
window-state-put	window
threat	threat
make-translation-table	translation
fns	fns
window-scroll-bar-width	window
bool-vector-count-population	vector
background-p	background-p
custom-theme-set-faces	faces
make-variable-buffer-local	variable
max-char	max
-butlast	
newline-and-indent	indent
next-screen-context-lines	next
make-backup-files	backup
set-process-filter	set
6.4	6.4
-lambda	lambda
hide	hide
imenu-add-to-menubar	imenu
file-locked-p	locked
prepare-change-group	prepare
smie-precs->prec2	smie
smie-config-save	config
revert-buffer	revert
set-charset-priority	charset
label	label
get-register	register
ring-remove	ring
sexp	sexp
default-file-modes	default
load-theme	load
read-char-choice	char
echo-keystrokes	keystrokes
set-display-table-slot	table
-mapcat	mapcat
barf-if-buffer-read-only	if
12.6	12.6
minibuffer-contents-no-properties	contents
current-global-map	current
literally	literally
pop-up-frame-function	function
file-symlink-p	p
make-backup-files	files
previous-history-element	previous
set-window-point	window
kill-buffer	kill
define-button-type	define
make-backup-files	make
just-one-space	one
fill-region-as-paragraph	region
sleep-for	for
Helper-help	help
vec	vec
set-buffer-multibyte	multibyte
match	match
custom-theme-set-variables	variables
sort-columns	columns
do	do
custom-theme-set-variables	set
fit-window-to-buffer	to
network-interface-info	info
defs	defs
s-less?	s
window-line-height	line
extension	extension
switch-to-next-buffer	buffer
deactivate	deactivate
lazy-completion-table	table
remove-hook	remove
progress	progress
obj	obj
idle	idle
run-at-time	time
this-command-keys	this
collection	collection
overlay-properties	properties
skip-syntax-backward	backward
char-width	char
define-alternatives	alternatives
display-supports-face-attributes-p	attributes
keep-margins	keep-margins
case-replace	replace
s-wrap	s
autoload-do-load	load
copy-hash-table	copy
file-modes-symbolic-to-number	number
custom-add-frequent-value	custom
x-popup-menu	menu
smie-prec2->grammar	prec2
max	max
define	define
match-string	string
font-face-attributes	attributes
buffer	buffer
adaptive-fill-first-line-regexp	adaptive
abbrev-table-p	table
all-frames	all-frames
make-translation-table	make
read-shell-command	shell
set-window-point	set
derived	derived
10.6	10.6
nobreak	nobreak
recenter-positions	positions
scroll-preserve-screen-position	screen
hour	hour
case	case
abs	abs
s-less?	less?
blink-matching-paren	blink
2.12	2.12
unbury-buffer	buffer
bool	bool
window-header-line-height	height
fill-nobreak-predicate	predicate
auto-save-default	save
initial-scratch-message	message
buffer-narrowed-p	buffer
-tree-map	tree
bidi-string-mark-left-to-right	mark
insert-file-contents-literally	insert
aggressively	aggressively
split-window-keep-point	point
s-pad-right	s
display-buffer-base-action	base
set-case-syntax	set
citation-regexp	citation-regexp
split-window-keep-point	keep
append-to-file	file
adaptive-fill-first-line-regexp	first
current-time	current
emacs-init-time	time
symbol-name	name
remapping	remapping
-select-by-indices	indices
s-replace-all	all
set-frame-selected-window	selected
eval-expression-print-length	length
constrain-to-field	to
date-leap-year-p	leap
after-find-file	find
yes-or-no-p	p
plist-put	plist
gv-define-simple-setter	define
substitute-in-file-name	file
pos-visible-in-window-p	in
mode-line-format	line
indent	indent
previous-frame	frame
pop-up-frame-function	pop
make-symbolic-link	make
move-to-left-margin	move
insert-file-contents-literally	contents
-pad	
decode-time	time
words	words
minibuffer-contents-no-properties	no
level	level
count-final-newline	count-final-newline
-take-last	take
partition	partition
keyboard-quit	quit
query	query
-each-while	each
multibyte-string-p	p
face-inverse-video-p	p
posn-object-width-height	posn
end-of-buffer	of
starting-name	starting-name
set-file-times	set
get-buffer-create	get
assoc-string	string
buffer-enable-undo	enable
list-fonts	list
default-file-modes	file
forward-sexp	sexp
batch	batch
keyword-args	keyword-args
display-warning	display
region	region
-when-let*	let*
put-image	put
smie-rule-parent	rule
scroll-bar-mode	bar
set-face-inverse-video	face
define-obsolete-function-alias	obsolete
-elem-index	
read-coding-system	coding
-partition-all-in-steps	all
switch-to-buffer-preserve-window-point	window
-same-items?	items?
window-pixel-left	left
4.4	4.4
filter-buffer-substring	substring
replace-buffer-in-windows	buffer
dups	dups
from-code	from-code
minibuffer-depth	depth
fn	fn
frame-live-p	frame
standard-category-table	standard
6.3	6.3
let	let
add-face-text-property	add
same-window-buffer-names	buffer
hash-table-count	table
image-mask-p	image
insert-buffer-substring-no-properties	buffer
font-xlfd-name	font
switch-to-prev-buffer	buffer
file-name-sans-versions	file
minibuffer-window	minibuffer
internal	internal
set-window-display-table	display
s-prepend	s
key-regexp	key-regexp
double-click-time	click
find-file-name-handler	handler
nodes	nodes
s-dashed-words	words
char-table-parent	table
smie-rule-next-p	p
get-buffer-window	window
face-remap-reset-base	base
-tree-reduce	tree
describe-buffer-case-table	case
fontset	fontset
code	code
kill-process	process
current-face	current-face
fill-region-as-paragraph	fill
primitive-undo	primitive
bool-vector-subsetp	vector
-partial	partial
pop-up-frame-function	frame
delete-region	region
line	line
fit-frame-to-buffer-margins	fit
mode-line-format	mode
delete-trailing-whitespace	trailing
unset	unset
get-largest-window	get
check-coding-system	coding
minutes	minutes
reindent-then-newline-and-indent	reindent
bool-vector-count-population	count
pop-up-frame-alist	alist
scroll-bar-event-ratio	bar
define-button-type	button
sort-columns	sort
s-capitalized?	s
add-hook	hook
preserve	preserve
exec-path	path
char-table-parent	char
-some	some
stream	stream
10.2	10.2
7	7
insert-directory	directory
italic	italic
call-process-shell-command	process
set-window-point	point
window-absolute-pixel-edges	pixel
replace-match	match
font-face-attributes	face
scroll-conservatively	scroll
move-marker	marker
nlistp	nlistp
append	append
window-current-scroll-bars	current
process-name	process-name
recursive-edit	recursive
definition	definition
read-key	key
make-auto-save-file-name	name
animate	animate
make-overlay	overlay
seed	seed
decode-coding-region	decode
focus-follows-mouse	focus
move-marker	move
get	get
to-file	to-file
keyboard-translate	translate
set-file-modes	set
color-values	values
difference	difference
read-shell-command	read
omit-port	omit-port
split-window-keep-point	split
recent-auto-save-p	save
-none?	
restore-buffer-modified-p	restore
lambda	lambda
libxml-parse-xml-region	parse
display	display
mouse-position	mouse
blink-matching-paren	matching
mark-even-if-inactive	if
s-pad-left	pad
lax-plist-put	put
category-docstring	category
sort-numeric-fields	numeric
display-message-or-buffer	buffer
make-category-table	category
seconds	seconds
bnf	bnf
garbage-collect	garbage
-table-flat	table
keep-time	keep-time
view-register	view
subst-char-in-region	in
info	info
merge	merge
display-buffer-at-bottom	display
stipple	stipple
map-y-or-n-p	map
make-translation-table	table
-same-items?	same
shrink	shrink
posn-point	point
add-name-to-file	name
value	value
find-backup-file-name	file
display-pixel-width	width
window-next-sibling	sibling
serial	serial
global-key-binding	key
overlay-put	overlay
ewoc-goto-prev	ewoc
backup-by-copying-when-privileged-mismatch	mismatch
property	property
buffer-live-p	p
num	num
handled	handled
set-right-margin	set
s-left	s
ewoc-create	create
button-label	label
functions	functions
recursion	recursion
imagemagick-types-inhibit	inhibit
let*	let*
put-char-code-property	char
tabs	tabs
category-set	category-set
date-leap-year-p	p
clear-this-command-keys	this
-flatten-n	
hook	hook
len	len
display-save-under	under
error-symbol	error-symbol
debug-on-quit	debug
custom-theme-set-variables	custom
find-coding-systems-for-charsets	find
word-search-forward	search
adaptive	adaptive
base64-encode-string	base64
text-char-description	text
video	video
-cons*	
syntax-table-p	p
window-dedicated-p	p
var	var
window-start	window
coding-system-charset-list	coding
custom-unlispify-remove-prefixes	unlispify
local-key-binding	binding
-drop-last	drop
hookvars	hookvars
next-single-char-property-change	char
s-with	with
skip-syntax-forward	syntax
need-vector	need-vector
make-backup-file-name	make
replace-regexp-in-string	in
imagemagick-types	types
get-unused-category	category
x-bitmap-file-path	bitmap
timer	timer
weakness	weakness
progress-reporter-done	reporter
backup-by-copying-when-privileged-mismatch	privileged
custom-theme-set-faces	set
file-attributes	attributes
display-buffer-below-selected	buffer
abbrev-put	put
-max-by	by
bury-or-kill	bury-or-kill
minibuffer-inactive-mode	minibuffer
indicate-buffer-boundaries	buffer
smie-rule-next-p	smie
smie-setup	setup
describe-buffer-case-table	buffer
delete-overlay	delete
interactively	interactively
window-bottom-divider-width	width
add-to-list	to
list-load-path-shadows	load
function	function
window-pixel-edges	window
display-message-or-buffer	or
face-remap-remove-relative	face
window-minibuffer-p	minibuffer
only	only
mixedcase?	mixedcase?
disassemble	disassemble
s-ends-with?	ends
number-to-string	number
word-search-backward-lax	lax
-zip-with	zip
before-save-hook	save
base-buffer	base-buffer
clear-image-cache	image
edebug-all-defs	all
interactive-p	interactive-p
set-case-syntax-pair	pair
record-regexp	record-regexp
inhibit	inhibit
func	func
display-supports-face-attributes-p	display
make-directory	make
props	props
initials	initials
set-file-extended-attributes	extended
make-translation-table-from-vector	table
abbrevs	abbrevs
s-mixedcase?	mixedcase?
number-or-marker-p	or
string-to-unibyte	to
intern-soft	intern
insert-abbrev-table-description	insert
break	break
find-font	find
make-symbol	symbol
-intersection	
progress-reporter-update	update
bidi-string-mark-left-to-right	bidi
s-lowercase?	lowercase?
beginning-of-defun	beginning
2.16	2.16
make-text-button	make
read-char-choice	read
concat	concat
progress-reporter-done	progress
mode-and-header-line	mode-and-header-line
after-save-hook	after
sort-subr	sort
display-pixel-height	pixel
newline	newline
string-prefix-p	prefix
abbrev-prefix-mark	abbrev
run-hook-with-args-until-success	run
check-coding-system	system
-map-first	map
s-ends-with?	with?
delete-auto-save-file-if-necessary	delete
sort-fold-case	fold
-partition-all-in-steps	steps
mismatch	mismatch
resizable	resizable
easy	easy
xml	xml
depth	depth
beginning-of-defun	defun
justification	justification
delete-horizontal-space	delete
find-image	find
no-cursor-in-echo-area	no-cursor-in-echo-area
indicate	indicate
posn-col-row	col
insert-before-markers	markers
s-center	center
put-charset-property	put
s-split-words	s
get-buffer-process	process
write-file	file
window-prev-sibling	sibling
bottom	bottom
gc-cons-percentage	gc
generate-new-buffer-name	generate
warning-suppress-log-types	log
set-text-properties	set
case-table-p	table
make-frame-invisible	frame
locale-info	info
minibuffer-contents	contents
smie-close-block	smie
component	component
run-hook-with-args-until-success	with
elements	elements
file-name-extension	extension
digit-argument	argument
id	id
scalable-fonts-allowed	allowed
move-to-left-margin	to
back	back
32	32
process-plist	process
posn-object	object
list2	list2
simple	simple
current-group	current-group
current-frame-configuration	current
minibuffer-prompt-end	prompt
active-minibuffer-window	active
network	network
-split-with	with
population	population
debug-on-error	debug
buffer-chars-modified-tick	tick
abbrev-file-name	name
easy-menu-define	easy
ewoc-set-hf	hf
not-selected	not-selected
display-buffer-at-bottom	at
find-buffer-visiting	buffer
set-terminal-parameter	terminal
debug-on-event	debug
switch-to-buffer-preserve-window-point	preserve
narrow	narrow
display-buffer-no-window	display
provide-theme	provide
-tree-map	map
ordered	ordered
debug-on-error	error
9.2	9.2
set-terminal-parameter	parameter
file-name-directory	name
iconify	iconify
use-float	use-float
lessp	lessp
icon	icon
s-split-words	words
-elem-indices	elem
window-header-line-height	window
button-end	end
set-buffer-multibyte	buffer
copy-abbrev-table	abbrev
define-obsolete-face-alias	define
paragraphs	paragraphs
thing-at-point	point
window-full-height-p	height
multibyte-string-p	multibyte
process-id	id
display-color-p	color
file-notify-rm-watch	rm
byte-to-position	to
35	35
ldexp	ldexp
expand-abbrev	abbrev
scroll-up-command	up
map-y-or-n-p	or
-unfold	
separation	separation
mapconcat	mapconcat
charsets	charsets
set-buffer-auto-saved	auto
overflow-newline-into-fringe	overflow
edebug-continue-kbd-macro	continue
binding	binding
get-charset-property	charset
text-properties-at	text
make-indirect-buffer	make
invert-face	face
-partition-all-in-steps	
start-file-process-shell-command	process
sort-regexp-fields	regexp
process-exit-status	exit
separator	separator
initialize	initialize
frame-auto-hide-function	function
tq-close	tq
imagemagick-enabled-types	enabled
pos-or-prop	pos-or-prop
abort-recursive-edit	abort
insert-buffer-substring-as-yank	insert
notifications-get-server-information	get
for-call-interactively	for-call-interactively
fetch	fetch
posn-col-row	row
framep	framep
make-byte-code	byte
underline-minimum-offset	offset
parse-colon-path	colon
key	key
memory-limit	memory
minibuf	minibuf
syntax-after	after
syntax	syntax
visible	visible
test	test
send	send
clrhash	clrhash
posn-at-x-y	y
previous	previous
set-file-times	file
ratio	ratio
local-set-key	key
at	at
set-window-fringes	fringes
detect-coding-region	detect
-flatten	
tool-bar-add-item-from-menu	tool
encode-coding-region	coding
eol	eol
backup-option	backup-option
group-gid	gid
next-single-char-property-change	change
1+	1+
read-passwd	read
smie-bnf->prec2	bnf
tool-bar-add-item-from-menu	bar
exit-recursive-edit	exit
flush	flush
s-upper-camel-case	upper
enable-local-variables	enable
barf-if-buffer-read-only	read
garbage-collect	collect
3.1	3.1
set-case-syntax	syntax
-min-by	min
insert-buffer-substring	insert
backup-file-name-p	backup
resume-tty	resume
tool-bar-add-item-from-menu	from
threshold	threshold
fit-frame-to-buffer-margins	margins
global-key-binding	binding
sentence-end-double-space	sentence
fill-context-prefix	context
display-buffer-pop-up-window	pop
abbrev-insert	abbrev
minibuffer-auto-raise	raise
contains?	contains?
expand-file-name	expand
display-save-under	display
minimum	minimum
average	average
auto-save-visited-file-name	save
find-file-wildcards	wildcards
special	special
setcdr	setcdr
set-process-plist	process
mini	mini
guess	guess
backup-by-copying	copying
-dotimes	dotimes
string-lessp	string
registry	registry
-zip-fill	
select-frame-set-input-focus	select
intersection	intersection
category-table-p	p
shrink-window-if-larger-than-buffer	window
description	description
repeat	repeat
byte-recompile-directory	directory
window-child	child
38	38
variables	variables
backup-by-copying	by
cancel-change-group	group
prop	prop
initial-frame-alist	frame
custom-theme-set-variables	theme
this	this
s-presence	s
warning-suppress-log-types	types
scroll-margin	scroll
send-string-to-terminal	string
smie-bnf->prec2	smie
marker-insertion-type	marker
zlib	zlib
s-capitalize	capitalize
set-file-selinux-context	set
local	local
abbrev-table	abbrev-table
17.8	17.8
edebug-initial-mode	mode
eolp	eolp
values	values
12.12	12.12
symbol-value	value
obsolete-name	obsolete-name
create-fontset-from-fontset-spec	from
local-variable-if-set-p	p
narrowed	narrowed
hack-local-variables	hack
8.1	8.1
pad	pad
next-overlay-change	change
regex	regex
file-relative-name	relative
file-symlink-p	file
window-in-direction	in
zlib-available-p	p
continue	continue
this-command-keys-vector	command
imagemagick-enabled-types	imagemagick
exec-suffixes	exec
prev	prev
file-executable-p	executable
set-face-underline	underline
set-frame-selected-window	set
face-id	face
in-string	in-string
minibuffer-complete-and-exit	and
describe-syntax	describe
integers	integers
fonts	fonts
font-xlfd-name	xlfd
assq-delete-all	assq
normal-mode	mode
s-replace-all	s
window-min-size	size
base-modes	base-modes
indexed	indexed
time-subtract	time
abbrev-get	get
tty-color-define	color
s-concat	s
face-remap-reset-base	remap
cookie	cookie
force-mode-line-update	line
current-window-configuration	window
make-syntax-table	table
columns	columns
set-file-acl	set
1.3	1.3
string<	string<
images	images
fit-window-to-buffer	buffer
keyboard-translate	keyboard
pred	pred
enabled	enabled
controlling	controlling
smie-rule-bolp	bolp
parse-colon-path	parse
13.3	13.3
modify-frame-parameters	modify
single	single
eobp	eobp
edit	edit
tty-color-define	tty
frame-pointer-visible-p	visible
propertize	propertize
window-minibuffer-p	window
keys	keys
number-or-marker	number-or-marker
set-window-dedicated-p	p
other-window	window
prompter	prompter
called-interactively-p	interactively
thing-at-point	thing
tabulated-list-init-header	list
frame-visible-p	frame
subst-char-in-region	region
get-charset-property	get
keep-record	keep-record
color-supported-p	supported
destination	destination
indent-relative-maybe	relative
edebug-test-coverage	coverage
set-frame-width	width
backtrace-debug	backtrace
character	character
group-real-gid	gid
dired	dired
menu	menu
multibyte-string-p	string
prefixes	prefixes
event-click-count	click
frame-visible-p	visible
backtrace-debug	debug
call-interactively	interactively
-group-by	by
buffer-narrowed-p	p
glyph-char	glyph
list-charset-chars	list
integer-or-marker-p	or
line-beginning-position	beginning
scroll	scroll
map-charset-chars	map
12.9	12.9
make-overlay	make
subfeatures	subfeatures
sleep	sleep
base-only	base-only
window-inside-edges	inside
column	column
get-charset-property	property
copy-overlay	copy
pop	pop
barf-if-buffer-read-only	buffer
writable	writable
double-click-time	double
comment-list	comment-list
load-file	load
delete-auto-save-file-if-necessary	file
waiting-for-user-input-p	waiting
search-backward	backward
list-of-strings	list-of-strings
float-time	time
describe-display-table	describe
terminal-live-p	p
backup-by-copying-when-privileged-mismatch	by
face-remap-set-base	remap
hash-table-p	hash
major	major
ewoc-enter-before	enter
insert-buffer-substring-as-yank	substring
set-face-inverse-video	inverse
next-button	button
12.1	12.1
-select-by-indices	by
notifications-get-server-information	server
face-remap-set-base	face
window-live-p	live
encode-time	time
char-table-p	p
delete-blank-lines	blank
-intersection	intersection
1.7	1.7
safe-length	safe
detect-coding-region	coding
as	as
set-case-syntax-delims	case
next-matching-history-element	history
isnan	isnan
window-resize	window
10.8	10.8
indent-rigidly	indent
float	float
regexp-opt-charset	regexp
minibuffer-contents-no-properties	properties
create-file-buffer	create
copy-abbrev-table	table
10.1	10.1
describe-bindings	bindings
camel	camel
process-type	process
-list	list
debug-on-event	event
mod	mod
char-to-string	to
read-from-string	string
termscript	termscript
-remove-first	remove
base-url	base-url
soft	soft
window-pixel-edges	pixel
base	base
ewoc-enter-before	before
find-file-wildcards	file
decode	decode
coding	coding
put-char-code-property	property
process-plist	plist
before-save-hook	hook
scroll-margin	margin
edebug-on-quit	edebug
fill-individual-paragraphs	individual
minor-mode-key-binding	key
failure	failure
s-matched-positions-all	all
sound	sound
scan-lists	scan
window-pixel-width	width
value2	value2
re	re
remove-images	remove
ignored	ignored
fit-frame-to-buffer	buffer
kill-read-only-ok	read
-separate	
add-to-ordered-list	to
map-char-table	table
put-image	image
add-name-to-file	to
imagemagick-enabled-types	types
set-file-selinux-context	selinux
controlling-tty-p	p
current-frame-configuration	frame
window-live-p	p
next-matching-history-element	element
window	window
face-font	face
warning	warning
buffer-narrowed-p	narrowed
splice	splice
standard-case-table	table
s-prepend	prepend
fill-region-as-paragraph	as
noselect	noselect
byte-recompile-directory	byte
trailing	trailing
rassq	rassq
remote-file-name-inhibit-cache	file
set-keymap-parent	set
s-matched-positions-all	matched
default-justification	default
edebug-initial-mode	initial
-copy	copy
reenter	reenter
edebug-all-defs	defs
read-char	read
frame-pointer-visible-p	frame
-all?	
-elem-indices	
archives	archives
replace-buffer-in-windows	windows
dirname	dirname
tool-bar-add-item-from-menu	item
s-shared-start	shared
symbol	symbol
set-terminal-coding-system	system
copy-alist	copy
choice	choice
set-text-properties	properties
find-file-noselect	find
resolvers	resolvers
set-process-sentinel	process
convert	convert
set-window-buffer	window
emacs-init-time	init
real	real
indirect-function	indirect
rassoc	rassoc
char-table-extra-slot	table
site	site
macrop	macrop
13.2	13.2
notify	notify
force-mode-line-update	update
make-temp-name	name
comparator	comparator
system-groups	groups
get-buffer-process	buffer
raise-frame	raise
one-window-p	one
scan	scan
window-top-line	top
method	method
input-pending-p	pending
endkeyfun	endkeyfun
window-full-height-p	p
image-type-available-p	p
same-window-regexps	same
quit-restore-window	quit
warning-suppress-log-types	warning
focus	focus
coding-system-p	p
font-spec	font
blink-matching-open	open
face-font-registry-alternatives	alternatives
re-search-backward	backward
process-query-on-exit-flag	exit
regexp-quote	quote
previous-char-property-change	char
set-process-buffer	buffer
margin	margin
search	search
default-frame-alist	default
set-window-configuration	set
edebug-initial-mode	edebug
pop-up-windows	pop
assoc-default	assoc
set-left-margin	left
-table-flat	
unfold	unfold
bool-vector-intersection	vector
edebug-all-defs	edebug
name	name
make-variable-buffer-local	buffer
base64-decode-region	decode
-let*	
add-to-invisibility-spec	invisibility
interface	interface
ewoc-enter-first	ewoc
disable-command	command
-find-last-index	last
buffer-or-name	buffer-or-name
apply	apply
combine-and-quote-strings	strings
set-face-attribute	face
-reduce-r-from	
point-min-marker	marker
adaptive-fill-first-line-regexp	line
-tree-map-nodes	nodes
progress-reporter-update	reporter
make-translation-table-from-vector	from
syntax-ppss-toplevel-pos	toplevel
sig	sig
button-type	button
serial-process-configure	process
-tree-map-nodes	
blink-matching-paren	paren
run-hook-with-args-until-failure	until
fontset-spec	fontset-spec
upcase-initials	upcase
skip-syntax-backward	syntax
!cons	!cons
individual	individual
configure	configure
frame	frame
-remove-last	remove
face-remap-set-base	base
fixedcase	fixedcase
smie-merge-prec2s	smie
overflow-newline-into-fringe	fringe
delete-auto-save-file-if-necessary	save
perform	perform
process	process
defun-prompt-regexp	regexp
var-val	var-val
set-window-display-table	table
beginning-of-line	line
date-leap-year-p	date
times	times
-juxt	
eval-minibuffer	minibuffer
tty-color-approximate	color
unibyte	unibyte
eval-expression-print-length	eval
-splice	splice
smie-rule-bolp	smie
customizations	customizations
window-configuration-frame	configuration
window-configuration-p	configuration
temporary	temporary
nomsg	nomsg
sentinel	sentinel
noundo	noundo
combine-and-quote-strings	quote
-unzip	unzip
display-mouse-p	mouse
-each-indexed	each
previous-property-change	previous
-not	not
process-sentinel	sentinel
file-truename	file
listp	listp
find-file-literally	literally
called	called
document	document
debug-on-quit	quit
delete-to-left-margin	delete
current-message	current
debug-on-error	on
vendor	vendor
make-keymap	make
window-current-scroll-bars	window
direction	direction
sit-for	sit
skip-syntax-backward	skip
next-single-property-change	next
olddef	olddef
valid	valid
subst	subst
command-line	line
when	when
display-selections-p	display
base64-encode-string	string
watch	watch
find-file-read-only	find
button-type-subtype-p	subtype
temp	temp
disable-theme	theme
seconds-to-time	seconds
next-char-property-change	property
set-fontset-font	fontset
default-input-method	input
make-hash-table	hash
yes	yes
not	not
-is-infix?	
window-margins	window
custom-unlispify-remove-prefixes	prefixes
set-display-table-slot	set
-iteratefn	iteratefn
left-margin	margin
face-font-family-alternatives	alternatives
mouse-on-link-p	mouse
strong	strong
auto-coding-alist	coding
gc-cons-threshold	gc
completion-table-with-cache	cache
inhibit-startup-screen	startup
window-next-sibling	next
tty-color-approximate	approximate
encode-coding-region	region
visit	visit
convention	convention
help-setup-xref	help
inhibit-null	inhibit-null
-unzip	
process-send-region	send
delete-blank-lines	delete
motion	motion
-prodfn	prodfn
frame-parameter	frame
current-only	current-only
next-history-element	next
16	16
hack-local-variables	variables
process-put	process
next-single-char-property-change	property
program	program
text-properties-at	properties
sentence-end	sentence
overlays-in	in
chop	chop
s-chop-suffix	s
lru	lru
add-to-ordered-list	add
position	position
dialog	dialog
transient-mark-mode	transient
x-server-vendor	server
action	action
modtime	modtime
frexp	frexp
text-properties-at	at
file-relative-name	name
x-popup-dialog	dialog
window-state-get	state
file-expand-wildcards	file
-contains?	
re-search-forward	re
substring-no-properties	no
buffer-end	end
minibuffer-contents	minibuffer
user-login-name	name
fit	fit
10.7	10.7
shared	shared
auto-save-list-file-prefix	save
category-set-mnemonics	set
drop	drop
network-interface-info	interface
digit-argument	digit
recenter-top-bottom	bottom
filename2	filename2
-copy	
generate-new-buffer-name	new
s-presence	presence
minibuffers	minibuffers
next-window	next
file-extended-attributes	file
compare-window-configurations	configurations
car-safe	safe
9.1	9.1
put-char-code-property	put
debug-on-entry	entry
no	no
terminal-name	terminal
process-send-region	process
base-variable	base-variable
create-fontset-from-fontset-spec	create
-if-let	
locale-info	locale
4.2	4.2
completion-in-region	region
special-variable-p	p
posn-object-width-height	object
input-method	input-method
jit-lock-unregister	unregister
offset	offset
display-mm-width	width
12.2	12.2
defined-colors	defined
windows	windows
re-search-forward	search
decode-coding-region	coding
logb	logb
display-buffer-no-window	window
lazy-completion-table	lazy
whitespace	whitespace
syntax-table	table
window-scroll-bar-width	width
prev-buffers	prev-buffers
display-table-slot	table
set-window-vscroll	window
inhibit-capture-property	inhibit-capture-property
group-real-gid	real
adaptive-fill-function	fill
next-single-char-property-change	single
make-temp-name	make
done	done
>grammar	>grammar
ewoc-invalidate	ewoc
find-file-literally	file
set-process-datagram-address	process
make-directory	directory
indent-for-tab-command	tab
next-screen-context-lines	screen
define-category	category
smie-merge-prec2s	merge
-reduce-r	reduce
do-auto-save	do
vector	vector
mark-even-if-inactive	inactive
set-window-dedicated-p	set
-zip	
backward	backward
category-docstring	docstring
insert-buffer	buffer
overlays-at	at
adaptive-fill-mode	mode
balance-windows-area	windows
current-local-map	map
literal	literal
kill-region	region
frame-pointer-visible-p	pointer
get-char-property-and-overlay	get
time-less-p	time
inhibit-startup-echo-area-message	area
syntax-after	syntax
write-char	char
warn	warn
delete	delete
rep	rep
switch-to-buffer-other-frame	buffer
process-live-p	process
delete-auto-save-files	delete
Snarf-documentation	Snarf
no-mini	no-mini
backup-by-copying-when-mismatch	when
tool-bar-add-item-from-menu	add
posix-looking-at	posix
noconfirm	noconfirm
-concat	
library	library
target-depth	target-depth
send-string-to-terminal	to
sleep-for	sleep
pair	pair
parse-partial-sexp	partial
next-overlay-change	next
for	for
-none?	none?
lwarn	lwarn
delete-trailing-whitespace	whitespace
5.3	5.3
-clone	
-select-column	
current-local-map	local
redisplay	redisplay
start-file-process	process
color-supported-p	p
rename-buffer	rename
current-fill-column	column
e	e
attribute	attribute
insert-before-markers-and-inherit	before
-tree-seq	tree
intern-soft	soft
ring	ring
current-idle-time	time
markerp	markerp
-drop-while	drop
vscroll	vscroll
minibuffer-inactive-mode	mode
s-shared-start	s
-if-let*	
buffer-string	string
initial-scratch-message	scratch
a	a
default-value	default
-orfn	
file-name-completion	name
available	available
get-pos-property	get
set-face-stipple	face
frame-number	frame-number
backtrace	backtrace
equal-test	equal-test
edebug-global-break-condition	edebug
backup-by-copying-when-linked	copying
smie-rule-separator	smie
assq	assq
->>	
setup	setup
-partition-by-header	by
-flatten-n	flatten
step	step
tokens	tokens
field-beginning	beginning
preds	preds
previous-complete-history-element	complete
put-char-code-property	code
shell	shell
font-family-list	font
number-sequence	sequence
downcase	downcase
window-inside-edges	edges
edebug-setup-hook	setup
switch-to-visible-buffer	buffer
-when-let*	
mode-line-format	format
active	active
quit	quit
all	all
button-type-subtype-p	type
terminal-name	name
display-screens	screens
tab-to-tab-stop	stop
get-window-with-predicate	get
abbrev-prefix-mark	prefix
window-parameter	window
parse-sexp-ignore-comments	sexp
symbol-plist	plist
kept	kept
set-case-syntax-delims	syntax
halt-test	halt-test
command-remapping	command
follows	follows
contents	contents
posn-object-x-y	y
yank-pop	yank
file-name-absolute-p	name
ring-ref	ref
minibuffer-window-active-p	minibuffer
set-window-dedicated-p	window
byte-compile-dynamic-docstrings	byte
read-buffer-function	read
close	close
reuse	reuse
3.2	3.2
s-shared-start	start
eval-expression-debug-on-error	expression
minibuffer-prompt-width	minibuffer
safe-length	length
before-p	before-p
constrain-to-field	constrain
set-terminal-coding-system	coding
get-lru-window	window
completion-styles	completion
minibuffer	minibuffer
insert	insert
unibyte-string	unibyte
-partition-by-header	
suppress	suppress
completion-boundaries	completion
ask-user-about-supersession-threat	supersession
old	old
endrecfun	endrecfun
iconify-frame	frame
make-indirect-buffer	buffer
backward-delete-char-untabify	backward
=	=
suspend-emacs	emacs
mode	mode
-	
s-center	s
make-translation-table-from-alist	make
19.8	19.8
-flatten	flatten
point-min	min
nth	nth
sort-numeric-fields	sort
current-input-mode	input
slot	slot
enable-recursive-minibuffers	enable
current-indentation	indentation
&optional	&optional
font-family-list	list
shrink-window-if-larger-than-buffer	buffer
completion-ignored-extensions	completion
pop-up-frame-alist	up
apply-partially	apply
merge-face-attribute	face
names	names
hash-table-weakness	weakness
suspend-emacs	suspend
map-char-table	char
other-buffer	other
s-append	s
imagemagick	imagemagick
s-starts-with?	with?
match-substitute-replacement	replacement
custom-initialize-delay	delay
enable-command	enable
ewoc-prev	ewoc
run-hook-with-args-until-success	hook
xlfd	xlfd
coding-system-change-text-conversion	system
modify-frame-parameters	parameters
file-name-sans-extension	sans
display-buffer-no-window	buffer
numeric	numeric
locate-library	library
keyboard-coding-system	keyboard
fringe-bitmaps-at-pos	bitmaps
read-coding-system	read
bindat	bindat
gc-cons-percentage	percentage
nosep	nosep
query-flag	query-flag
key-description	key
store	store
center	center
read-quoted-char	char
read-string	read
posn-at-x-y	at
current-justification	justification
user-real-login-name	user
posix-search-forward	search
precs	precs
insert-buffer-substring-as-yank	yank
tick	tick
seconds-to-time	to
push-mark	mark
command-loop	command-loop
preceding	preceding
plist-member	member
prec2	prec2
necessary	necessary
quote	quote
display-screens	display
exp	exp
buffer-enable-undo	buffer
window-combination-limit	window
following	following
get-unused-category	unused
initial-value	initial-value
types	types
display-buffer-in-previous-window	window
process-send-eof	process
>=	>=
syntax-ppss-toplevel-pos	syntax
set-mouse-pixel-position	set
copysign	copysign
set-terminal-parameter	set
yank	yank
lsh	lsh
char-table-extra-slot	extra
completions	completions
format-seconds	seconds
-iteratefn	
specs	specs
s-lines	lines
overflow-newline-into-fringe	newline
do-auto-save	auto
gc-cons-percentage	cons
read-directory-name	directory
body	body
find-charset-region	find
s-upper-camel-case	camel
self-insert-command	insert
edebug-global-break-condition	condition
join-following-p	join-following-p
enable-recursive-minibuffers	recursive
face-font	font
7.1.9	7.1.9
buffer-name	name
no-redraw-on-reenter	no
lazy-completion-table	completion
fill-individual-paragraphs	paragraphs
3.5	3.5
-remove-first	
remote-file-name-inhibit-cache	inhibit
-partition-by	by
scalable-fonts-allowed	scalable
face-inverse-video-p	inverse
same-window-buffer-names	same
buffer-size	size
confirm	confirm
bidi-string-mark-left-to-right	right
previous-property-change	change
buffer-chars-modified-tick	chars
s-titleize	titleize
substrings	substrings
equal-including-properties	including
buffer-modified-tick	buffer
mouse-movement-p	mouse
register-read-with-preview	preview
get-buffer-process	get
same-window-regexps	window
-rotate	
define-key-after	key
delete-blank-lines	lines
read-shell-command	command
logand	logand
quoted	quoted
file-acl	file
file-name-nondirectory	name
-distinct	distinct
replace-regexp-in-string	string
16.5	16.5
debug-ignored-errors	debug
inhibit-eol-conversion	conversion
smie-rule-parent-p	p
unique	unique
frame-auto-hide-function	frame
inside	inside
hash-table-p	table
use-global-map	use
one-window-p	p
shell-quote-argument	quote
s-starts-with?	s
get-unused-category	get
server	server
prepend	prepend
split-window-sensibly	split
unhandled	unhandled
set-frame-height	set
set-mouse-pixel-position	pixel
next-frame	frame
-if-let*	if
copy	copy
display-buffer-pop-up-window	window
sort-regexp-fields	fields
libxml-parse-xml-region	libxml
