--include	process syntax simplified file specified defaults pattern read include match files full option form normal rules ruleparsing directories rule filter patterns allow
-timeout	load seconds specify time resources wait
-baseurl	used url relative base urls specify
demand	submodules non-negative internally option populated provide commits gitmodules controls (see used $num$ default temporarily value fetched new conditions git-config recurse-submodules
prefix	set chain give b/ prefix individual names file destination filename displaying archive subject whose given source_prefix certificate fetching extract show / prepend write source certificates instead foo match files temporary paths use a/ standard submodule printed characters path line copy beginning [<subject-prefix>] name embedded created url messages patch informative signature
timefmt	timestamps format specified display using
sleep	execution suspend time interval
-cat	files concatenate indicated format read write single result file specified
datestring	rev-list git corresponding string min-age= max-age= parse date output parameter
driveinfo	information relevant associated targeted drives lists device raid disk
--compress	letting use set compression level default compress see explicitly instead specify
spec	provided given create new data image size
tablespace	specifies database default remove tablespace new define
-nrequest	default unlimited number server exit requests receiving ocsp
--restore	read initial keystrokes filename
contextname	context option -c notification present nondefault sent name
exfat	system new file construct exfat
cmd	cmd followed process argument path id -e use arguments instead remote rsh option running using execution optional must last name default $loc$ command $num$
upload	specifies via non-default exec=<upload-pack> run given git end handled passed used fetch-pack repository clone ssh path specify remote side command git-upload-archive accessed fetch
--recursive	effect
--break	pairs complete rewrite create break changes delete
-repository	directory information use kexts repository
--role	specifies used name dump create role
submodules	gitmodules temporarily fetched submodules generation diff non-negative provide populated controls new conditions git-config used option commits internally default (see value ignore recurse-submodules changes $num$
-stats	separated statistics comma display
--branch	head repository pointing created pointed point cloned branch instead newly name
rolename	specifies used name dump create role
--previous	specifies development builder iteration localizations incremental purpose interface document previous
--suffix	files use used .suf suffix -b default specified allows filenames backing generated option .patch using override instead backup .gz ~
textutil	text utility
+	given invoked followed abs trace modules + list argument sign current start added plus set bytes seek first
--prefix	prepend prefix including specified filename trailing archive string given prefixed -i / . files creating option implicitly use (usually generated characters using unique /) explicit contain directory identifier dot
new	rename new named old class
-kernel	given kernel_file link
metadata	bridges objective-c generator metadata
mem	specifies files used temporary resorting amount internal memory sorts disk hashes
createdb	new create postgresql database
-recover	containing corresponding certificate created image -certificate secret specified keychain specify
iconv	conversion set character
--cflags-64	c provides generating custom flags passed annotations 64-bit compiler
active	specifies applied brought cause regarded packets timer packet reset filter idle link therefore determine activity data demand-dialing mode
path	pointing show xcode installed prefix disc displaying find destination-path submodule writes outside input folder match build read first number .plist using burns $loc$) name gui tar-1.14 remove informative output .dist tar-1.14.90+ signing list relative computer result specified extract .pmdoc compile rsync .class package-info content nib enough version strip-path foo told check run written commits use base git-dir interface path distribution last zip package current messages design-time resulting signature packagemaker requests changes explain user specifies image requirement replace names strip given entitlement script leading xar extraction copied files flat metapackage option form part remote specify info chdir modified signed project record stopwords resources install accessed embed root extracting $loc$ codesign process stripped pathnames file exclude git-file -classpath archive contents machine binary built subdirectory fetching prepend write valid take document strip-components node used temporary paths may bundle uses printed scripts data synonym builder components sets directory (default $num$ came
--fixup	autosquash use rebase construct commit message
getsid	returns sid associated takes options
incdir	compilation passed command option directly
k	specifies name k $loc$ list ect place file debug kernal resize log
nulls	specifies sort nulls non-nulls
splitpartition	destructively volume multiple split partitions
term	term minimum length
kextstat	status kernel kexts extensions loaded display
tr	translate characters
-ce	index usmuserengineid set create mib used table usmusertable entry part view snmpv3
-ca	information used corresponding certificate revocation ca specified number -caserial file indexfile serial options -cacreateserial
newfs	exfat ms-dos system construct fat file new
total	sectors number system file device total size
unit	ppp0 ppp1 number connections etc ppp sets interface outbound unit name
-cp	statistics synonym name show wellknown string new specified value alias set either path protocol -classpath usmuserpublic user
auid	audit records given id select
to	patch mails given savepoint appear provide series make breaking back new no-thread threads reply avoids mail message-id roll first
ddthh	files attribute creation time modification output specify metadata
lwp	large files fetch web
init	execute shell repository script create line existing git command specified initialize reinitialize passing one serial empty
datadir	specifies system location file directory configuration data
-v	specifies debugging 1.0 1.1 number ipp session 2.2 2.1 2.0 operation verbose information use protocol label version print program used filesystem volume characters particular name level default $loc$ mode sets $num$
call	read $loc$ options file
dns	domain addresses supply one mdns service & two acting dns test discovery option tool dns-sd pppd name windows clients allows server multicast microsoft
type	-rw four disc string notation fat records using attribute-type (one resource decimal remove specific hosts architecture output deleting specifies set erase static specified backup-type continually mode arch_type inspect standard key change definition four-character starts turn resulting hexadecimal backup simple number another strip files code terminated use script data interpret type empty fork enable tool bulk udf particular 16 structures attribute-value fetch debugging prompt universal indicates scanned file null binary media 32) designating octal instead mapping user characters inserted types numbered eject macroman drive place sets 0x55455955 operate $num$
until	exclusive named show commits top two limit inclusive) output (bottom
slapindex	database reindex slapd entries
warn	handle signed specify tags
word	map word excluded texts create appended stop_word_file repetitively generated command evaluated words specified print found data parsed
mb	buffer megabytes trace resize mb
mm	files attribute creation time modification output specify metadata
work	specifies files used temporary resorting amount internal memory sorts disk hashes
ms	domain samba addresses option supply windows wins clients allows two server pppd acting dns internet services one microsoft name
uustat	status control uucp inquiry
root	directory path package
--origin	origin use remote name repository track upstream keep using instead
--footnote	info node style end separate defined according default put output footnotes
--message	msg commit use message given
plist	matching property union values builder object id plist member class export listed specified interface descending document apply properties either
indir	directory job $loc$ submit working
enc	specifies parameters routines curve symmetric cipher elliptic encoded
end	none transaction current records generated expire specify time date commit rrsig
verify	information compute checksum image list value stored compressed verify archive read-only
--extract	files named embedded certificate displaying extracts specified write individual signature certificates .xml chain document extract cwd subdocument name
config	specifies information named set installation repository get libcurl global uses file directory configuration options slapd
maxfail	terminate attempts n failed connection consecutive
lam	files laminate
x509	signing display certificate utility
-cert	add request certificate filename
hdid	backing service driver store hdi
dappprof	profile function user lib usage
--bom	files links directories devices bom specified copy present
arch	specifies droplet set applet arch_type things universal strip operate architecture-specific $num$ create used target architecture file specified binaries arch properties thin
wins	samba addresses option supply windows wins clients allows two server pppd acting internet services one microsoft name
deletesec2group	control given group name settings principal removing thus access table entry security delete snmpv3
--poer	specifies domain socket extension listening tcp server connections unix file local port
iosnoop	i/o events snoop occur
--write	builder update write resulting file specified interface path document batched
hidden	hidden number sectors
passwdfile	use complete simple passwdfile authentication password contents
-set	specifies use set outputting certificate things self number signed used architecture serial architecture-specific arch properties
-uid	specifies attribute used uid user
l	disables forbidden specified file allowed counts -u -l + - current listing available option host link user commands list invoking command enables
timeout	set dump i/o locks attempts table pap authenticate connection closed shared option means seconds acquire pppd peer beginning wait forever stdin allows maximum n idle limit timeout time $num$ silently
indexfile	index containing revocation certificate format text ca information file indexfile
debug	debugging enable level defined specified messages debuglevel debug-level turn see details sets debug $num$ slapd
lappend	variable onto elements list append
--address	bind outgoing daemon socket address
authreq	pap set default maximum number transmissions n $num$ authenticate-request
--css	style reference read stdin - html file output include generate css
--min	junk files none smaller help avoid transferring rsync length minimum term file specified small tells size
+c	dialect associated name process initial character number supplied maximum column unix command printed defines
network	set network leading frame request ipxcp number without 0x ipx n hexadecimal configure
+d	files specifies search complete open output cause directories contains list fds instances depth file descriptors directory exclude include lsof listing
packetsize	specifies bytes data number sent
dst	kernel set saving value daylight time
"group1	use groups administrative privileges computer listed determine local
size	sector set force file text image number cluster num io specified converting font tells size provided given smaller log transfer create help system per track split rich new files junk used buffer transferring rsync fat small buffer_size data resize block-size info specify sectors avoid default checksum larger bytes points plain debug fixed $num$ block
smb	determines desktop flag directory home mounted
dsa	processing key dsa
stderr	stream $loc$ standard write file error
-engine	ecparam reference thus obtain ec specified id req needed pkcs8 initialising cause pkcs7 dsa engine string x509 functional spkac unique attempt specifying
-kfile	none
ipptool	perform requests printing protocol internet
osacompile	compile osa applescripts language scripts
days	available information commands days revocation create update number field used fresh minutes nextupdate
filter	specifies changed determine dump rewrite packets demand-dialing pass packet brought used performed file allowed need asserted matching select index submodule unknown regarded pairing check rewriting may contents copied type unmerged sent therefore files reset added deleted modify symlink broken regular link commit data applied received c b branches environment cause ...) tree modified timer filter renamed idle r u mode activity x entries
signature	produced add message signature
-ncols	using logging display columns mode
grade	grade transfer set command file
--document	use locale c translating default keywords output document texinfo
mnthome	appleshare mount directory home afp correct privileges
--id	unique identifier package
service	specifies logging name service purposes
attach	device attach image disk
top	information processes top update number print sorted display
--in	patch mails given appear provide series make breaking new no-thread threads reply avoids mail message-id first
toc	xml dump xar header file specified
listen	notification listen
-inform	specifies present certificate format x509 change command expect input -req normally options crl
--recurse	submodules non-negative internally option populated provide commits controls used default temporarily value fetched new conditions recurse-submodules
--root	directory path package
--arch	files represent (either plain universal size ppc64 checksum ppc i386 architecture file specified print archval binaries displaying mach-o contents thin
keyword	used tar posix.1-2001 modify header handles extended archives way keywords
minvalue	determines sequence clause value minvalue minimum optional generate
idle	specifies disconnect seconds n pppd idle link
rpcinfo	report information rpc
bridge	bridges objective-c generator metadata
--after	files newer show contiguous parse num trailing containing git max-age= -between parameter store rev-list corresponding string matches commits groups date line recent lines specific place output
-tgtimagekey	pair image $loc$ specify created
seed	set checksum $loc$ prefer -4 seed ipv4 advanced
inherit	parent adds target form specified new child table
clusterdb	cluster postgresql database
slaptest	openldap suitability .conf file check slapd
seek	start bytes seek abs
strength	specifies strength key value
realm	realm service bind kerberos authentication sasl principals id specify
-	:, preceded followed modules argument module sign affected given invoked set. - current logmasks corresponding trace containing removed name list minus first
-port	requests ocsp port listen
aes-256	algorithm default encryption particular specified type specify
glob	shell glob pretend matching command listed commit line refs glob-pattern
object	tagged one comma file select whose containing specification contained filtered extended handle tags matches object given tokens records regular path specify delimited pathname expression
-excludedelements	used (the quoted context) list single argument need generated html specify usually shell elements
regular	filter adds file
letter	attribute one attribute-letter file following gets bits
scripts	directory path copied package scripts
--inter	thereby hunks show lines number context specified close diff fusing
responder	url responder specify
m	control specifies set methods rewrite kernel manage supplement numbers file table ipx activates index use create alternate sequential memory dsa node enable hash complete respectively processing break disable joins particular join nested-loop forbids pairs scan h mount n merge scans changes delete
nbytes	debug log resize
-setalias	alias certificate sets
dot	files merge corresponding ._* native
-len	stop octets len writing
--fill	info default lines break num characters $num$
--file	signing codesign process parse file specified message displaying archive use writes visit send take files may given meaning part output device path specify info execute $loc$) f -, list modified signature commit (default
authcdn	dn used selecting lists access appropriate session specify test clauses identity
-oid	containing identifiers additional object oids file
pkg	flat metapackage package file path distribution .dist
--run	code run script tags without using <?..?> php
pkn	hashes protect used created keys encrypted image list identified hexadecimal public specify
--perms	enabled
folder	xcode $loc$ current sets path folder
crl2pkcs7	certificates create pkcs#7 structure crl
personality	kernel named kext personalities send
pk2	hashes protect used created keys encrypted image list identified hexadecimal public specify
pk1	hashes protect used created keys encrypted image list identified hexadecimal public specify
stop	map excluded create stop_word_file texts command evaluated words specified found parsed
--reference	reference repository setup $loc$ obtain machine objects local automatically
--mainline	merge considered mainline cherry-pick cannot know usually side
--name	named run-time -c form shorter sets parameter
dumpall	postgresql script database cluster file extract
bar	bar value ini entry foo define
patch	e-mail patches prepare submission
--table	tables reindex dump views cluster clean sequences table analyze matching
resizevolume	volume resize non-destructively
architecture	building use target architecture specified
-cakey	certificate ca private sign key sets
-scheme	scheme build schemename specified
bitvector	given trace modules module points specify
num	protocol show non-zero -c -m except explicitly o(n^2) matches break advanced term name level directories list -4 added set force contiguous connections see num extract targets rsync errors version letting processing groups interface checksum $loc$ etc cert place options named ppp0 ppp1 prefer number ppp occurrences diff unit size quit use compression certificate leading ipv4 files option line must info default require n minimum delete process lines seed file serial trailing tells containing outbound length potential split instead -between used time compress characters older request sets $num$
result	function rows set-returning returned number estimated change
subject	[<subject-prefix>] use patch prefix instead line standard subject
addrtype	node information addresses rather icmpv6 echo-request query generate
--cleanup	commit message cleaned option sets
--rsync	machine remote rsync run specify
filename	keystrokes text global symbols causes issuer xml keychain exclusion parameters send source add pkcs#7 input nodes include ca resources tests format read listed entries using name settings list remove server mode output crl specifies signing set dump library sign syslog specified extract matching append ocsp selected supplied filename current pem certificates shared newly full use standard key x log sending commands snoop plugin overrides messages pathname signature load named variables number private one header names table ecpg subdocuments given additional certificate xar initial visit oids identity sealed gives building option received search pppd extensions encoded specify info none save default der created signed record sent signer collecting debugging tar defined well file serial parsed defines containing self firmware targets write extracted build place keys symbol object bundle signkey user characters data structure searches remember rules pkcs#12 identifiers request patterns sets
--thread	mails appear addition subsequent make replies controls headers second references in-reply-to first
param2	sub-directory relative amount output distribution changes
wc	count character line word byte
nsec	tolerated seconds times range response options specify ocsp
-bulkerase	disc terminated prompt eject starts -rw drive continually bulk erase mode another media inserted
repairmirror	repair given set raid whose adding newdevice exported mirror device new degraded disk raidvolume uuid
--grep	log matches commits ones limit pattern specified output message expression regular
nseq	create sequence examine certificate netscape
planner	major statistics modules system timing print query relating
indexlist	elements option list sublist tcl specified proper must
country	country-code option equivalent .net argument -h using .whois-servers
-ndays	available information used revocation nextupdate number days field fresh minutes
keysize	specifies number authentication key bits size
ncpus	specifies use threads number
cvmkfile	create pre-allocated file
diff	regex instead use word delimit working show etc changes commits changed tree runs considering commit mode words using diff decide non-whitespace
--incremental	specifies builder prior incremental take interface document localizations
-rand	files containing used rand_egd socket generator random number (see seed file data $num$ egd
incrementalfile	specifies builder prior incremental take interface document localizations
sourcelanguage	specifies language resultant source xliff document
trigger	definition belonging configure firing remove forms trigger table change
erasedisk	one partitioning scheme file existing removing containing writing volume erase volumes new disk empty system
rgid	real given group name records id select
--reuse	information creating log timestamp object existing including take authorship commit message reuse
dtruss	process syscall details
input	specifies requirement lsm private existing file specified zone create add categories new classify map passwords format key input one present input_files created output
--command	named jobs list requesting command execution
--tags	$loc$ branches show respectively refs pretend remote-tracking command listed (, found commit line respectively) tags
slapauth	string-represented $loc$ list ids ldap check
n	code partial consider show option numbering connect prefix spaces rechallenge integer protocol echo-reply re-initiating nested disconnect patches send writing failed one-line candidates samples input local merged first n*1024 returned lcp format timestamp showing possible terminate break transmissions every presume import using unique restart authenticate-request insert receiving name renames over-load bytes attempts timeout output queues system specifies kernel abbreviated set -x509 frame request packet configure-request challenges elements descriptions mtu ipx shown detect network outputting routing progress slots size available full tags seconds commits fast-import committish jbod objects threads peer generate change wait digits diffs pairs actual signed tapes created column many 0x script messages days terminate-request connection context leading hexadecimal changes retransmission block (default echo-requests statements number copies header ppp names frames message unit diff-tree considering use git van log certificate needed addition positive create inclusive three start echo-request terminates certain decompression xsan milliseconds enable 40-byte complete form received pppd compression link dead ipv6cp consecutive cases given specify must diff-raw configure-rejects determines default challenge maximum devices n descriptor idle n=20) limit sent certify display delete control debugging $loc$ rewrite indent well describe html configure-naks reconstructed chap numbers file serial finishes pap receive nak self means jacobson rejects valid branch transmit instead node used time populate may object driver ipxcp generated authenticate value rows recent kernel-level mru interval lines options ipcp without command comes configure sets traffic nx512 starting $num$ usual
0x####	information verbose program mode print operation
ip	specifies subnet peers used ip packets use send without allow address interface given authenticating
is	given default cat enabled zcat standard also without let behave output input copy data change
iv	digits use actual string hex iv represented comprised must
conf	one program configuration option tlid inetd wrong unable suspect .conf file uses tcpdmatch find specify network
in	files grep open output pager matching
id	load ecparam set reference mails generation series iokitpersonalities within thus functional ec existing cfbundleidentifier used file specified no-thread matching select subject whose given described appear would script provide make breaking id req needed pkcs8 initialising mail cause pkcs7 dsa engine usmuserengineid avoids string index x509 kext modify executable new obtain records job part threads spkac key reply known immediately unique operations identifier attempt look unload resource usmusertable kexts patch token place specifying resulting fork output specifies message-id first
if	foreign-data domain family sequence text parser exist operator table index conversion wrapper throw trigger role template type schema function dictionary mapping tablespace user aggregate configuration class search language rule server cast error view
cvdbset	control tracing program cvdb
xattr	attributes extended display manipulate
--to	specifies encoding header add output email headers
filtered	whose tagged handle tags object filtered specify
ipxcp	system set number configure rejects nak request ipxcp send maximum frames n local options
pluginpath	load level plug-ins located valid pluginpath plug-in found first
--src	given show a/ source prefix instead
cycle	error word calls nextval sequence maximum value return key specified reached optional
recurse	gitmodules fetched option populated commits submodules (see controls $num$ new git-config
maxconnect	available control protocol network seconds terminate n connection traffic comes first
-so	stream $loc$ standard write file output
--stop	map excluded create stop_word_file texts command evaluated words specified found parsed
-si	input use $loc$ file standard
gzip	files compress expand
-se	stream $loc$ standard write file error
tracepoint	tracing enable modules tracepoints indicated
protocol	specifies particular used protocol name session show $loc$ number value alias generated version either key sets statistics wellknown
photo	images full-color
--grade	grade transfer set command file
--until	rev-list parse git corresponding string older commits show specific min-age= date output parameter
yes	use set buffer unaligned system i/o file caching yes
cherry	apply commits introduced changes existing
--filter	-f adds file-filtering $loc$ repeated rule filter .rsync-filter add dir-merge file filter=
-shadow	use image primary file shadow conjunction data
opt	opt set option algorithm value key public
lcp	echo-requests frame number dead configure-request set echo-reply returned given retransmission terminate-request send valid instead receiving sent option lcp seconds echo-request pppd transmissions every configure-naks presume peer restart configure-rejects default interval maximum n without timeout starting $num$
-pass	source pkcs#12 password file output
stopfile	trace stop snapping stopfile file appears
euid	given name effective records user id select
ditto	create archives directory hierarchies copy extract
renames	detect renames
-subject	files attribute output subject specify metadata
hunk	thereby hunks show lines number context specified close diff fusing
createuser	new account postgresql user define
--tablespace	specifies default tablespace database
security	function access given group name settings whether removing thus change control principal definer entry sasl security snmpv3 table properties specify delete
old	rename new named old class
computerid	add domain computerid specified
begin	code run processing lines start transaction input php block
escape	specifies control regardless map transmission certain character escaped whether characters peer async requests
--rfunction	function information name shows
cnt	files cnt cvdbout.000000 cvdbout writing starting overwrite
--convert	rename new named old class
-extfile	containing use extensions certificate file
track	track number sectors per
foo	bar value ini entry foo define
repository	reference repository setup $loc$ obtain machine objects local automatically
burn	burning media image burn attached device disc file directory optical burns valid
--default	given use user arg instead parameter
properties	sasl security properties specify
-addreject	prohibited use adds
o	digits form 0t switched 0x.. decimal number printed file offset defines
commit	existing including specified message select creating whose use invoked log -c graph construct current reachable take tips editor autosquash head reuse repository information timestamp object loading user authorship transaction branches like edit rebase list record contain commit changes automatically
kbps	second per i/o bandwidth limit kbytes
soa	soa zone format number signed serial
remotenumber	set remote assumed system telephone authentication purposes number
bufsiz	buffer set socket size
git	pointing show global existing reinitialize find patches parameters histories add local get difference name submission list merge side set portable reference exporter specified download matching gitattributes index pattern e-mail various print new run repository commits given objects git-dir interface path along prepare introduces fetch etc place pick commit introduced changes options massage named symbolic one names another apply three-way logs ensures git working create placing two checkout empty files graphical formed cloned link remote copy specify join tree record supposed display delete associated rewrite lines refs tag file git-file check contents paths make archive valid reachable branch filesytem-agnostic instead revs development used information clone update data types recent branches well together git-upload-archive directory
dropuser	account postgresql user remove
slapadd	database add slapd entries
pager	files grep open output pager matching
width	generate diffstat
was	effect
createview	create mib table entry snmpv3 view
head	lines display file first
libname	command passed linker option directly
failure	echo-requests number dead peer set frames echo-reply returned given rejects nak system send valid instead receiving local sent option lcp options ipxcp pppd configure-naks presume ipv6cp configure-rejects default maximum n ipcp without starting $num$
createaccess	given mib group views level certain create particular thus request access specified levels allowing suitable table entry security principals model snmpv3
errinfo	fails syscall errno . uses dtrace print
reset	restore run-time form parameters default storage value one defaults resets parameter index-method-specific
attr	information display gitattributes
--unicode	applied given code option encoding unicode point formatstring cannot replaced characters represented constructed placeholder string target
mtu	set maximum value mtu transmit n unit
--config	files file set remote takes repository use effect fetched initialized variable immediately configuration newly-created checked history
mru	set receive mru maximum value n unit
delete	files non-zero rsync directories remove volume num must tells delete
-bundle	load whose executable set described look unload iokitpersonalities within kext kexts cfbundleidentifier known immediately identifier
syscall	syscall examine
blocksize	write number 512-byte positive decimal bytes drive per writing i/o records tape specify file integer output archive block size
check	information ensures name reference formed well display gitattributes
password	specifies password private one xgrid_controller_password file specified use derive source input local username administrator passwords controller proxy key peer conjunction present must created default requires connection output authenticating
no	foreign-data set sequence clause disabled minimum / specified reached size log wrapper function used return trace buffer modules masks logging key corresponding word optional generate specify determines longer calls nextval whether tracing enabled maximum value minvalue validator error display
nc	connections udp listens tcp arbitrary
when	ignore branches colored submodules color changes show remote-tracking current generation matches diff highlight local
vacuumdb	analyze garbage-collect postgresql database
kextunload	kernel unload terminate driver kexts kit i/o instances extensions
role	role remove change database
-vafile	containing responder explicitly file certificates trusted
nr	code bsd-compress sends request nt compress packets maximum peer using nr scheme bits agree sent size
nt	code bsd-compress sends request nt compress packets maximum peer using nr scheme bits agree sent size
--dbname	specifies specifiess added name language database analyzed reindexed cleaned clustered removed
node	node specifies given set record computer numbers directory ipx find
iopattern	print i/o disk pattern
truncate	table set empty tables
welcome	negotiation executable shell run script completed ppp command connect specified initiating
update	map lsm existing add specified input_files
--template	templates .) use used file version section initial (see git-init contents template directory commit message given $num$ specify
interval	specifies text frame see vs rechallenge resigned given -f zone send delay seconds echo-request passed input sent option lcp may samples update pppd records every performance peer info received framework interval lines n time previously-signed
modules	given trace modules module points specify
-font	used name plain rich text converting font specify
time	records generated expire specify time date become valid rrsig
push	associated refs update objects remote along
-param	specifies encoded curve parameters elliptic
hiutil	examining help viewer indices utility creating
--select	loading graph automatically specified commit select
--new	end script multi-volume tape run implies
rsautl	rsa utility
-search	specifies directory search kext kexts
--strip	tar-1.14.90+ stripped specified number names file strip write leading content extraction strip-path input document strip-components elements nib design-time uses output interface path builder tar-1.14 remove mode components x $num$
marks	load complete processing specified dumps internal file marks table input
-grid	identifiers list grids logical
--dribble	filename remember keystrokes user
string	specifies node set ip-up extra pointed router separated including value specified go prepend trailing usmuserpublic creating index given password prefixed ip-down -i . instance provides print new parameter manuals files option implicitly differences use introduce (usually indices generated user characters scripts peer using unique data string name none look /) created challenge explicit remove contain directory entry identifier authenticating dot spkac
disklabel	query disk apple manipulate label
--lock	forever dump acquire locks table shared beginning wait
-certopt	output customise -text used format
nametype	specifies owner type key
level	control debugging set statements facility defined certain thus request hardware syslog see full specifies specified table tells snmpv3 letting information use delete group compression net-snmp personal removing create mib logged detail debug-level access explicitly details debuglevel instead principals type mini available enable option views basic compress given standard levels allowing particular report model network suitable extension level default settings messages turn sets debug entry security view $num$ slapd
gui	interface graphical git portable
-capath	containing certificate verify ca looking issuing pathname dir file signature certificates crl trusted
-workspace	workspacename build workspace specified
item	specifies directory search kext kexts
randomdev	specifies source randomness
dir	load specifies compare behaves pointing hierarchy unchanged symbolic transferred rsync file specified limit backups git-file check append machine current use git computer additional certificate verify make placing transfers prepend looking also add issuing instructs filesytem-agnostic instead partially local store supposed files working node option repository missing given plug-ins combination none cloned hardlink link git-dir pluginpath scope put path find copy change like infopath search receiving resulting using level @include side record destination tells place crl compare-dest signature directory found backup valid dir first
checkmembership	associated option member returns user group
binddn	binddn use name bind ldap directory distinguished
--split	info files default num split $num$ size
--inplace	option though required sparse already-existing resend data conflict auto-disabled
-bufsize	buffer i/o set size
cost	function execution estimated cost change
group2	use groups administrative privileges computer listed determine local
port	specifies domain hostname named number tcp connections unix rndc connect file specified rmi port subject use whois channel nc availability source internet expected command listens local double-colon fastcgi listen cgi alternate postgres -nr privilege applications registry listening address using specify restrictions remote socket extension created bind external $loc$ host server path client proxy_address mode found requests proxy
portnum	requests ocsp port listen
addr	domain samba addresses option supply windows wins clients allows two server pppd acting dns internet services one microsoft name
--resources	directory path copied resources package
--listed	new $loc$ incremental backup gnu-format
template	templates .) search used text section (see remove git-init template directory $num$ specify
reply	patch mails given appear provide series make breaking new no-thread threads reply avoids mail message-id first
epdisc	negotiation endpoint machine sets peer discriminator multilink local epdisc sent
--noextattr	noacl passed
dbnum	configuration database check add listed file entries output dbnum-th generate
install	path root install
cvdb	xsan client system file debugger
serveradmin	daemon command-line administrative server mac interface x os
address	specifies cgi named nc ip specified one connections report rndc connect path port agentx subnet use channel hostname send machine e-mail state without master daemon command listens -x fastcgi faulted outgoing used option form given change desired job proxy address interface using a=0xnnnnnnnn present status peers socket notifications default bind packets finished server 0xnnnnnnnn contact proxy_address mode allow cancelled requests authenticating email external
wait	sending forever dump seconds acquire packet locks table shared beginning wait
--separate	git repository filesytem-agnostic make placing symbolic cloned place supposed specified directory instead link
targetname	specified targetname build target
-extension	files used extension default format) determined (by output specify
confgen	generation tool rndc key
uptime	centiseconds option application value -u field sysuptime taken parsed present
-detaillevel	specifies mini full network level personal available detail hardware information basic report
delimiter	commands used dump evaluate create update texts delimiter passed specify input_files
bom	files links directories devices bom specified copy present
--title	given package title
iana	files used force using encoding default plain specified html interpreted output determined (by file text input bom) specify utf-8)
workspacename	workspacename build workspace specified
opensnoop	opens file snoop occur
setfile	files attributes directories set
ipx	node received set protocol name hexadecimal frame request number 0x ipxcp network without numbers option leading router ipx n configure routing
regex	regex whose given added word look word-diff-regex=<regex> matches equivalent differences use considering runs plus decide specified instead word-diff=color line removed non-whitespace
-0-7	drive specify density
--export	import-xliff importstrings-file export file specified table extract plist xml union class member internal listed marks expected document complete format object xliff stringsfile descending interface properties localizable builder dumps either xliffdocument strings
msg	case use set created given one merge used msg commit message
checkout	files index working paths tree branch copy checkout
deleteauth	control extension settings removing specified thus access table entry delete
ctype	specifies setting lc_ctype used database
--nohfscompression	default
-days	specifies used -x509 option certificate make certify days number valid
randomfile	specifies generating random source data authorization
--controller	option allows controller user type specify
cat	concatenate print files
descriptor	x file f=x form descriptor
values	rows set compute
jstat	statistics monitoring tool virtual machine java
attribute	specifies uid attribute one enable static file group gid gets bits sort used returned mapping attribute-letter user entries based attribute-type records specific following attribute-value
skipto	numbered less rules skip number subsequent
incremental	new $loc$ incremental backup gnu-format
snmpnetstat	status information via networking network snmp entity configuration display
-userdefault	default set user value
requirements	signing code requirements embedded indicates internal specified path
1	debugging differ run-time useful $num$ programming assertion times mistakes second detect allowing aid enables checks
parameter	index form parameters storage one defaults resets changes index-method-specific
map	accm map end option sets create lsm existing add link classify specified async-control-character-map new categories input_files
mdfind	files query given finds matching
raidset	volume remove
max	files set decompression $num$ number accept maximum connections ipv6cp chap minimum file frames reached slots still returned configure code options -f van compression min terminate-request nak inclusive system send jacobson field n pad print instead fragments must local .max pap used string lcp format max authenticate-request ipxcp transmissions configure-naks configure-request active line rejects like ipcp configure-rejects end-of-file header default challenge $loc$ request according server connection client sets starting width
clone	directory new clone repository
--checksum	set checksum $loc$ prefer -4 seed ipv4 advanced
getid	provided associated uid depending returns gid option options takes
date	[hh set creation show specified only) quotation spaces enclose file mtime (c -d author contains except compares notes marks override instead include store files used string form commits [:ss] like yy modification recent newer entries date pm]] ctime modes older mm directories $loc$ display specific r u time sets commit | [am
data	definition foreign-data wrapper remove new change define
repo	remote retrieve tar repository making instead local archive
--resolve	pointing valid git-dir path git-file check
sectors	sectors number fat cluster per device total
stdin	input use $loc$ file standard
su	identity user substitute
fromdevice	repair given set raid whose adding newdevice exported mirror device new degraded disk raidvolume uuid
sc	usage statistics call system show
remotename	set remote name assumed system purposes authentication
sd	mdns service & tool dns-sd multicast dns test discovery
--rc	information class name shows
--re	information name extension shows
--rf	function information name shows
--ri	configuration name extension shows
lsm	semantic tool latent mapping
cols	per line cols octets format
-ou	dn adding use container computer ldap
-modificationtime	files attribute time modification output specify metadata
disconnect	terminated execute shell script pppd command specified link passing
acknowledge	specifiying identifying acknowledged number marks event
newdevice	repair given set raid whose adding newdevice exported mirror device new degraded disk raidvolume uuid
drutil	interact $loc$ burners
-dname	property set java system
window	differ useful times second allowing $num$
policy	policy specifies probe used ipsec
sizeofvolume	specifiying raidset create volume build size name
postgres	server postgresql database
savepoint	savepoint roll back
dapptrace	function usage library user trace
htdbm	password dbm manipulate databases
schemename	scheme build schemename specified
not	whether marked forms column values allow reject null change
permissions	files adding (see chmod apply $num$ permissions
-spkac	containing name form allows spkac variable alternative
execute	-e last name followed process argument running command arguments option path using execution optional id must
name	mib pointing text pointed global existing degraded disk find adding group uuid newdevice encoding writing input local format read partitioning ls) upstream using interpreted service processes name settings config output authenticating view specifies set force sign erase mirror .xml snmpv3 label determined (by new newly cwd subdocument shows repository whose compilation given cvdb members peer configuration generate deletes run-time logging certificate extension created extracts $loc$ allows keep place assumed router changes options origin repair named secure point symbolic logical one device names directly table raidvolume use described snoop script removing create system call authorized passed apxs scheme empty define files flat head option cvdbout kerberos cloned volume link purposes specify none made default plain bom) package record computer values utf-8) delete rename function diffstat process specified thus metapackage group-name examine file archive defines information containing make firmware write authentication html branch instead revs document parameter privileged administrator used raid track symbol sets exported characters variable account class remote database ths subtree (eg command volumes filesystem entry $num$
vpnd	daemon service mac x vpn os
-nmin	available information used revocation nextupdate number days field fresh minutes
drop	foreign-data domain set family rewrite text parser marked descriptor remove operator table null procedural index conversion dictionary cast sequence wrapper forms default trigger role template reject server type schema function form view mapping tablespace user aggregate configuration data class change search language database whether rule value foreign column values allow drops options constraints
-reqexts	-x509 option certificate request extensions present alternative include sections options specify
--byte	applied given option encoding bytes formatstring source valid replaced value input byte constructed placeholder string
domain	domain set purposes syntax using append adds addition create generate authentication dlv new local form host dnskey key (create_domain ds change definition name constraint remove sets $num$
-mobile	default account enable determines plugin whether support disabled mobile flag offline logon
--internal	file produce list internal links
ec	processing key ec
-caserial	use ca number file sets serial
outname	.h outname code name places create .c file output
-offset	begin default parsing start file offset starting
ipfw	control firewall ip shaper program traffic
--stdout	given cat zcat standard also without let behave output input copy data change
--volno	used working track keep volume multi-volume file archive
args	specifies engine selected arguments compression
--unified	diffs lines three n context instead generate usual
-auth	default password
lmh	drive specify density
privgroup	use group allows options group-name members privileged
byte	requested form b=x bytes number call x
--output	stdout spaces file archive xml write use working selected filename current html split provides instead nodes store files elements form ibtool indent val default list resulting directory output property $num$ dir
language	specifies locale text resultant translating specified keywords texinfo use source override document files xliff c target language default plain remove output scripting procedural
netid	server-side netid stubs compile specified transport
router	router set name
rewrites	pairs complete rewrite create break changes delete
-respin	read request response file ocsp
origin	origin zone
-index	index containing elements option certificate format text ca indexfile list sublist information tcl file specified proper revocation must
symbolic	followed checksum $loc$ link path size
one	search sub object subtree one one-level base scope children specify
-email	finished state send notifications job address cancelled email change
xx	specifies control regardless map transmission certain character escaped whether characters peer async requests
message	mails series existing including message reuse information given invoked log -c provide make breaking no-thread take avoids mail editor creating timestamp object new threads user reply authorship appear like edit patch commit message-id first
open	files directories open
-author	files author attribute output specify metadata
--flatten	ibtool runnable option editable value compile produce instructs flatten file output combined
-password	default controller xgrid_controller_password specified password requires must
mesg	messages display users
fmt	concatenate force tar back one single result file specified archive indicated zip system write (by input files format read contents) using interpreted convert default determined resulting
--entitlements	signing entitlement given take file signature path embed data contents
linsert	insert elements list
csreq	requirement code expert tool signing manipulating data
module	:, preceded set followed list argument module sign corresponding given invoked set. - current logmasks added affected trace containing removed name modules minus plus + first
than	specified number only) file mtime (c given except compares instead include files jobs like hours newer entries ctime younger modes older directories list r u newer-than queued
sdkname	xcode project appropriate build workspace specified using tools sdk
tcpdump	traffic network dump
require	debugging default encryption required packet disabled allowed problem example
zipnote	rename files stdout edit zipfile comments write
--framework	framework given generates metadata
param1	sub-directory relative amount output distribution changes
--modify	differ useful times second allowing $num$
--subject	[<subject-prefix>] use patch prefix instead line standard subject
--rclass	information class name shows
and	options -k encouraged
delim	use character delim field delimiter tab instead
--argscmd	run show list gitk command determine time revs
--paragraph	info indent val default spaces paragraphs $num$
groupname	control certain thus specified table snmpv3 given delete group net-snmp removing create mib access principals type views standard levels allowing particular model extension level settings request entry security suitable view
-textsizemultiplier	sizes numeric factor multiply font specify
raidutil	manage raid objects manipulate view
conversion	definition conversion encoding remove new change define
configurationname	building use target configurationname build specified configuration
dsofile	specifies created dynamically object filename explicitly shared
authtype	control delete group net-snmp extension settings certain create mib thus removing standard access specified allowing table entry principals type view
lsbom	file list bom contents
buffer	set buffer bytes io buffer_size size
compress	x c instead compression using support access generally pipe builtin program mode output prog input archive
--color	regex branches colored show color equivalent specified diff remote-tracking current matches plus word-diff=color highlight word-diff-regex=<regex> local
--superuser	superuser use name triggers user disabling specify
-user	processes display owned user
drive	one list drive per drives lets verbs output operate specify
-target	specified targetname build target
salt	digits given actual string chain use hex nsec3 represented encoded salt generate must
set	domain set marked one value null index parameters storage forms default reject schema form mapping user change whether remove server column values allow changes options index-method-specific
show	objects various types show
ldapuri	separated allowed referring commas fields $loc$ list uri server ldap expected ; specify whitespace
-rsigner	ocsp responses certificate sign
threshold	none
deleteview	given delete removing mib thus subtree table entry view snmpv3
kdebug	debugging code kernel-level enable driver ppp
upgrade	last name archive installed base path replace root find
title	given package title
-cacert	authority certificate specify
--directory	directory infopath add dir change
lastwords	print exit syscalls
-keyform	specifies used key format der argument private pem file specified -signkey -key option
cupsctl	options cupsd configure .conf
nameofraidset	specifiying raidset create volume build size name
ssz	files attribute creation time modification output specify metadata
-rother	certificates response include additional ocsp
mcxquery	managed tool mcx client query compositor
sso	directory single open sign
ssh	keys gather ssh public
--label	specifies string rules label attach new existing find
gen	bridges objective-c generator metadata
--dump	xml dump xar header file specified
sourceaddr	specifies source request packets address
-staticmap	attribute-type mapping specific records enable static user attribute-value
--glob	shell show pattern glob pretend matching command listed commit line refs glob-pattern
kernel	given kernel_file link
--read	previously generated stored file apply changes write-batch
connections	number accept maximum connections client sets server
-addtrust	use adds certificate trusted
ocsp	status utility protocol certificate online
-passin	input pkcs#12 password file source
label	specifies given used corresponding option may labels find three reports times existing attach place names file new label rules conflict string
3	use version protocol specify ldap
mib2c	extending code agent generate template
--partial	put dir transferred file partially
parent	parent adds target form merge considered specified mainline new cherry-pick cannot know child usually table side
--keep	default option
slapd.conf	.conf file alternative $num$ specify slapd
snfsdefrag	xsan defrag system file utility
--short	shorter full outputting object name try sha1 values names instead unique abbreviate
s	specifies kernel set process pid numbers file exclude id size excludes group exempts function subjected system int identification listing include selects files pgid whose descriptors directs user alone path optional processes name calls might list times fds comma-separated sets output login lsof display block names
expression	specifies file demand-dialing pass packet brought determine allowed adds regarded therefore cause sent reset link data applied received packets timer filter idle mode activity
reindex	rebuild indexes
jitter	signing expires simultaneously zone issued time records signature lifetime fixed rrsig
--port	specifies domain socket extension alternate listening number tcp server connections unix file double-colon local port specify
eventnumber	specifiying identifying acknowledged number marks event
period	tolerated seconds times range response options specify ocsp
iotop	process top events i/o disk display
--timing	count cgi script measure times repeated time execution
iterations	generating chain many use nsec3 interations
cancel	cancel jobs
ecpg	c preprocessor embedded sql
skey	use skey ordering process key display secondary
west	set west system value minutes gmt
-inputencoding	files force using encoding default plain specified interpreted determined (by file text input bom)
mark	describe tree working
apxs	apache tool extension
-mobileconfirm	account determines plugin whether created warn mobile flag going user
engine	specifies engine usmuserengineid used string would index generation set key usmusertable part unique id operations
enable	domain allows computer specified home network mounting forms authentication trigger forest forces local belonging configure flag uses (, active table determines $loc$) plugin whether directories firing enabled default unc directory
external	whether function security definer change
contextprefix	control certain thus specified table snmpv3 given delete group net-snmp removing create mib access principals type views standard levels allowing particular model extension level settings request entry security suitable view
--widechar	applied wide given option encoding formatstring source valid replaced value characters input byte constructed placeholder string
msdos	ms-dos system fat construct file new
-passinterval	account password computer often default changed set trust $num$
slapschema	checking in-database schema utility slapd
mount	snoop mount volume filesystem mountpoint xsan
controllertype	option allows controller user type specify
keygen	generation tool key dnssec
cast	cast remove
--resource	collecting signing option default overrides bundle rules sealed signature resources
stdout	stream $loc$ standard write file output
parse	parameters massage pick
cluster	index sectors bytes system per according cluster file table block size
stripeclusters	may certain over-load xsan possible devices jbod command using cases queues
-reqout	certificate der request write file encoded response
pap	pap set retransmission means default interval maximum wait number pppd seconds transmissions authenticate limit timeout time peer n $num$ restart authenticate-request
whois	domain network service number internet directory name
author	); author commit found copied first
pax	read write archives file directory hierarchies copy
media	media acceptable 0xf0 descriptor range 0xff
hostname	specifies alternate ip controller connections value file specified -if port ocsp use hostname chooses archive xgrid sent listen option applications host address device present name $loc$) f -, $loc$ request meaning postgres server client xgrid_controller_hostname (default
--priority	operations specifies created changed update rule priority
--squash	autosquash use rebase construct commit message
--debug	debugging turn types particular
arguments	specifies engine selected arguments compression
cvaffinity	type set affinity
nodename	info file visited nodes specify first
signzone	signing tool zone dnssec
lrange	list elements return adjacent one
ip6fw	firewall ipv6 controlling utility
--zend	load file zend extension args.
bundlepath	load located bundle bundlepath
ibtool	prints documents builder verifies updates interface compiles
--rextinfo	configuration name extension shows
components	tar-1.14.90+ elements file leading strip tar-1.14 number remove extraction strip-path uses mode components specified x path strip-components $num$ names
model	control certain thus specified table principal given group net-snmp removing create mib access snmpv3 type views standard levels allowing particular model principals name extension settings level request suitable entry security view delete
dsenableroot	account enables root disables
urllist	default /// serve tcp port ldap interfaces slapd
generator	generating hellman generator use key diffie
--from	specifies input encoding
param	associated option member returns user group
setting	set setting build value
samples	even use logging standard terminal mode samples output display
rules	collecting signing option default overrides bundle rules sealed signature resources
cvmkdir	directory create affinity xsan
grid	interest identifier grid xgrid logical
-ggid	specifies attribute used group gid
execution	function execution estimated cost change
yyyymmddhhmmss	records given occurred select datetime
rwsnoop	$loc$ events snoop
server	specifies definition use authentications specified lookups remove server descriptor address directory foreign change
confdir	directory config specify
t	specifies kernel changed load addresses reported single set file select information functions submodule network puts also unknown writes pairing controls -t specify time-out values copied type unmerged resources files non-printable added temporary deleted retrieved reporting netstat symlink broken regular optional repeat wait c b $loc$ might ...) seconds modified value renamed r u mode time following x deadlock lsof $num$ otherwise
smime	$loc$ utility
getconf	variables configuration retrieve standard
yyyy	files attribute creation time modification output specify metadata
erase	media tool inspect udf structures interpret
rsync	flexible rcp faster replacement
-configuration	building use target configurationname build specified configuration
xgrid	jobs monitor submit xgrid
nettype	server-side belonging stubs compile nettype transports class
seconds	specifies interval process number represented see ), file specified server 00 conducts since hex authentication delay started epoch octal new many occurs seconds print repeated date utc last january decimal (00 ipp 1970 timeout time requests $num$ procedure
droplang	postgresql language remove procedural
on	submodules non-negative internally option populated provide commits gitmodules controls (see used $num$ default temporarily value fetched new conditions git-config recurse-submodules
package	unique identifier package
of	whose tagged handle tags object number fats filtered specify
acl	tool run mode
--username	connect create drop user name
-drive	one list drive per drives lets verbs output operate specify
backup	files backup-type sector simple backup fat32 boot numbered using instead deleting location
or	specifies flat search file package kext metapackage kexts noacl passed directory path distribution .dist
image	burning image stored disk read-only size provided given media create attach new burn optical compressed device data compute checksum attached value verify
xfile	members processing list excluded optional archive
--compression	specifies engine selected arguments compression
strip	symbols remove
operator	definition family remove operator class change
chrootdir	named used -a option chrooted directory run specify
log	commit logs show
prepare	current two-phase transaction prepare
start	records generated valid specify time date become rrsig
-prefixspaces	elements indent default $num$ number nested generated spaces html specify
zip	files compress archive package
--requestor	status specified e-mail job address report
htpasswd	files authentication manage user basic
-newkey	option certificate request private creates key new
execsnoop	process new execution snoop
pull	branch repository merge another local fetch
--format	logs tar v7 only) one raw unix full oneline pretty-print specified (c oldgnu archive contents use fuller 1.13 zip u selects email metadata medium string format posix.1-2001 given generated output short ustar posix.1-1988 created gnu r resulting mode <=1.12 posix commit
default	non-negative set internally option default value forms column used remove provide temporarily recurse-submodules
--bindpath	cgi bind server mode path fastcgi external
describe	reachable recent tag commit show
file	log-file pairs args. encrypted random must only) ctime stored f=x (c causes previous access style password keychain zone output_file except send source add internal batched present excluded marks input secondary ca split lsm format read evaluate translations every words entries using replace exact categories like execute name directories performing list html dumps merge w/o hosts mode indexfile x crl specifies signing set existing series importstrings-file related sign evaluated specified extract ocsp rsync updating attempting exactly per responder looking contained version trusted certificates new errors apply metadata locate namelist run responses found processing given standard key output interface path configuration write-batch input_files search logging working extension created generator allows (see keep prior multi-volume produce pathname signature commit changes options load addrlist named contains stop_word_file previously image number private one texts table message three-way considers use described additional certificate script transfer create initial macro-expanded secret explicitly listed expected final files generating corresponding complete form update ldap rsa -certificate zend volume .ini link newer ldif encoded line specify socket exception include rand_egd look f default der localizations iteration batch signed dest descriptor r newer-than slapd @setfilename links stdout request incremental command parse seed file mtime exclude ignoring archive contents option information containing kernel_file revocation per-update verify rsigner - parsed write also issuing compares take instead document classify development map begin used track put effect generated stringsfile uses purpose php data response localizable modes builder stdin lines strings patterns u log directory $num$ egd
-verbose	information verbose program mode print operation
pstopdf	postscript convert pdf document input
storage	index form parameters storage one defaults resets changes index-method-specific
field	sort current bytes pipes packets according one four listing total counters
-dependency	set resolving kext kexts add dependencies plugins known
-keywords	files shell (the quoted attribute context) list argument usually single need keywords output specify metadata
symbol	symbol c preprocessor define
concat	join together lists
remote	set remote $loc$ interface identifier local 64-bit
rs	reshape array data
mask	create mib table entry snmpv3 view
validator	specifies foreign-data previously servers check given mappings generic wrapper new function used registered user using specify name longer called well foreign validator options valfunction
directory	specifies templates via unix-domain ignored kext connections git-init write find adding use additional working section current keyset client template instead include store listen files used postgres repository exec symbol search directory generated socket sql included path configuration specify .) c look applications root (see kexts r resulting mode following become changes $num$ dir slapd
strings	format importstrings-file builder translations replace expected stringsfile specified interface document extract strings localizable
alg	specifies use used encrypt key algorithm pkcs#12 selected private v1.5 v2.0 allow pkcs#5 certificates algorithms enables options option
--skip	show skip number output commits commit starting
code	specifies code encoding lines .whois-servers number one zero <?..?> aliases ru addr script -h send terminates unreachable match country-code notice processing run option tags equivalent noroute none argument every discard using line php noport search input admin .net packets rule n try icmpv6 without notneighbor output $num$
pty	specifies terminal used script rather communicate specific command device
disk	form written read number 0xnnnnnnnn disk d=0xnnnnnnnn block physical
-e	code -e whose subjected flawed character input might resources format read evaluate exception records entries using execution execute name list specifies kernel set dump specified ru exempts pattern exit consecutive rrsig metadata processing expire path optional search last package running extensions attributes block exported followed encoding number one considers select given script create system copied scheme final function generating option line trying specify must none effective n limit match root files process argument general file exclude id archive faults arguments command used time generated user date php calls database lines fat16 comma-separated fat12 enter directory
-d	prints spaces enclose directs field cache character debug-level keyset add device location ldap save dn string yy records tablespace entries clustered using binddn bar name level gui mm session mode debug | specifies kernel set creation used daylight added value plugins clauses extract .pmdoc provided filename access debuglevel foo selecting compilation use dependencies preprocessor analyzed path configuration optional deletes c language $loc$ pm]] turn delimiter lsof named saving ignored notes kext one variable appropriate directly table select given snoop source contains system listed passed var milliseconds define files enable @set option form dad0) msec marks occurred lists known removed specify quotation look default see kexts reindexed [:ss] sets distinguished slapd [hh debugging file defined messages specified delim ini tab cleaned defines specifiess built firmware delay instance details test instead snaps printer trace symbol newline replace packagemaker characters date data identity database bind resolving (eg command time directory entry $num$ [am
-g	specifies set associated characters #, process hex global primary numeric one root) numbers file specified diffie next sudo id select regex whose given group whitespace generator script (by make destination run two gateway member passwd returns gid identification hop listing command transfer selects real generating added pgid option excludes matches differences use separate records grade every user key variable based line removed optional bit-digits look processes eight name database default normally bytes comma-separated sets output hellman starting slapd
-f	code text find prefix .conf alternative disk package-info -d group zone volumename character send program ldap input info tests string format read evaluate fat records every joins using (one execute overriding name fields performing list remove merge 16 hosts mode h output specifies node set occurrence series batch see computer kexts specified option. index outname per filename sequential print fragments metadata namelist full hash respectively processing use standard active path configuration beginning forbids search created $loc$ according delimiter pathname commit automatically addrlist encoding variables kext one names another pairs message select methods given snoop script scan firmware width selects scans separated flat floppy commands volume flag cvadmin particular line nested-loop specify .h join places f default type .c maximum signed n record display slapd files give .plist lines package parse single minimum file archive defines information containing min 32) id write field take config .max temporary generates max bundle generated disable effective framework url request patterns directory $num$
-a	code show dynamic datetime mistakes query digest aliases whose loading -a character assertion add systems string matches fat records entries report -between magic name architecture identifier specifies kernel domain computerid contiguous num specified implemented matching asserted detect per cfbundleidenfier e-mail checks available opening filter given attribute-letter job proxy groups address generate run-time desired changed programming modules no-r sensitive dereferencing attributes changes via letters addresses kext number one done loaded select use dump create echo-request treat selects configured authorized files generating option kerberos occurred options) line specify case account target bits applet following aid enables debugging attribute files-from file trailing check information containing % rather make machine application algorithm gets afs node administrator may symbol arch cryptographic droplet sectors database lines icmpv6 status place sets
-c	event code show using terminate cols existing i/o executing comma immediately fetched adding -a -c alternate character -h keyset specify listing input defining sent count reuse notation format matches timestamp stop possible octets records authorship syncrepl execution name four processes like renames edit positions decimal .net list requesting mode including specifies set opposed replication creator bytes contiguous request sign connections configfile num specified initialized 0x52486368 matching invoked notification per classes provides new receiving ioservice country-code jobs creating repository equivalent use standard cookie key output path configuration fourcharacter log sending c run-time zone package allows plane place context transfer commit hexadecimal extracting changes registry named useful groups kext number classname instances simply message open select given checked takes snoop leading xar copies class editor dns .ini selects iokitpersonalities empty location files flat generating certificate option descriptors argument controller nondefault line .whois-servers present begins chdir look cluster default type maximum record r error following history separated echo_response rndc lines sudo metapackage indicates file close null trailing archive string information containing counting extract designating newly-created take octal flags -between parameter used binary object effect detect uses user characters variable php compatibility audit remote sectors unload macroman normally well packets .key command sets directory consumer
-b	code pointing show pointed dynamic datetime i/o integer suffix whose application -m -n -k writing add tape location input include dn 512-byte matches controls break records entries immediately execution processes name positions decimal list server mode output identifier specifies requirement set force bytes iokitpersonalities executable num specified temporary buffers encouraged per access written print shared newly cgi run repository opening processing use standard groups searchbase byte generate search fixed socket created checksum place positive requests changes options block load fetched key point within kext number cfbundleidentifier notify determine path pairs message select size given described block-size zip leading create system bits contiguous fastcgi head corresponding complete form occurred cloned volume external mail known line specify must word look default database kexts repetitively limit display delete rewrite thus cluster single exist file archive option binary containing get check write read authentication branch instead -between status requested used blocks buffer bundle variable php unload bind bootstrap lines drive sets entry starting send
-m	control specifies set supplement kernel 0xff manage number module one date minimum mechanism file table mountpoint message activates event select modification -d given detect system snoop -b remains media alternate specified range 0xf0 sets memory msg bits acceptable dsa used string trace enable processing modify use collection mainline records cannot know cherry-pick statistics compatibility specify case term name renames created considered mount modules descriptor merge length points form mode filesystem usually commit backward side
-l	disables text forbidden global degraded disk adding uuid -c -m newdevice writing -u samples listing override ldif local o(n^2) labels read stop possible octets ds name mirror timelimit mode output specifies preload set dump locale list discover syslog connect specified targets even errors + current dlv new falling available processing whose seconds ping6 use len standard host objects dnskey key generate wait search enables logging language many $loc$ reports times place -l options user repair facility number names directly counts raidvolume terminal given addition three fast sends passed selects files dumped corresponding complete commands link input plain require n invoking behavior sets display scripting linker file allowed option - write potential instead conflict used raid normal may time exported device database packets command databases $num$
-o	switched comma command-line-style destination-path zone writes output_file writing explicitly input hidden string format matches records descending upstream using extra-options secondary processes sorting name decimal list patch specific output security page dir specifies orderfile value specified server matching postgres pattern specification per filename current contained version provides shared queued jobs repository modify given hours oem offset path optional properties digits delimited 0t created keep resulting expression options user origin prints letter numerically number one key open select ecpg use skey working ordering data create passed store files shell option form started new tokens line specify grep algorithm 0x.. older signed n pathname display extracting stdout process dynamically file need archive defines result information containing generic means write instead document extended multiple separate track glob object regular printed characters pager pages remote sectors database $num$ without flags place directory sasl order reserve
-n	show prefix -g zone -i writing add explicitly location marks format bound fats entries processes name identifying decimal remove server output lines specifies dump generation module connections unlock service specified rmi matching overwrite revisions server-side cnt cvdbout.000000 pattern contained version template print commits use cvdb objects threads key configuration generate digits last specifiying limits package times soa number owner given) actually size given snoop create copies listed type schema files option form cvdbout volume repeated logging selects stubs netid maximum signed compile limit install display transport nprocs process ths purposes accept examine file serial check schemas event client build instead raidset track object registry ls) remote database acknowledged (eg sets dbnum-th starting $num$
-i	sector multipathed text existing .conf find whose -f zone -i source program location samples listing input include sent fat32 get matches inetd records every performance integer unique runs identifier dir specifies set packet see specified resigned append index network may unable suspect internet seconds compilation modify use job address interface path configuration wait sending search last package login via recreate logical one directly unit given 32-bit additional initial system passed selects files shell option received tlid volume repeated simulate specify info target previously-signed lines vs file id information format tcpdmatch delay command used exec passwd update wrong uses user sql included framework interval packets @include time entry $num$
-h	specifies set chain hoplimit /// specified controller number tcp chooses connections header connect allowed host drive n port use rows heads referring positive alternate nsec3 machine located interations specify samples ldap expected instead ; xgrid listen separated generating postgres variant interfaces ipv6 serve applications running every -if address integer commas fsmhostname whitespace none name uri database column many $loc$ list fsm value server default ip client present hostname fields output xgrid_controller_hostname display slapd
-k	specifies sector signing set file list named fat32 request comprised connections services rndc kill io specified exiting kernal size use derive boot hex created seconds authentication client treat place wait location string buffer rpcgen given unix-domain job kernel_file link servicing key represented buffer_size password must digits actual name using applications default k $loc$ bytes postgres ignoring ect flags socket directory listen backup $num$
-j	signing issued number signature jump file specified lifetime matching select subject zone id ldif rrsig processing simultaneously expires records entries line token time fixed
-u	exclusive show session comma per causes based whose conjunction group uuid application -l alternate -u specify listing administrative dn means rules records ssh scheduler difference name drop list remove server mapped found authenticating queued .conf specifies domain set #, -a library supplementary owner unlock computer connect specified jobs provided network @clear cancels access connecting run repository -d given details); proxy sysuptime path generate diffs $loc$ initgroups (see mutually connection context login options named via secure non-default submits number owned one names untracked throughout select use takes create three returns gid authorized taken authcid selects listed files option volume var numeric separated present account locked value n record authz-rewrite -user accessed root comma-separated slapd username rndc associated uid int sudo numbers file id end depending privileges authz-regexp parsed member field authentication sid test instead config revision centiseconds used users trace track clone undefine generated user variable audit sectors bind lines .key alias command sasl starting $num$ usual
-t	code reindex four attempts query tables based title writes controls -t input gmt string notation views read timestamp octal timing using execution $loc$) decimal list hosts mode timeout output specifies set dump specified matching network pattern selected filename version print timestamps falling hexadecimal cgi newline run seconds retrieved netstat given standard reported key x path relating change c package column tracing $loc$ times range commit requests (default major addresses encoding named within number ipp names sequences table message inode use statistics tar script west top initial system chrooted analyze type empty files enable option tool repeated line specify count also none indicates single value four-character values fetch following minutes display indicated syscall measure cluster examine scanned terminator file null contents information format designating connection write extracted modification instead -a non-printable used temporary clean binary reporting characters tracepoints sets macroman modules allow time directory 0x55455955 first $num$
-w	comment conducts simple set use -m appended idle delay seconds authentication closed print new occurs sent started process used passwd generated mail included password data specify word many stdin server connection values procedure timeout silently
program	machine x c remote instead compression using support access generally rsync pipe builtin program run mode output prog input archive specify
-q	lowest quietly run log diagnostics actions standard priority print job sets taken output highest $num$
-p	protocol probe results tcp prefix still availability whose -f alternate send source -p listing policy ipsec local match postgres working listening instead integer conjunction name processes like bytes server found dir specifies kernel domain set packet connections xgrid_controller_password result specified source_prefix rmi port subject track version identification internet print profiling excludes -nr standard overwriting host proxy key output active path optional digits restrictions search socket extension created many $loc$ allows connection listens named kext number one unix reached use personalities snoop beginning custom override expected selects listen files option ldap precision privilege controller copy specify must none default value connect control username rndc prompt indicated process pid command examine numbers file id fill password whois nc prepend note field pad @include document channel administrator used may applications generated registry characters data pages remote end-of-file client comma-separated sets requires $num$
-s	sector code global syntax four directs statements expressions disk next children write based facility logged send resorting source internal affinity systems -s listing save might sent ip belonging string stop introduce records stopfile listed entries transports using sorts name symbols runs sepstring settings interface level bytes remove server merge nettype .suf become queued specifies kernel set dump tells ed $num$ request sign connections syslog specified extract server-side sub dn pattern section supplied filename current abs print fragments utility rrsig counters jobs associate seconds modify use base key substitution represented path configuration optional appears digits search actual specifiying package according times amount changes otherwise superuser named entrycsn suffix debugging address number one alone names table total size subdocuments environment given described create hex system strategy one-level start apxs identity attribute time-out scope copied triggers separated shell option differences sort logging line disabling specify must look keyword stubs device value compile stopwords printing replstr deadlock display slapd files rndc delay defined snapping list variable file seek archive returned functions strength check storage id member instance valid build instead listens channel memory used temporary tried trace raidset passwd symbol object per generated regular user scripts date hashes data class pool volume sectors lsof packets subtree order command expression time directory salt pipes .gz updates
-r	code random symbols epoch send source resize input include real global number records every entries using password service randomness resource name january decimal list remove server merge mode debug output specifies signing see repeat export specified index 00 since rev filename print run repository tags seconds use job become represented path table comparison run-time specifiying package (00 resulting lsof named secure requirement ), megabytes respect select size given log puts script create hex listed selects authorization fork generating option kerberos volume line specify utc account embedded mb kexts record computer behavior root reserved rejuvenate indicates file id containing realm authentication internal build octal place principals config revision node used trace raidset buffer symbol effect user date requirements <?..?> php data remote sectors url bind 1970 without comma-separated specifying time directory sasl $num$
-y	use used jobs complete simple given list younger mechanism number hours authentication contents sasl password passwdfile queued specify
-x	strategy-specific hostname protocol processing exclusive pass .conf one talking debugging session connect file specified types turn throughout id agentx filter use adds exclusion merge archive -o nc authzid strategy port rules master present excluded test means mutually -x authorization dn requested particular used option format read authzdn=dn output proxy members address using details); optional specify ustar default bind list (see authz-regexp server specific patterns authz-rewrite contact proxy_address mapped sasl requests $num$ slapd
-z	specifies load layer retrieve args. starttls selinux specified zend file sizelimit solaris operation transport information use handled zone issue higher extended traffic entries class specify compression search extension level contexts security $num$
-class	i/o kext unload defining iokitpersonalities terminate possible classname instances plane registry ioservice class
fat	(one sectors 16 32) number fat per type $num$
util	directory single open sign
verb	usage information verb display specified
-cols	per line cols octets format
--older	given jobs older list number hours queued
--merged	whose head branches list reachable specified commit tips
--	files paths show commits explain enough came specified match
list	specifies separated signing relevant codesign occurrence tar process specified logical installed header see extended export tab positions keywords associated disk displaying secure option. -d given grids record writes character comma field handles archives way print input document config authorized files used node users provided may newline modify use lists drives replace records targeted part raid characters instead device path byte one pages single default fields identifiers list modified information delimiter comma-separated signature posix.1-2001 output
--protocol	protocol version force used older
--php	use look directory file specified .ini path php
keyscan	keys gather ssh public
-3	given chain hex nsec3 encoded salt generate
kextfind	kernel based variety kexts information extensions criteria print find
whatchanged	commit difference introduces logs show
tag1	used (the quoted context) list single argument need generated html specify usually shell elements
tag2	used (the quoted context) list single argument need generated html specify usually shell elements
--database	specifies dumped name dump database global discover objects connect databases
syslog	debugging set logging option facility selects level logged value tells syslog user statements local $num$ slapd
pass	specifies applied received pass packets packet filter determine allowed data sent
val2	files shell (the quoted attribute context) list argument usually single need keywords output specify metadata
val1	files shell (the quoted attribute context) list argument usually single need keywords output specify metadata
profiler	hardware configuration system reports software
--encoding	specifies used dump database create encoding character set specified scheme
section	containing -x509 option certificate allows section request spkac add extensions present form alternative include sections options specify name
-preferred	use authentications lookups server specified directory
--cc	cc header add email headers
version	specifies saying 1.0 1.1 text number talking ipp want specified 2.2 2.1 oldest use 2.0 script libcurl nc enough protocol current returns version new return string outputs possible proxy given specify installation package default server requests $num$
certificates	files embedded certificate displaying write individual signature certificates chain extract
dsconfigad	directory services $loc$ configuration
tags	handle signed specify tags
loose	short name objects non-ambiguous
modify	repair set mirror degraded disk raidvolume whose given uuid newdevice new raid adding targeted modify controller user device specific allow attributes exported
hours	younger jobs older list given number hours queued
threads	kernel threads determines number created
volid	volume id
searchbase	use point default search instead searchbase starting
sampleproc	sample processes cpus
search	node index search string dictionary text pointed parser remove dereferencing done go entry configuration template specify aliases
periodic	functions periodic run system
pick	apply commits introduced changes existing
--relative	relative run option subdirectory show pathnames project outside directory exclude changes told
options	specifies foreign-data set process clause image tcp disabled disc / file specified custom command-line-style archive size information log wrapper writing started options extra-options passed new files corresponding postgres trace format buffer enabled modify mapping masks specify user burns valid change processes logging algorithm whether tracing modules server specific directory display extracting
-arch	specifies building use target arch_type universal specified architecture file strip operate $num$
family	operator family remove
--use	x c instead compression using support access generally pipe builtin program mode output prog input archive
--author	); regular author commits $loc$ lines output specified header ones limit pattern commit found copied expression match first
select	select() returned form descriptors xcode number system bsd manages call s=x ready x path tools folder
destination	files prints printer output named signed destination-path version build specified input result
-lp	username use conjunction specified password local
archives	files directories list specified archive uninstall
-lu	username account local privileges computer administrative
logmask	given trace modules module points specify
--backup	files backup-type rsync option combination simple backup specified side numbered using directory instead backups receiving deleting tells store
flat	flat metapackage package file path distribution .dist
--abbrev	abbreviated partial show header prefix minimum n diff-tree use needed listing instead alter diff-raw full 40-byte form format showing object short using unique non-ambiguous digits sha1 name default many lines display length objects output hexadecimal $num$
-certificate	certificate encrypted image access specify secondary
flag	set field $loc$ record flag specified
none	automatically associated option sequence column well owned specific dropped table whole causes
endpoint	negotiation endpoint machine sets peer discriminator multilink local epdisc sent
-subj	replaces outputs request modified field specified input data subject
todevice	repair given set raid whose adding newdevice exported mirror device new degraded disk raidvolume uuid
der	specifies present certificate format x509 command expect input -req normally options change
jobid	named successfully jobs schedule dependent rejuvenate list finished job kill execution
--remote	index remote retrieve tar repository url making instead include local archive
prompt	one use prompt option default allows custom -p override password
exclude	list comma-separated exported attributes
--start	patches numbering n start instead $num$
slapacl	access attributes list check
-useuncpath	determines network plugin whether mounting directory flag unc uses specified active home
previousfile	specifies development builder iteration localizations incremental purpose interface document previous
-address	files whose generating loading symbol kext cfbundleidenfier treat address loaded identifier
rezdet	detective resource
lsort	sort elements list
--sweep	available commands none create update
csv	control client profiling
fs	calls system related faults filesystem report page
mapping	definition mapping remove foreign user server change
--rextension	information name extension shows
disable	disabled table trigger support created forms default going offline belonging enable configure warn flag user account determines plugin whether firing mobile logon
fd	error input output open sudo standard file descriptors close normally
--signed	handle signed specify tags
deleteaccess	control settings removing specified thus access table entry delete snmpv3
.sfx	use suffix specified filenames generated .patch using instead
--compare	files rsync option missing hierarchy destination use compare machine instructs directory transfers dir additional
a	available whose code kernel modules configured dynamic via systems implemented afs
--progress	insert shown git statements fast-import n objects every import progress
--contains	branches specified list commit contain
hoplimit	set hoplimit ipv6
secs	rpcgen created default request exiting seconds servicing services using $num$ wait
-validity	tolerated seconds times range response options specify ocsp
keyfile	key used -a option create alternate private .key rndc location file using keyfile specify spkac
uninstall	specified archive uninstall
authopen	open authorization file
sysctl	kernel state set get
help	usage information verb display specified
writeview	given mib group views level certain create particular thus request access specified levels allowing suitable table entry security principals model snmpv3
-outform	specifies option format -inform meaning pkcs#7 output options structure
basename	directory pathname portion return filename
--env	environment used may modify filter performed need commit
tcpdmatch	oracle wrapper tcp
style	mails defined second references replies style end appear addition subsequent make controls node separate in-reply-to put info default according headers output footnotes first
--ignore	ignore diff generation changes submodules
--rmt	default instead use cmd $loc$
asn1parse	asn.1 tool parsing
jrunscript	line shell command script
alter	foreign-data domain sequence operator table server index conversion generator wrapper trigger role type function mapping membership user aggregate change definition name database foreign view
return	select() returned form descriptors number system call s=x ready x
acfs	volume mount xsan
dim	map commands number dimensions computing create use direct defaults given update categories
--context	containing show matches leading contiguous lines num place groups line -between trailing
yy	specifies control regardless map transmission certain character escaped whether characters peer async requests
framework	framework given generates metadata
modname	-g name generation option -i module explicitly install sets template
--rsh	use shell rsh option communication cmd allows copies $num$ program choose rsync instead alternative local remote
-encoding	files used script default plain encoding character html (by text output reading specify utf-8)
xliffdocument	xml import-xliff xliffdocument format builder translations replace xliff expected specified interface document extract strings localizable
lreplace	new elements list replace
weight	commands scale number weight point may positive create update negative words specified input counts floating
-name	searches specifies use short name parameters ec friendly key private certificate names file specified matching
-symbols	write files generated directory symbol
connect	protocol number packet dial-up appropriate ppp done something need needs prepare script instance valid milliseconds finishes started dial phone link peer wait commands n sent usually modem connect
event	given name identifying acknowledged number records marks event select specifiying
buffers	use set buffer unaligned system i/o file caching yes
--kill	named kill job
since	exclusive named show commits top two limit inclusive) output (bottom
--host	specifies name database running server machine host
lineno	processing number jump file specified ldif line entries
debuglevel	debugging level set debuglevel ldap
print	available rsync short describing help page exit options
makeinfo	translate texinfo documents
asr	restore copy apple volumes images disk software
ciphers	ssl tool cipher list display
asa	characters carriage-control interpret
cookie	option replication cookie provides syncrepl consumer
proxy	use hostname protocol nc server talking proxy_address connect specified using requests port proxy
-extensions	section extensions add certificate
rlog	files information log messages rcs print
--dimensions	map commands number dimensions computing create use direct defaults given update categories
w	dialect associated name process initial character number supplied maximum column unix command printed defines
..."	use groups administrative privileges computer listed determine local
encoding	specifies files used dump database create encoding character specified script set reading output input scheme specify
kext	specifies search set resolving kext kexts known add dependencies plugins directory
number	show skip numbering prints i/o prefix disk patches less location exit 512-byte read unlimited fats cannot know entries cherry-pick integer unique name decimal tar-1.14 server try default 0xnnnnnnnn output side tar-1.14.90+ set bytes connections connect blocks d=0xnnnnnnnn ocsp merge subsequent written strip-path new receiving full commits given offset stage digits limits many page assumed usually commit requests block named abbreviate number parsing names strip size use 32-bit start leading system least extraction unmerged files outputting form telephone volume purposes copy none checking maximum n values mainline parse file limit id physical end shorter rules authentication instead document strip-components begin multiple allow buffer object uses user pages numbered peers sha1 remote considered lines components starting $num$
jstatd	machine jstat daemon virtual
replstr	ed replstr modify according syntax member regular names substitution using expressions expression archive $num$ utility
--no	gitmodules fetched populated produced specified message whose submodules controls add reachable new tips git-config head option commits branches list (see signature commit $num$
heads	heads number drive
script	specifies negotiation protocol dial executable number dial-up initialize appropriate ppp done something file specified need serial terminated given end prepare script rather terminal instance tape shell sent used run started evaluate completed communicate needs pppd phone link execute device line commands implies batch specific multi-volume command mode usually passing modem initiating connect
identity	automatically given code truncated sequences restart owned sign values change using path table columns identity
schema	domain form dump pattern remove define contained objects selects new schema changes matching schemas
option	specifies foreign-data letter tar strategy-specific clause format specified displayed number -caserial header extended names file pass keywords given) n serial -cacreateserial subject customise certificate generic self means window wrapper strategy handles archives way new issuer selects used option provides posix.1-2001 modify mapping specify -text user separate input optional change must run-time determines signed database need $loc$ value server specific merge without behavior output options reserve
--rejuvenate	named job rejuvenate
transaction	current two-phase transaction prepare
snmpusm	network maintains entity creates snmpv3 users
rootpassword	account password root used
-convert	files convert system indicated format back one write file specified
processid	processid top display
xxd	make hexdump reverse
grep	print pattern lines matching
slapcat	utility ldif database slapd
str	use locale c translating default keywords output document texinfo
--younger	younger jobs list given number hours queued
cvcp	xsan copy utility
--strategy	strategy-specific use option given supplied strategy specific merge pass order specify tried
null	whether marked forms column values allow reject null change
shadowfile	use image primary file shadow conjunction data
bsdcomp	code bsd-compress sends request nt compress packets maximum peer using nr scheme bits agree sent size
lib	instead library trace
extparam	-e search none general extensions specify
-onlyin	directory scope search limit specified
passwd	passwd simple use password authentication
-personality	kernel named kext personalities send
dscl	directory line command service utility
-xcconfig	load building settings defined filename build targets
-protocol	determines desktop flag directory home mounted
-srcimagekey	image $loc$ system recognition pair disk specify
--refs	whose use shell pattern refs given names match
--dirty	describe tree working
-status	tolerated seconds times range response options specify ocsp
ext	-e files search used extension default (by none general determined extensions format) output specify
clean	files merge corresponding ._* native
--occurrence	named used process list num occurrences file diff extract delete
dscacheutil	information statistics service gather initiate cache queries directory
notifyview	given mib group views level certain create particular thus request access specified levels allowing suitable table entry security principals model snmpv3
xcode	xcode $loc$ current manages sets bsd path folder tools
readview	given mib group views level certain create particular thus request access specified levels allowing suitable table entry security principals model snmpv3
ipv6cp	configure-rejects set number retransmission seconds interval maximum configure-naks n default transmissions send timeout configure-request ipv6cp instead terminate-request starting $num$ restart returned
font	used name plain rich text converting font specify
find	hierarchy file walk
ruid	real given name records user id select
keychain	containing corresponding certificate created image -certificate secret specified keychain specify
parameters	print note used results option
mpioutil	paths configuring tool logical multipathed units
merged	whose head branches list reachable specified commit tips
--decorate	print commits shown ref names
-packetencrypt	debugging default encryption required packet disabled allowed problem example
--schema	dump contained objects schemas selects matching schema
iopending	plot disk number pending events
logfile	sending log messages well filename syslog file append
-fontsize	used plain points rich text converting font specify size
restart	set truncated owned challenges chap sequences table pap retransmission columns lcp seconds ipv6cp restart none default interval n ipcp timeout $num$ automatically
bytes	sector bit-digits number two cluster single file archive size whitespace hex system per written eight separate volume every characters bytes limit output block
timelimit	seconds timelimit search complete wait
egid	given group name effective records id select
x	sizes numeric factor multiply font specify
crl	crl utility
orderfile	orderfile pattern glob per one shell specified output line patch order
dump	control profiling postgresql database script client file extract
creator	specifies code creator number four set file null 0x52486368 binary designating octal empty string notation standard characters fourcharacter macroman decimal output hexadecimal
locale	specifies used database locale lc_ctype setting
pmset	management power manipulate settings
arg	specifies request arg number ec days file specified trusted subject use adds parameters field make source valid elliptic instead parameter certificate option outputs given new replaces prohibited user key input encoded password data short name pkcs#12 curve modified creates alias private sets output
sizelimit	sizelimit search retrieve entries
agentxtrap	notifypdu master agent send agentx
-namespace	username account sets primary convention naming
dn	dn adding use entry container dump requested database thus subtree access specified computer exist fetched ldap corresponding entries check specify must
--text	commands used dump evaluate create update texts delimiter passed specify input_files
uux	command execution remote uucp
outfile	output file name specify
interface	given set remote $loc$ packets source address interface identifier local 64-bit
logfd	log messages send n descriptor file
rminame	remote name object bound registry rmi
llength	count elements list number
c	executing terminator use % character listing instead selects files option may newline c characters input -a line begins processes magic changed command
last	specifies sort nulls non-nulls
-caname	specifies certificates friendly name
foreign	definition foreign-data wrapper remove new change define
context	groups containing thereby hunks show matches trailing contiguous lines number num place context specified close diff line -between fusing leading
--scripts	directory path copied package scripts
lsof	files open list
nbuffers	use processes number server sets shared buffers
point	mountpoint snoop filesystem
header	headers header add email arbitrary
slots	used van compression inclusive $loc$ number jacobson header connection code decompression sets slots n $num$ must
zipinfo	detailed information list archive zip
rpcgen	protocol rpc call remote procedure compiler
rcsclean	files working clean
create	foreign-data encoding image lsm specified size provided given generator index create sequence wrapper build new input_files define map raidset conversion volume tablespace data name specifiying schema
strategy	use tried given supplied strategy merge order specify
fuser	files processes process list ids one open
pg	postgresql script database cluster file extract
--branches	$loc$ branches show respectively refs pretend remote-tracking command listed (, found commit line respectively) tags
createlang	new procedural postgresql language define
kerberos	default password
precision	digits indicated many precision characters print integer data
--apropos	indices manuals look string
batch	generated like dest update write previously w/o stored batched file apply changes write-batch updating
-keyout	created private filename write key newly gives
--max	show number num file tells size non-zero given transfer least descend pathspec limit files commits rsync levels line must limits many directories larger depth command output delete
error	status errors mail output error send standard write job file specified instead occurs
darwinup	manage roots install uninstall
pack	specifies given via run non-default repository exec=<upload-pack> clone end fetch-pack git command ssh passed path accessed fetch specify handled
nameofvolume	volume remove
-encryption	algorithm default encryption particular specified type specify
jps	status java process tool virtual machine
-key	specifies key read create private spkac file using keyfile
dsfromkey	generation tool ds dnssec rr
holdoff	specifies seconds many link terminates re-initiating wait
dumudf	media tool inspect udf structures interpret
keys	separated statistics comma display
stringsfile	format importstrings-file builder translations replace expected stringsfile specified interface document extract strings localizable
packagemaker	tool installation-package creation
user	separated owned set uid #, initgroups causes sudo named numeric group supplementary syslog rndc comma file specified owner root config jobs id select users one -u use based alias -l privileges facility system foreign access -user authorized local listed files used run option whose mapping generated display user selects peer -a conjunction queued secure change definition processes specify name starting list remove .key record extraced command sets server authenticating $num$ slapd
-rkey	file used responses rsigner private sign option key specified present ocsp
aggregate	aggregate definition function remove change
database	change database
-creationtime	files attribute creation time output specify metadata
flags	numerically comma specified open matching select given custom specify provides annotations separated generating passed records 64-bit compiler audit c list classes flags $num$
tclass	use traffic class specified
-zzone	co zone keyword time see details substitution $num$
-seek	hexdump used positions -r revert added file offset found
-path	option hostname request host present port sent ocsp
cut	line cut portions selected file
volumename	set volumename volume cvadmin active automatically
extra	processes postgres started server process passed specified command-line-style options extra-options
snmptest	network communicates snmp entity using requests
pathchk	check pathnames
source	specifies set ip file availability subject whose use copy nc send port source privilege match files used characters interface source_prefix beginning restrictions name packets
parents	commits none many least show
ldif	input output read specified standard write file instead ldif
targetlanguage	specifies target language resultant xliff document
--owner	specifies files database extraced user owner new change
...	specifies control regardless requests certain image relative character sub-directory encrypted public map used keys characters async peer hashes distribution specify escaped protect created transmission list identified whether amount output hexadecimal changes
xcodebuild	xcode workspaces build projects
-spksect	containing name form section allows spkac alternative
format	log-file only) existing (c degraded disk xml adding submodule uuid zone newdevice writing input string format posix.1-2001 partitioning updates using ustar name submission list mode output set logs reference erase mirror ensures e-mail provides new email metadata full chose whose given standard put 1.13 logging created allows commit soa repair number one unix pretty-print oldgnu raidvolume use fuller prepare removing system formed scheme selects empty medium option form floppy differences volume patches specify must none gnu default signed r posix <=1.12 property display tar specified raw oneline file serial archive contents information containing per-update write also exactly raid effect generated exported v7 device ibtool short well u volumes posix.1-1988
evaluate	map lsm classify specified categories input_files
-passout	output pkcs#12 password file source
-cafile	containing certificate verify ca looking issuing pathname trusted file signature certificates crl
--info	info flat end script .plist package bundle package-info multi-volume tape file path run implies
d	domain cache purposes instances directs file open append use contains authentication cause files complete host device search name local directories depth directory lsof
continue	values change sequences
-command	comparison use command
--exec	used remote git-upload-archive path side specify
topsyscall	syscall top name syscalls
-svar	val value var preset file variable mib2c.*.conf
per	sector sectors bytes number fat system cluster per file block size
pem	specifies file used -key option format structure -inform der specified argument private pem meaning pkcs#7 key output input -signkey options crl
prog	compression generally access program prog archive
kextload	load kernel extensions kexts
ping6	network echo_request packets send icmpv6 hosts
subdoc	named name extracts specified .xml document cwd subdocument
uudecode	binary $loc$ file
oem	characters string oem $num$
output	key instead containing passwords name zone format created signed one write output_file contained pathname private file input output data present result
from	specifies list related one names file specified exclude extract transfer create contains per listed input include files option get read standard using line exact specify f allows patterns
xgridctl	control interface daemon xgrid
by	automatically associated option sequence column well owned specific dropped table whole causes
certificate	flat metapackage name certificate package sign
constraint	domain adds (create_domain form constraint create syntax using new drops $num$ constraints
range	files within based allow selected specified range file time modification falling inode change
block	number cluster file disk d=0xnnnnnnnn size iso-9660 media system per written physical structures form read tool inspect udf joliet interpret bytes 0xnnnnnnnn block
--tree	filter rewriting tree contents
cutoff	none
--depth	git-clone depth=<depth> git option repository truncated commits create shallow number created (see specified deepen revisions clone $num$ history
mdns	mdns service & tool dns-sd multicast dns test discovery
rows	function rows set-returning returned number estimated change
reindexdb	reindex postgresql database
fast	git data exporter
subst	code encoding formatstring unicode constructed given point source valid input option cannot characters represented byte placeholder string applied wide target bytes value replaced
--reedit	invoked like -c edit user commit message editor
-groupsize	bit-digits separate hex bytes two every characters output eight whitespace
files	followed show lsm number existing file specified untracked open matching contents size 32-bit create archive add new classify files map device pager categories input_files grep checksum directories $loc$ list crc output
--block	checksum fixed force block-size
erasevolume	write none system existing volume erase file new empty
info	info information bundle flat file sector get .plist fat32 system logical package read documents location multipathed path package-info unit
sepstring	sepstring next printing file print line fragments
exdir	directory extract optional files
--weight	commands scale number weight point may positive create update negative words specified input counts floating
up	prints multiple page output document pages
--macro	macro-expanded @setfilename ignoring source file output
--copy	files rsync destination option unchanged behaves also compare-dest using directory found copy local dir like
z	specifies information layer extended solaris handled zone starttls contexts selinux $num$ security issue operation transport higher
parser	text search parser remove
--lc	specifies setting lc_ctype used database
chap	pppd given set number retransmission seconds challenge interval maximum n challenges default chap every rechallenge timeout peer transmissions $num$ restart option
curl	libcurl information installation get
definer	whether function security definer change
procsystime	call analyse system times
application	specifies application use file opening
spkacname	containing name form allows spkac variable alternative
hdiutil	etc verify burn attach images disk manipulate
--source	specifies language resultant source xliff document
--compile	write specified compile file path input
--sockopts	options tcp specify custom
algorithm	cryptographic algorithm selects digest select
age	tolerated seconds times range response options specify ocsp
--since	rev-list parse git corresponding string show commits max-age= specific date output parameter recent
depth	truncated number specified revisions given git git-clone create descend pathspec depth=<depth> option repository commits clone shallow levels deepen line created directories (see depth command $num$ history
projectname	project projectname build specified
--untracked	untracked files show
valfunction	specifies function given name servers foreign-data previously registered well wrapper check generic validator user using new foreign options called valfunction mappings
sector	sector bytes number per
-issuer	specifies current certificate issuer
-challenge	specifies challenge created string spkac
dropdb	postgresql remove database
-title	files title attribute output specify metadata
dnssec	signing rr dnssec generation tool key zone ds
--keychain	signing keychain search file specified identity
ldapsearch	search tool ldap
include	style read stdin - html file output include
resources	directory path copied resources package
ecparam	generation parameter ec manipulation
unzip	files zip list compressed test extract archive
rollback	transaction savepoint back current abort roll
--mode	files adding (see chmod apply $num$ permissions
rcsdiff	compare revisions rcs
--notification	status send job error mail occurs
dbname	specifies specifiess added reindexed name language database global discover analyzed objects cleaned connect databases clustered removed dumped dump
-in	specifies file specified parsed certificate submit filename input working option read standard job key data parameters default pkcs#12 $loc$ request directory crl
button	widgets create button manipulate
-id	used interest job submitting identifier xgrid
-format	files contents) force indicated using format default specified interpreted determined (by file input output
.suf	.suf instead use suffix .gz
--match	given used consider repository tags pattern avoid leaking private made matching
-iv	digits use actual string hex iv represented comprised must
--tape	n*1024 bytes tapes change writing
pkcs12	pkcs#12 file utility
download	large files fetch web
index	files index working definition recreate tree remove new copy change define
-company	files attribute company output specify metadata
--pax	used tar posix.1-2001 modify header handles extended archives way keywords
-inkey	file read rsa private default key input
--node	info file visited nodes specify first
--pretty	given short fuller logs full format one raw medium oneline pretty-print commit email contents string
-switch	xcode $loc$ current sets path folder
--newer	files instead file modes newer-than directories mtime except only) compares ctime r u newer specified date (c entries include store like
-project	project projectname build specified
--dst	given b/ show destination prefix instead
--timeout	set option seconds allows maximum i/o timeout
len	stop octets len writing
spkac	generating printing spkac utility
cert	certificate encrypted image authority access specify secondary
--doc	built gui packagemaker file using path .pmdoc
--before	min-age= contiguous parse num containing git leading show -between parameter rev-list corresponding string matches commits groups date line older lines specific place output
--candidates	considering consider tags describe committish n candidates input instead $num$ recent
boolean	ibtool runnable option editable value compile produce instructs flatten file output combined
apply	apply set command arguments
gateway	specifies use destination next hop gateway
use	co zone keyword time see details substitution $num$
set/drop	set default value forms column remove
links	followed links checksum $loc$ list produce link file path internal size
--remotes	$loc$ branches show respectively refs pretend remote-tracking command listed (, found commit line respectively) tags
inet	one program configuration option tlid inetd wrong unable suspect .conf file uses tcpdmatch find specify network
factor	size bytes n=20) nx512 block (default
pppd	daemon point-to-point protocol
f	specifies another gnu-format incremental names file extract archive use end working script create character program tape new selects begin used run get track processing volume meaning device implies $loc$) f -, $loc$ list keep multi-volume fields output backup (default
challenge	set number default challenge transmissions maximum chap n $num$
--stage	files named checking entries instead copy unmerged stage
abort	whose tagged transaction handle tags object current abort filtered specify
columns	using logging display columns mode
mrru	receive maximum n reconstructed sets unit
fetch	download refs objects repository another
slapd	specifies daemon stand-alone file ldap directory configuration slapd
0..9	use compression specify level
reserved	reserved number sectors
tar	tar gnu archiving version tape archives manipulate utility
process	process made call system
sudo	execute command user another
tab	output format specified
-dids	jobs schedule dependent successfully list finished job execution
serial	soa specifies use 32-bit outputting zone format self number signed volume certificate integer serial id
-groups	use groups administrative privileges computer listed determine local
ipparam	ip-up ip-down extra provides scripts parameter
delay	set finishes script seconds packet n delay peer valid connect ppp updates milliseconds wait
pkcs8	conversion format tool private key pkcs#8
forest	username account sets primary convention naming
sid	generated use entrycsn id server
pkcs7	pkcs#7 utility
--inline	content-disposition create $loc$ patch second part attachment inline commit message first
--checkfor	saying returns return string script libcurl outputs possible current enough version text want new installation oldest $num$ specify
-req	input self signed certificate must
fsmhostname	machine located connect fsmhostname fsm
outdir	directory job $loc$ results store
--word	regex instead use word delimit show changed runs considering mode words using diff decide non-whitespace
-length	end default bytes number parse file
lines	show number controls specified close message diff hunks -m fusing -n send mail include used option thereby standard input execution lines context options notify
allow	debugging signing number subnet default ip required use peers packet telephone disabled without connect allow allowed problem given authenticating example address
-sign	certificates include request additional signed
--mail	used option -m -n lines number send standard include controls notify input mail message execution options
write	dest w/o like updating write-batch
snmpvacm	control access network maintains view-based creates entries entity snmpv3
ls	directory list contents
lp	print files
xliff	xml import-xliff xliffdocument format builder translations replace xliff expected specified interface document extract strings localizable
createauth	group net-snmp extension certain create mib thus standard access specified allowing table entry principals type view
-nameopt	determines option displayed names subject issuer
tput	initialize terminal database terminfo query
merge	development join two together histories merge file run three-way
mode	set show specified file cleaned untracked diff message counting event statistics system bits files option modify collection words using compatibility specify word delimit created changed mode sets commit
archval	files represent (either plain universal specified ppc64 ppc i386 file checksum print archval binaries displaying mach-o contents size
identifier	load repair set iokitpersonalities within kext logical cfbundleidentifier device adding file mirror degraded disk raidvolume unit whose given described uuid -b remains newdevice opening application interest new local xgrid $loc$ status used raid get use executable bundle job grid exported multipathed known immediately unique compatibility 64-bit backward remote look unload package kexts information submitting specifies identifier interface display
configfile	use code generating configfile
frequency	available commands create update
-job	list job retrieve attributes
req	pkcs#10 generating request certificate utility
rev	quietly symbolic actions unlock result file respect find revisions given log working rev send actually print instead revs revision files run option pick effect standard taken found difference comparison locked parameters overwriting remove merge specifying diagnostics output massage names
ref	ensures short name reference css graph formed well loading objects select file specified commit generate automatically non-ambiguous
contextmatch	certain thus specified table snmpv3 given group net-snmp create mib access principals type views standard levels allowing particular model extension level request entry security suitable view
dictionary	text search dictionary remove
indent	info xml elements indent val default spaces paragraphs $num$
fqdn	adding domain used name (, .ads.demo computer dns directory fully-qualified .com)
length	n*1024 sha1 tapes bytes term display length minimum listing output writing alter change
pathname	containing option snoop ca hostname request trusted host pathname present file certificates port sent ocsp
suffix	files use used suffix -b default database allows add output backing determine option specified override instead entries backup generate check ~
owned	automatically associated option sequence column well owned specific dropped table whole causes
echo	echo-requests frame dead echo-reply given send write echo-request arguments receiving sent option lcp seconds standard pppd every presume peer n without output valid
classname	i/o kext unload defining iokitpersonalities terminate possible classname instances plane registry ioservice class
diskutil	verify local modify disks repair
-out	specifies results private file specified parameters filename write pkcs#7 certificates store keys standard job key encoded data specify default der $loc$ place structure directory output
owner	specifies new user database
raidvolume	repair given set raid whose adding newdevice exported mirror device new degraded disk raidvolume uuid
authzid	exclusive authzdn=dn session .conf throughout id -o authzid test authorization dn requested used means rules details); specify bind (see authz-regexp mutually authz-rewrite mapped sasl $num$ slapd
system	domain jobs named list system reports one hardware systems install adds configuration queued software
wrapper	definition foreign-data wrapper remove new change define
priority	lowest operations created changed update rule priority job sets specifies highest $num$
nvram	nvram variables firmware manipulate
identifier@address	files whose generating loading symbol kext cfbundleidenfier treat address loaded identifier
configure	system set number configure lcp default request configure-request send maximum frames transmissions ipv6cp ipxcp n $num$
asyncmap	accm end option link sets async-control-character-map
-localhome	determines (, plugin whether directories enabled default flag computer forces home local $loc$)
ipv6	set remote $loc$ interface identifier local 64-bit
rsa	tool processing rsa key
cvadmin	administer xsan system file
rcsmerge	merge revisions rcs
--help	available rsync short describing help page exit options
cvlabel	luns xsan disk devices label
nprocs	processes nprocs display
--exception	given format generating exception final file considers metadata
msec	delay snaps msec trace milliseconds
formatstring	code encoding formatstring unicode constructed given point source valid input option cannot characters represented byte placeholder string applied wide target bytes value replaced
-classpath	files script .class user accessed find specify
--index	node rewriting string index pointed recreate filter go entry
min	files maximum minimum file reached still -f min field pad print fragments .max string format max active line like end-of-file according width
archive	rename named tree installed archive information create write archives input files used read standard path specify overriding remote default list pathname git-upload-archive output side
--link	files unchanged hardlink dir
-shell	use shell logging attribute $loc$ computer exist user (, specified directory
--bundle	load located bundle bundlepath
device	$loc$ followed number one interpret erase file disk destructively containing iso-9660 snoop removing system writing write instance split new scheme structures empty multiple dad0) tool inspect none volume udf device joliet existing resize partitions partitioning name partition (eg volumes media non-destructively
class	specifies containing useful key zone indicates default remove keyset mode dns specified operator class record
url	index used remote urls reference url responder relative base specify file include generate css
--system	jobs named list queued system
keyname	specifies authentication rndc name key
-output	used name file output specify first
pwpolicy	password gets policies sets
text	search dictionary text parser remove template configuration
terminate	ipcp set lcp terminate-request maximum number default transmissions ipv6cp n $num$
-signkey	file supplied option certificate input request private sign signed key specified signer using signkey self causes ocsp
--open	files grep open output pager matching
getfileinfo	files attributes directories get
funzip	filter pipe archive zip extracting
-gid	specifies used attribute logical gid grid user interest identifier xgrid
local	set remote facility selects $loc$ syslog user interface identifier local $num$ 64-bit
-serial	added option certificate request number except cert num serial
words	regex map excluded found equivalent command stop_word_file parsed texts plus evaluated words specified word-diff=color word-diff-regex=<regex> create
h	domain adds install
view	definition group net-snmp extension certain create mib thus remove standard access specified allowing table entry principals type change view
requirement	specifies input requirement
exists	foreign-data domain family sequence text parser exist operator table index conversion wrapper throw trigger role template type schema function dictionary mapping tablespace user aggregate configuration class search language rule server cast error view
--comment	comment -m specify included mail sent
iostat	report i/o statistics
--only	dest w/o like updating write-batch
fddist	dtrace descriptor distributions. uses file usage
--exclude	specifies dump process related syntax simplified file specified exclude matching schemas tables based pattern contains per listed match schema files full option form normal rules upon ruleparsing line one table directories rule filter patterns allow defaults
pattern	pretend consider show process bytes refs private syntax header shell simplified names file specified exclude message remote-tracking matching glob-pattern whose given based log found pattern avoid respectively) send archive member may pad listed normal commits command defaults include match files allow used option repository tags matches modify glob leaking use ruleparsing ones packet (, commit line upon specify respectively made branches full rules directories $loc$ lines according rule filter regular limit form fill output expression $num$
--certificate	flat metapackage name certificate package sign
-certpbe	used encrypt key algorithm selected private allow certificates options
kextutil	load diagnose kernel problems kexts symbols extensions generate
routing	received set protocol routing option
boundary	content-disposition create $loc$ patch second part attachment inline commit message first
--starting	begin archive file f
email	cancelled headers cc finished job send header add state address notifications email change
lun	information given set raid whose repair newdevice get uuid logical adding multipathed mirror device new degraded disk raidvolume unit exported
jot	print random sequential data
--date	override date used commit author
job	specifies job modify existing
key	signing set fetched defined hex image comprised variable file specified initialized disk newly-created recognition use checked takes display section storage system process affinity treat pair remote files string repository associate effect specify descending key represented immediately configuration pool must digits sorting actual keyword created $loc$ ignoring flags directory order history
group	#, sudo primary numeric one group-name file specified root) id select use group gid (by role privileged run passwd membership user members based change name database default starting allows command sets normally options slapd
configuration	text search configuration remove
dsimport	description empty
plugin	load plugin object library filename file shared
admin	administrator name database make kerberos account authorized changes
cupsd	cups scheduler
attributes	case letters string list job sensitive retrieve file sets attributes bits
comment	comment -m specify included mail sent
ci	revisions check rcs
-genparam	algorithm x.509 approriate key certificate
chmod	directory affect $loc$ file permissions
gitk	git repository browser
table	parent tables reindex analyze adds target form views pattern specified definition remove new cluster change clean child table sequences matching dump
libdir	command passed linker option directly
copies	detect renames well number copies sets print $num$
authcid	exclusive session .conf throughout id -d authentication test authcid dn used means rules details); specify bind (see authz-regexp mutually authz-rewrite mapped sasl $num$ slapd
username	specifies superuser domain $loc$ submits owned computer connect specified use network create alternate cancels connecting administrative username jobs user scheduler disabling specify account name triggers local drop server connection authenticating privileges proxy
--blocking	size bytes n=20) nx512 block (default
-packetsign	debugging signing default required packet disabled allowed problem example
controller	targeted modify specific controller user allow attributes
plain	32-bit followed checksum $loc$ crc file contents size
value	comma disk password uuid parameters opt means matches records (, immediately attribute-type server specific specifies foreign-data set often computer static specified initialized newly-created recognition index specification separate contained provides new public repository given effect key java configuration optional change property logging -c created $loc$ pathname expression options named fetched clause image one variable path trust select use checked takes system wrapper returns gid files shell option form tokens run-time delimited specify account default value n attribute-value index-method-specific history changed associated uid attribute enable exist file need containing depending generic storage shorter setting build sid parameter extended provided mapping regular user letter pair remote algorithm changes without sets directory $num$ reserve
-keygen	specifies engine used string would generation key unique id operations
fault	faulted a=0xnnnnnnnn 0xnnnnnnnn form address
-verify	locate search additional certificate attempting signing containing file certificates response ocsp
rename	rename archive
rndc	generation tool rndc key
codesign	signatures create code manipulate
vj	used van compression inclusive $loc$ number jacobson header connection code decompression sets slots n $num$ must
--user	jobs named list queued user
--sign	flat metapackage package file path distribution .dist
-domain	adding domain used name (, .ads.demo computer dns directory fully-qualified .com)
--bwlimit	second per i/o bandwidth limit kbytes
incr	variable value increment
pmdoc	built gui packagemaker file using path .pmdoc
--domain	domain adds install
sadc	collector data system activity
ldapport	alternate tcp server listening ldap port specify
php	interface line php command cli
expand	macro-expanded @setfilename ignoring source file output
mech	sasl authentication used mechanism specify
i	files whose matches listing address specified internet selects
subtree	dn given mib dump removing create entries thus subtree view specified entry snmpv3 table check delete
mostrecent	default option
auditreduce	audit records files select trail
command	program named $loc$ allowed simulate simply show transfer list forbidden approriate request gitk -u shell current performed determine specified need rsh alternative jobs contents index use set runs snoop script -l initial -i copies rewriting passwd x.509 exit allows certificate communication instead revs local execution choose file used run option opposed may enter modify rsync host user key entry variable line one target comparison execute remote name algorithm environment default commands cmd tree requesting filter invoking -s command time commit login $num$
-pkeyopt	opt set option algorithm value key public
--diff	changed file select submodule unknown pairing copied type unmerged files added deleted symlink broken regular c b ...) modified renamed r u x
-comment	comment files attribute output specify metadata
--committer	regular commits $loc$ lines header ones limit pattern specified output expression match
add	index domain adds (create_domain form constraint column create (create_table syntax add file using new table $num$ contents
usage	usage calls show system related faults statistics call filesystem report page
linkname	link name logical sets
--chmod	directory affect $loc$ file permissions
dirents	number fat16 fat12 entries directory root
dest	compare behaves hierarchy unchanged transfers rsync additional destination machine also instructs local files option missing use hardlink using copy like compare-dest directory found dir
--connection	set maximum number connections user new
fats	fats number
friendlyname	specifies name certificate private key certificates friendly
--password	read password file
tail	part last display file
-keypbe	used encrypt key algorithm selected private allow certificates options
--files	files option f read exact create get allows standard specified list names file transfer using extract specify input
csplit	files based split context
works	no-r files-from options)
page	specifies print document pages
unreach	code number one zero aliases addr send terminates unreachable match notice noroute noport search admin packets rule try icmpv6 notneighbor discard $num$
slapdn	based string-represented list syntax dns ldap check schema
sequence	definition generator sequence remove new change define
-host	option hostname request host present port sent ocsp
export	git data exporter
yyyymmdd	date records given occurred select
--tag	whose tagged handle tags object filtered specify
--out	using format destination-path result specified output updates build
dsmemberutil	operations including membership various apis
--import	load replace file specified id apply matching plist marks input document object processing translations stringsfile interface localizable property builder values xliffdocument strings
getuuid	uuid returns associated takes options
preload	preload normal sends many ping6 packets possible fast mode behavior specified falling
--global	variable make global name script
--target	specifies target language resultant xliff document
host	specifies use name database default variant running server machine host specified instead
offset	hexdump used positions -r revert added file offset found
paste	files merge corresponding lines subsequent
--stat	generate diffstat
-v1	specifies use option algorithm pkcs#12 v1.5 pkcs#5
-v2	use option v2.0 algorithms pkcs#5 enables
extension	load file zend extension args.
column	info adds clean form column lines create (create_table syntax break default num characters using new analyze table $num$
ldaphost	alternate host server running ldap specify
-reqin	read request response file ocsp
xar	archiver extensible
-alldomains	domain determines plugin whether allows authentication flag forest
mergepartitions	repair given set raid whose adding newdevice exported mirror device new degraded disk raidvolume uuid
--stopwords	use stopwords
val	comment attribute spaces file paragraphs subject xml val author editor var metadata files elements company preset variable specify info indent default title value output $num$ mib2c.*.conf
-pubkey	hashes protect used created keys encrypted image list identified hexadecimal public specify
*	changed file select submodule unknown pairing copied type unmerged files added deleted symlink broken regular c b ...) modified renamed r u x
--attach	content-disposition create $loc$ patch second part attachment commit message first
var	@set @clear undefine var variable define
-editor	files attribute editor output specify metadata
function	function definition remove change
-pid	processid top display
but	option though required sparse already-existing resend data conflict auto-disabled
volume	size 32-bit end name raidset script create filesystem remove id volume multi-volume tape build characters integer run label implies $num$ specifiying
pcastctl	daemons control podcast interface producer
partitiondisk	disk removing partition volume
spctl	secassessment policy security system
count	specifies echo_response diffstat packets measure number file specified script leading show call receiving cgi requested elements form commits stop repeated x path execution generate count sending last limits b=x bytes remove times limit mode time output
--dirstat	sub-directory relative amount output distribution changes
--process	none code run processing lines execute parse every file input line php
--log	log-file names file specified message causes rsync log per-update addition also one-line branch merged option populate commits exactly effect put logging specify must actual allows n descriptions
--not	one named jobs users request list requesting command opposed file transfer simply execution queued
record	node specifies named secure file record received list containing filename pppd records computer export characters specified comma-separated config sent name
limit	quit set errors faults default flawed maximum number connections read archive num limit user consecutive new trying $num$
distribution	flat metapackage package file path distribution .dist
minutes	available information set revocation days west nextupdate system value number field used fresh minutes gmt
--find	detect well copies renames
-sdk	xcode project appropriate build workspace specified using tools sdk
--add	headers header add email arbitrary
pid	-e followed last name snoop process pid argument running track examine command arguments option path using execution optional id must
-config	none
dumpiso	iso-9660 media tool inspect joliet structures interpret
replica	belonging configure firing forms trigger table
ini	use look directory file specified .ini path php
mtime	instead file modes newer-than entries except only) ctime r u newer mtime date (c compares like
-url	url responder specify
bufsize	variable buffer dynamic size
--temp	none
boot	bootstrap file get
other	locate search additional certificate attempting signing request containing signed file certificates include response ocsp
branch	branches create rewrite list delete
--plugin	load level plug-ins located valid pluginpath plug-in found first
dsexport	records export opendirectory
stat	status display file
repeat	specifies last number times repeated file specified
--upload	specifies given via run non-default repository exec=<upload-pack> clone end fetch-pack git command ssh passed path accessed fetch specify handled
newvolumename	specifiying raidset create volume build size name
bundle	specifies use opening bundle application file identifier
--error	default quit num errors $num$
-signer	option certificate request private sign key specified signer using signkey ocsp
--submodule	paths submodule chose format fetching differences messages prepend informative printed path output foo
rule	-f rewrite file-filtering $loc$ repeated rule .rsync-filter add dir-merge remove filter=
-certfile	specifies containing additional format read one pem certificates filename
ipcp	configure-rejects set number retransmission seconds interval maximum configure-naks n default ipcp transmissions send timeout instead terminate-request starting $num$ restart returned
-hostname	use ip hostname specified value -if controller address xgrid_controller_hostname xgrid present
