multipart	represents l{_multipartmessagestructure} i{multipart/*} message structure
limited	l{ilogobserver} : stores buffer twisted >>> fixed events size
code	via l{_traceback} object used code l{_frame} fake
partial	disconnected downloaded middle got page partially
chain	point multiple look exchange many l{iresolver}s mail name records host lookup indicating error using trying address canonical
switched	longer switched level accept connections traffic amp protocols
skip	skip add
forbidden	l{forbiddenresource} http specialization returns code i{forbidden} l{errorpage} response
global	mix-in log global stop observers start
none	implementation nothing pid file
existing	implements handing l{_isshconnectioncreator} supplied existing connection ssh l{_existingconnectionhelper}
gairesolver	thread l{getaddrinfo} implementation calling l{ihostnameresolver} hostnames resolves
known	~/ structured file ssh/known_hosts openssh-format representation
manager	set managed xmpp smtp manager accounts jabber business managing responsible send mail smart relay exchange user's component host uses relayers representing attempt esmtp messages server queue connection logic router
fdset	use able l{ifiledescriptor} implement type resources
ilogging	information used log give item generated context events
esmtpsender	easily sending factory emails utility
cooperative	resumed task l{cooperator}, inside object paused stopped l{cooperativetask}
query	represent @ivar calls url factory method single client portion dns path query xml-rpc post
wsgiresponse	wsgi helper hooks drives threadpool application l{wsgiresource} l{http using
dirs	directory completes names
ptr	domain pointer name
componentized	mixin ways various allow adapted persistently
urllib2request	object c{urllib2 work request} fake c{cookielib}
dhgroup	hash sha-256 exchange defined key group diffie-hellman sha-1
kqueue	relies kqueue reactor python 2 uses 6 /kevent higher
patcher	things cover objects neat new attributes monkey-patching
iterator	passes mixin container provides iterator mechanism python since searching module sys writer elements common behavior entries path periodically buffers input
zone	represents saving time daylight without offset timezone fixed
xml	protocol stream pre-serialized xmpp streaming marker jabber event xml takes generic factory handler reconnection objects mixin class care handlers dom server pipe xmlstream client reconnecting
sshtransport	supporting endpoint protocol object packets dispatch functionality ssh basic sending/receiving message representing transport
esmtprelaying	managed relay esmtp messages send queue host uses relayers smart
send	outgoing protocol direct send connection client
imap	account consider require mailboxes implementors supplementary implementing cleanup interface close classes
iconsumer	data consumer consumes producer
to	raised producer parser expects deferuntillocked} factory streaming sax converts l{deferredfilesystemlock non-streaming l{httpchannel} xml web twisted adapt internet document l{request} normal interfaces object wrapping stan interface l{twisted iopensslcontextfactory} adapter twice context model called
itcptransport	based transport tcp
istream	l{factory} set stream parser c{*args} l{istreamclientendpointstringparserwithreactor}, connections l{clientfactory} except l{istreamclientendpointstringparserwithreactor} listen string convert endpoint incoming like c{**kwargs} server client place l{istreamserverendpointstringparser} connect
encrypted	raised presented encrypted without key password fromstring/fromfile
irecord	entry single authority zone
sha256	hash sha-256 exchange defined key group diffie-hellman
presentation	particular system hint
redirection	endlessly redirection http occurring
sent	made attempt reasons request l{requestnotsent} indicates unrelated details issue
issltransport	based transport ssl/tls
predicate	predicate log level whether namespace logged results events lower l{ilogfilterpredicate} determined filters event's event
random	exception secure algorithm random raised factory l{insecurerandom} found providing l{securerandom} methods
iargument	box information object deserialize python serialize back l{iargumenttype} amp
string	raised set protocol don't simple parser c{*args} l{istreamclientendpointstringparserwithreactor}, formatted string-based single api send pass chunks transport provided in-memory long prefixed support except wrapper authentication l{istreamclientendpointstringparserwithreactor} l{amp incorrectly method string stringio 'str' conversion mailbox stateful trying pager locateresponder} like convert splits c{**kwargs} argument conforms plugin length l{istreamserverendpointstringparser} implement
macparams	represents authenticate necessary parameters l{_macparams} mac codes ssh compute message
subcommand	given code complete constructs usage zsh options
exception	raised one interpreter causes strcred create current state low-level l{_wrapperexception} type method form occurred failure base trying class exception include calling error exceptions
imessage	files definition handling representing smtp alternate messages delivery via interface implement optional message sent
choice	choices enumerated result types choice
mf	mail forwarder
updater	domain object callable 5 updates file aliases
anonymous	implements authenticate checkers generates request mechanism authentication anonymous sasl
locked	adding locked collection entities
formattable	formattable dictionary
unixserver	unixsocket endpoint server
imapfile	files optional messages interface message representing
icontact	registrar user proxy
colored	users syntax colors repl input type
level	use someone logging tried level unknown namespace system lower l{ilogfilterpredicate} levels filters l{loglevel} event's describing events constants log
dname	redirection non-terminal name dns
throttling	protocol l{throttlingfactory} number connections bandwidth throttles
iplugin	interface implemented plugins must
list	collecting required list parser multi-line results instances single displays file amp accounting utility ftp in-memory wire based contacts construct response decode buffer internal encode several type match multiple completes deleted tree tool object evil mailbox deferreds boxes lists words container standard l{deferredlist} class convert : callbacks argument items gui listings messages element comma-separated dictionaries fixed serializes
sshprotocol	multiple authentications checker succeed sshprotocolchecker requires
xmlrpcintrospection	introspection implement api xml-rpc
icloseable	require mailboxes supplementary cleanup interface close
malformed	wire-level protocol data error indicates l{_malformedchunkeddataerror} malformed c{datareceived} c{_chunkedtranferdecoder} encounters method raises
iinitiating	xml stream entity initializers interface initiating
polling	based schedule rather notification writes passage reads time
team	composite implementation l{iworker}
authenticating	credentials prompts authenticate protocol attempts
heading	mobile object heading
dir	directory interface dbm
system	useful "system" i/o home information system pydoctor parts basic might l{systemftprealm} used kinds docs account uses user decide particular interface generate relies l{tuntapport} avatarid performing directory operating l{twisted (particularly
ipush	known basis unless producer streaming data continuous write also produce push consumer expected
unexpected	received unexpected success standard add error expected data
force	errors run garbage collection forces test
ilistening	port listening
unixclient	unixsocket endpoint client
sshciphers	operations represents authenticate encrypt sshciphers encryption connection ssh need occur
managed	relayer manager smtp notifies
hack	attribute to-be-deprecated c{intnstringreceiver emulates recvd}
optheader	opt record header
beginner	begins logging holds related l{logbeginner} state begun told
initializer	stream binding number initializer minimum xml non-sasl feature 1 0 authentication version session performs establishment checks implements component base external interface entity class tls resource server-side initializers common sasl initiating
syslog	syslog logging log observer
afsdb	map domain name database server cell afs
download	disconnected downloaded middle got page partially
component	authenticator authenticate (where component xmlstream server initializer server-side authentication external components permit accepting entity jabber initiating
implemented	raised handling failed c{twisted given server indicates enotimp} command result dns query unimplemented implemented parameter names
port	event managed descriptors tcp connections tun/tap-device unix (i file specified multicasting foreign serial transport improperly use from/to datagram implementation writes factory port acting basic command l{memoryiosystem} supports udp used read tunnel-like object ssl base connected listening device data class socket listeningport windows local packets reads datagrams server win32 select()able posix either uses ports socket-like
win32colorizer	_ansicolorizer see docstring
canonical	set look form exchange found many point name records host cycle error mail trying resolution indicating canonical
compat	attribute to-be-deprecated c{intnstringreceiver emulates recvd}
dnsdatagram	udp protocol dns
clock	provide implementation deterministic l{ireactortime easily-controlled
jellyable	pb code helper capable sending jelly inherit class deals convenience directly peer avatars must method getstatefor'
isshconnection	l{_isshconnectioncreator} knows create somehow connections ssh
iftpshell	ftp commands shell protocol given used abstraction user account
ptyprocess	process support uses operating-system pty
int32string	int32-prefixed strings receiver
current	web raised normal create exception factory current failure state adapt context interpreter trying
gpgsafix	fix sentence possible types gpgsa
credential	implements credential @cvar http seconds l{bytes} support rfc2617 factory wrapper number authentication digest basic digestcredentialfactory} challenge_lifetime_secs @type authenticationrealm l{digest
mix	mix-in log global stop observers start
usenet	factory articles asks certain since connects server client usenet time new nntp protocols
template	raised render element loader without template trying l{missingtemplateloader}
fdwaker	used to/docs/selfpipe i{self-pipe trick<http html>}, wake //cr yp
hinfo	information host
apidocs	building documentation thing see api l{main}
public	raised checkers l{publickey} don't receive way valid contain signature part every key credentials pair representation public
pidfile	process referenced based implementation pid c{ifilepath} invalid concrete valid file nothing l{ipidfile} contents
body	declared protocol attribute) produces (via number produced file incrementally collects l{ibodyproducer} different l{filebodyproducer} writes going input sent object produce c{length} data bytes consumer
tcpclient	tcpv6 outgoing code tcpv4 tcp connections management shared non-posix reactors
widget	widget @ivar currently focus contained none focusedchild
hash	username credential used hash access credentialchecker apache realm password
smtprelayer	relayers base smtp class
conf	protocol conf simple parser unix names file port @ivar service invalid tuples dict 8 /etc/rpc /etc/services mapping inetd services configuration deprecated rpc traditional superclass
reporter	adderror prints via followed verbose stream simple text module #skips) single converts result #failures testresult things support print character l{util wrapper writing dirtyreactoraggregateerror}s basic test gets tests sure run trial's form reporter docstring l{testresult} standard taken running particular distributed #errors along decorator minimalist runs subunit #tests name makes adapter tree see reports summary trial (timetaken time output adapted workers send
mem	protocol server memcache values connect store/retrieve memcached
aggregate	reactor adderror} trial passed l{twisted ireporter itrial
icipher	tls cipher
wrapping	wraps made protocol builds track support factory wrapper connections connection user another keeps wrap adds proxy order protocols notify
icredential	credential kind responses challenge factory authentication way particular generate interpret defines
xmpphandler	protocol handlers xmpp collection handler subprotocol
isystem	os-specific handle wraps object networking
beacon	information term help reference beacons positioning cell beacon objects generalized determine satellites position (a
threads	functions invoked run methods thread exposed may contains dispatch set threads another interface let thread-safe reactor
groups	names group complete system
address	l{tunneladdress} username reactor family l{interfaces process supported bound used i{af_inet6}, parse (i another specified l{hostnameendpoint} endpoint 2821 transport addresses one use hold alias implementation data l{hostnameaddress} iaddress} invalid stub instance ipv4 ipv6 expected neither server email meant l{sshcommandaddress} missing l{iaddress} provider authenticate ssh address e l{itransport representing represents l{tuntapport} made attempt socket object tunnel i{af_inet}, translates rfc provide (eg command error etc) transports incomplete
directions	north west four cardinal directions east south
path	represent raised signify list abstract within module parsing instances single c{sys subclass file decode provided error object-space zip implementation top invalid access contained internal encode filepath} l{ifilepath}; l{filepath used paths python completed object sys wire proxy path must exception permits l{filepath} 'downwards' filesystem directory entry
smtptlserror	security negiotiating occurred transport error
iraw	arp udp ip tcp protocols interface icmp low-level
wait	see l{deferredgenerator}
box	wire-level via protocol packet indicates appropriate malformed '_answer', destinations implementation - detail switch state much terminates receiving sent ampbox outgoing dictionary l{ampbox}es error upon length-prefixed regular amp dispatches '_error' pairs incoming like protocolswitchcommand '_ask', bytes key/value connection l{boxdispatcher} sets strings
publisher	respond exposes singleton used remote publishing request l{resourcepublisher} events observers fans api log message class i{ilogobserver}
smtpdelivery	delivery indicates attempt error
inotify	raised unify inotify everything api watch possible related descriptor points notifying basically file exceptions reading
credentials	http passed simple check authentication another credentials scheme type yet digest knowledge
broken	setup exception c{testcase} methods teardown adapter emitted pyunit-style id() warning undesirable one subclasses occurs
receive	protocol file stream getting receive higher-level direct send dcc connection client bare coverage
root	l{pb used settings provide object openssl broker}s pbclientfactory} portal context login trust root
rrheader	record resource header
unpersistable	unpersisted back instance something couldn't class comes
queue	represent give list exist trivial event doesn't relayed addition wrapper yet also way method around driven notifications interface sending like whenever messages queue deferred
trial	runner uses number twisted marker single file wrap pyunit end support distributed feature c{trial} test suite used run around cannot every front specialised internally launches could trial found specialized
cert	certificate + private public certificates base key pair class
daemonize	reactor hooks daemonization provides need called
gtk3reactor	x portable gtk3+ 3 gtk+ using event loop reactor
published	representation object local remote publishable
climb	climb object speed") ("vertical
unixchecker	l{unixchecker} unix factory server checker credentials check
options	specifies available named addresses l{certificateoptions parser i{twistd file message create twistd web} sample-inetd use workers forwarded parameters trial 'none' dummysecurityoptions() distributed except everything internet shared c{optparameters} procmon} local tool define c{optflags} option conf c{list} deliver insecure basic worker <twisted disallow ssl lists mail line accepted c{twist} class @ivar dummy anything plugin -- list certificateoptions>} @type default c{str} command allow security -> options
sendmsg	file used sendmsg} mixin offer python descriptors behaviorless copying unix uses placeholder stream-oriented c{twisted recvmsg functionality transports sendmsg additional
proxy	domain provide protocol allows simple attribute results agent factory connections hook reconnecting invalid another registration implement port web sip container producer service relayed implementation notification ipushproducer} able cross wrapper l{_proxydescriptor access everything forwarder connectionlost mutation deletion internet parsed reverseproxy finite cause soap used http information python module-level interfaces act class buffer module put resource proxies data l{twisted man implements remote reverse calls middle gotten header tree lost server specific descriptor connection client renders proxyrequest producerconsumerproxy making xml-rpc proxyclientfactory consumer support provided proxy
register	specific domain allows proxy registration
ansi	wraps parser colorizer around stream color text object loosely write ansi callers allowing codes particular class
writer	pipe process's helper write internal input class
secure	exception secure algorithm random raised found
family	use made attempt socket family field supported i{af_inet}, i{af_inet6}, 'family' (eg values address etc) reactor
app	profile observer stdout runner configured syslog specified l{applogger} based log l{logger able custom logger selects files l{serveroptions} commandline object configuration class specific attaches options
offset	represents saving time daylight without offset timezone fixed
iworker	perform concurrently work worker
private	modes certificate x509 private key ansi-compatible
stanza	exception stanza error
authrequired	authentication required support server
unix	fork shed methods stdout simple pid syslog unix file event log things privileges able provides logger files wake interface applicationrunner class socket like unix-specific maintain loop
boolean	xpath wire false provide true operators "true" "false" boolean encode expression
fake	managed sometimes-builtin platforms file fake descriptors l{memoryiosystem} udp used c{urllib2 missing read tunnel-like object datagrams c{cookielib} exception work request} response} stand-in socket-like
marker	marker trial could file found
ftpcmd	generic ftp exception commands
txt	freeform text
select	select() runs threaded based reactor - win32 platforms posix
ifile	object may descriptors sent numeric unix-style descriptor l{ifiledescriptorreceiver} file interface path implement representing receive protocols
esmtpclient	sending errors esmtp emails client base class
from	implements defer invoked methods formatting may it's object order work c{str} set threads converted interface c{__str__()} thread-safe reactor
certificate	peers used want certificate don't x509 request use private one key expected local find
httppage	via http gets resource quits
recv	adds features l{terminalprotocol} history basic line-editing line editing input
dispatcher	commands based name service handlers '_ask', l{ampbox}es outgoing dispatch dispatching appropriate '_error' incoming '_answer', dispatches event l{boxdispatcher} destinations
connector	iconnector} implementation interfaces internet connector provides basic l{connector} l{twisted
iunixtransport	connections domain unix stream-oriented transport
handler	handle request state progress xml-rpc store
call	function scheduled rather turns mapping c{()}-suffix call repeatedly key invocation lookup read-only names
https	web https provides form creator verifying clients factory connections ssl connection adapt context policy l{client certificates l{ipolicyforhttps} normal
memory	domain work useful simple testing module i/o primitives unit based in-memory checkers implementation factory checker parts l{iworker} provides basic performance public dictionary keys drop-in object usernames c{os} simplistic ssh credentials extremely queues later registry specific context mapped l{twisted replacement
cram	encapsulation crammd5 hashed credentials
tlsversion	tls client/server negotiate versions
type	raised reactor supported back l{iargumenttype} encountered i{sock_stream}, information use i{sock_dgram}, etc) invalid authentication flattening provides type authtype serialize python object cannot flattened user known amp box made attempt socket deserialize plugin (eg identifier
start	mix-in tls use set log process worker global stop subclass observers start running command starts directory implement giving
authorization	raised client authentication fails
const	naming constant @ivar string name
iresponse	received http object server representing response
relay	protocol communicating process l{deferred} turning result output trivial
epoll	uses reactor 7 epoll
ipolicy	provides form creator verifying connections certificates connection l{ipolicyforhttps} https policy l{client
urllib2response	response} c{urllib2 work object fake c{cookielib}
expose	callable various exposing helper simple decorator-style uses using methods
xmppauthenticator	xmpp initializes server xmlstream client connecting
apopcredentials	credentials use authentication apop
ialias	interface aliases
long	raised protocol point violated (l{lineonlyreceiver long exceeded canonical one prefixed send protocol's mail indicating limitations string exchange records host line trying name look many maximum server length sent error
stick	log turns writes stdout/err messages class pretends
suite	library's single wrap errors logged consistently c{run} c{trial} usage suite method memory tests used run around extend object l{testresult} standard reported test every internally minimize remove overrideable c{testsuite}
iprocess	combines around process-related l{interfaces process interfaces work running various parameters interface l{_iprocesstransportwithconsumerandproducer} issue event transport handlers
arg	raised handling number value server wrong command arguments implemented parameter called
overrun	mis-use l{iunixtransport connection caused sendfiledescriptor}
md	mail destination
mg	member mail group
endpoint	c{*args} tcp l{clientfactory} wraps @ivar l{sshcommandclientendpoint} except l{istreamclientendpointstringparserwithreactor} l{istreamserverendpoint resolved string connects ssl fastest listening l{streamserverendpointservice} runs like c{**kwargs} name-based server unixsocket l{istreamserverendpointstringparser} set constructing testing connections connect initialized l{hostnameendpoint} port _spawnprocess outside command-executing provides provider outgoing standard host interface configuration l{iagentendpointfactory} tcp+tls convert incoming place requests addresses l{istreamclientendpointstringparserwithreactor}, servers hook another destinations described l{wrapclienttls} twisted ipv4 https ipv6 spawning l{itransport}, l{ipushproducer} way amongst l{iconsumer}, child exposes endpoint processes l{iprocesstransport}, descriptor listen l{factory} stream process l{iprotocol} parser agent file l{iservice} secured - instance client functionality used http implements passed ssh
join	join multicast attempt failed group
mb	domain name mailbox
tunnel	l{tunneladdress} represents in-memory used tap l{tunnelflags} implementation describe l{tuntapport} bound tunnel flags tun behavior device existing configure defines
ialiasable	interface domains email aliased
descriptor	select() domain mutation sendfiledescriptor} caused numeric unix file operated decode write adds support feature l{_proxydescriptor mis-use read l{ifiledescriptorreceiver} deletion attribute encode receiving sent half-closed exchange may descriptors offered object unix-style l{binaryboxprotocol} proxy mixin interface l{_descriptorexchanger} representing protocols socket receive l{iunixtransport access l{ifiledescriptor} descriptor connection implement
ssldefault	paths set built default verify openssl u{ssl_ctx_set_default_verify_paths specified trust
minfo	mail information list mailbox
mr	rename mail domain name
iconch	conch cred authenticated user
irenderable	may rendered object l{twisted l{irenderable}
ehlorequired	ehlo support server
pickle	flaws implementation numerous contains generally unsuitable using pickles trivial newsstorage
mx	mail exchange
feature	exception used stream support required feature twisted trial advertized cannot initiating base initializers entity class pyunit indicating
history	l{ilogobserver} : stores buffer twisted >>> fixed events size
sshpublic	files authorized_keys based keys user authorized_keys2 checker authenticates ssh public listed
py3test	files tests modules functions loader asked l{testsuite} test loads l{testcase} finds
saslerror	sasl exception base
dnsserver	eserver} l{dnsprotocol} failed indicates c{twisted factory server connections also tracker result dns query class names
stream	protocol mixin stream xmpp factory instances file initialized jabber port xml wraps error described takes generic l{iservice} connection twisted event outside handler c{write} wrapped l{istreamserverendpoint reconnection managed used business object exception l{untilconcludes<twisted listening representing care c{'wsgi l{streamserverendpointservice} runs endpoint calls streaming handlers value server descriptor xmlstream objects client logic reconnecting file-like
tlserror	tls exception secure support required transport factory supplied authentication base either context error indicating
process	protocol ended @ivar parameters implementation program input indicating l{iprocessprotocol} processes l{itransport} execution condition runs die timeout output l{interfaces testing operating-system operation event _spawnprocess errors probable integrates ptyprocess waiting provider progress ends stderr base selectable wx timer exited already simple twisted hook errbacks process's handled iaddress} restarts dispatching passed processreader spawning l{itransport}, l{ipushproducer} complete descriptors apparent occurred l{iconsumer}, child endpoint l{iprocesstransport}, deferred pending error loop associated helper stdout process l{iprotocol} performed file tells monitors write instance internal events requested used running class processmonitor longer stdin pipe alias without representation transports
lock	l{filesystemlock} raised fired acquired lock deferuntillocked} locks l{deferredfilesystemlock hack implemented event based system l{deferred} systems mutex unpickled l{iworker} driven unthreaded mutual-exclusion allows twice allow called
monitoring	files changes monitoring service
controller	received useful messages controller dns do-nothing
ichecker	provide l{twisted objects factory
xforwarded	layer top c{getclientip} request value header add uses result another x-forwarded-for
paused	resumed exception task previously raised paused
coerce	storing corce parameter class utility
tag	l{tag} represents l{tags} object providers name objects tags implementation l{irenderable} factory existing xml tag attributes loads children l{itemplateloader}
pop3factory	pop3 protocol factory server
publishable	whose persists sessions cached object state across
unhandled	locate received via knowledge could dispatched dispatcher appropriate handler command passed amp credentials type check
serial	event rfc1982 windows number ports win32 select()able acting base posix device uses serial class transport
spf	definition text structurally formatted freeform policy semantically
sslcontext	l{iopensslcontextfactory} generating capable l{openssl factory server-side ssl objects l{defaultopensslcontextfactory} context provider
usernames	usernames complete
ibody	provide object bytes write objects l{iconsumer<twisted provides l{ibodyproducer}
smtp	definition via protocol messages smtp server-side interface sent
verify	rejected verify could signed something error peer supposed
digested	http simple authentication another scheme yet digest
namespace	convenience object namespace declarations tracking
httpchannel	tls wraps http depending object expects one switches objects proxy negotiated receiver interface protocol requests l{request} l{httpchannel}
iresolution	initiated hostname results l{ihostnameresolver} receives l{iresolutionreceiver} progress resolution
ecdh512	sha-512 hash elliptic exchange defined curve key
iencoding	resource knows l{_irequestencoderfactory}
plus	body l{reactorbase run waker lines header normal iteration twisted turn retrieve wake causes mail simply message main class loop utility
hierarchical	filter things buckets nested
parameter	storing corce parameter class utility
loopback	sending whenever around give addition list wrapper deferred queue also way interface trivial notifications like
profile	runner profile module standard
map	none zipimport e default wrapper implementation importer ipathimportmapper zipimporter
description	tunnel describe existing
dnsnot	failed c{twisted indicates enotimp} result dns query names
information	information term help reference beacons positioning cell objects generalized determine satellites position (a
structure	represents i{text/*} kinds l{_rfc822messagestructure} helper defined l{_singlepartmessagestructure} l{_multipartmessagestructure} i{message/rfc822} messages i{multipart/*} non-i{multipart/*} base l{_textmessagestructure} particular message classes representing class structure l{_messagestructure}
chunking	l{readfile}, object access also zipfile} l{zipfile gives
insecure	provided deemed e secure g found l{filepath} required exception invalid jelly insecure'; mechanism error path raised could indicating authentication
use	simple credentials checker extremely
iprotocol	information wraps providing protocol service provide l{iprotocol} create l{iprocessprotocol} factory implementations l{iprotocolnegotiationfactory} various words provider interface factories plugins protocols
mapping	rather turns mapping c{()}-suffix lookup names key invocation read-only
collection	represent errors run forces garbage virtual xmpp object collection access entities test static wrapper provides services hosts subprotocol handlers
dnsformat	failed c{twisted eformat} indicates result dns query names
wrong	declared attribute) (via bytes number produce different produced going c{length} l{ibodyproducer}
mixin	code protocol reactor entries tcp manager l{twisted based c{registerproducer} implementation character behaviorless signals protocols marks functionality must c{_normalattr} positioning get python dispatching c{__str__} c{notifymoderators} dispatch new buffering emails l{win32reactor} easily name signal avatars server deals c{unregisterproducer} common timeout smtp notifies methods c{abortconnection} c{twisted recvline connections added lookup() event instance adds attempting factory access l{iconsumer} state provides internet filedescriptor} method run responses selecting implementing peer c{__getattr__} placeholder grab care sending commands thread handlers installs messages xmlstream multicast stream-oriented mixed attributes implement reactors sendmsg server} manage private unix another poll-like /proc/net/tcp utility easy-to-use additional capable terminal pb start state/attributes flexible define c{__ne__} offer descriptors observers sendmsg} l{ireactorwin32events} keeping client} wish work formatting install providing subclasses c{__eq__} helper certain abstract c{_disconnectselectable} implementations single file sentences defines returning storage write mix recvmsg take copying used separate track l{usage running produce uses designed mixin class implements relayer takes records bootstrap inherit options client time transports
date	datetime} tuple -- c{datetime encodes month instances year date day
such	function raised made remote name command given called cannot non exception install found existent attempt method reactor
destructive	tests run minimize remove usage memory test suite
md5password	username password encapsulate hashed
response	l{response} l{responsedone} indicates unparsable returned knows l{iprotocol describes l{responsefailed} instance version passed indicating status http string may bytes reason line connectionlost} response received request uri server error
types	fix sentence possible types gpgsa
man	protocol parser compatible logitech serial mouse microsoft mouseman
a	host ipv4 address
pop3	access querying hosting virtual server pop3 capabilities interface protocol mailbox
attempt	set attempt relay exchange messages server manager mail
postfix	map in-memory protocol dictionary postfix factory tcp postfixtcpmapserver implementation agent mail transport
bind	files implements //en resource zone bind error binding occurred authority initializer <https couldn't u{bind interface loads entity initiating
stdio	log turns writes stdout/err messages class pretends
bootstrap	mixin bootstrap factory observers xmlstream install event
head	http head request method
element	detailed code render l{failure<twisted frame l{failureelement} number one single l{_frameelement} part frames element xml information source details several node l{irenderable} object base particular line represents l{_stackelement} l{_sourcelineelement} list page near classes renders l{_sourcefragmentelement} lines
callback	container callbacks receive instantiate may peer pager pages
switch	use protocol protocolswitchcommand implementation detail different switch state amp-derived command something sets mid-connection ampbox
netstring	incoming complete format sends netstring enough valid receives netstrings protocol data
sslserver	create l{iopensslserverconnectioncreator} l{openssl provider
iresource	web resource
exchanger	adds file descriptors support feature l{binaryboxprotocol} mixin l{_descriptorexchanger} receiving offered
producer	producer l{interfaces bytes abstract sentences no-op certain streaming single superclass file non-streaming chunks incrementally l{tlsmemorybioprotocol} transport l{ibodyproducer} combines l{filebodyproducer} l{staticproducer} basis provide producing writes produces write also version various provides internet expected input several issue chunk used unless around business entire ipushproducer} interfaces continuous registered ipushproducer}, produce buffer mixin known l{_iprocesstransportwithconsumerandproducer} data l{twisted protocols man pull finite middle stand-in work request object act implementation resumeproducing() classes objects time push implement producerconsumerproxy consumer called positioning l{iconsumer<twisted
installed	already reactor could installed install one
looping	function call repeatedly
dhgroup14sha1	modp hash sha-1 exchange oakley 2048-bit key group diffie-hellman 14
v2parser	protocol parser two header version proxy
installer	definition installed reactor probably
ssl4client	endpoint secured tcp ssl client ipv4 configuration
digest	rfc2617 number @cvar mechanism digest-md5 hash digest digestcredentialfactory} support wrapper access credentialchecker authentication challenge_lifetime_secs username credential used http seconds apache realm password implements sasl l{digest
dnsquery	dns failed erefused} c{twisted due indicates lookup result timeout query names
write	body write tried sending read writes request writing l{ifiledescriptor} buffer finished log transport test bunch data indicating l{ibodyproducer}
systemd	endpoint string stream parser server i{systemd} type
position	position information error
disconnect	catches l{iprotocolfactory} c{connectionlost} c{_disconnectselectable} l{_disconnectfactory} notifications proxy mixin providing relays method
monitor	processes processmonitor die runs restarts progress monitors
inegotiated	tls used alpn/npn tunnel encrypted inside negotiate protocol using based supports transport
smtpclient	sending errors smtp emails client base class
isshprivate	checked user's private l{isshprivatekey} ssh key credentials encapsulate public
gtk	windows works reactor
rpcservices	/etc/rpc deprecated parser invalid rpc file services
tcp4server	implements endpoint tcp server ipv4 configuration
dchandle	wraps callbacks handle} ephemeral instances close l{asyncio
window	container object focus paint provides wrap-around scheduling top-level
complex	l{ihostnameresolver} l{iresolversimple} converter
bypass	tls used protocol object c{starttls} implement l{_bypasstls} transport
policy	web creator clients factory ssl connection adapt context normal
mail	email service
hidden	information string displayed able request server identify user port returned
md5	implements digest-md5 authentication mechanism sasl
inventory	sphinx around work custom broken references external sphinxinventory
ednsmessage	i{edns} message
non	formattable dictionary
float	encode floating-point wire values repr
return	returned value coerce bad unable command local
python	represent simple list dynamic module l{logging} c{sys object-space imported script top twisted function python object standard sys library representation path extremely class present resource embedded could messages output
cfreactor	corefoundation reactor
safe	wraps stream calls object l{untilconcludes<twisted c{write} wrapped
auth	raised methods helper authtype known expect string provided service convenient formatted invalid authentication way incorrectly defines might l{_userauth} added provides familiar argument implementing part ssh 'ssh-userauth' password response implements called challenge plugin server client l{usage identifier side user
nmeasentence	object representing nmea sentence
ichat	interface ichatservice clients interacts
fancy	implements c{__eq__} c{__ne__} implementation c{__str__} mixin flexible providing
aborted	code locally application connection explicitly aborted using l{twisted
win32reactor	win32 apis uses reactor event
not	reactor supported l{requestnotsent} entity debugger reasons valid indicating non random stop handling listening name server specific unrelated stopped source found isn't successfully module rmd operation implemented port imported appear attempting access enough vcs connecting import issue available run repository you're path thrown meaning advertized existent asked can't raised secure previously one doesn't given failed connector scheme resumed tree-manipulation unimplemented trying exception made values error called associated stream paused indicates exist file perform verify feature authentication internal details parameter used object running user task attempt algorithm required request uri command directory initiating
resource	respond code iresource encoding simple tree results l{resourcepublisher} found} exposes api result another escape wrap server use specialization record hostname able web-accessible method returns potentially https i{forbidden} cause remote define body eventually used http knows object generated dispatch scripts put applying l{errorpage} response i{not resource l{iresource}, gotten l{noresource} relayed request serves l{_irequestencoderfactory} deferred vs renders l{resourcescriptdirectory} filesystem directory everything l{forbiddenresource}
buffering	write buffering adds mixin
glib2reactor	glib using reactor mainloop
decorator	errors run testresult garbage collection base forces test cases decorators class decorator
permissions	read/write/execute instantiate representing class permissions
authenticator	jabber authenticate subclass entities authenticates initializing receiving enable business (where object component authenticator base external initialize accepting class server xmlstream client components logic initiating permit
name	domain set reactor point labels named entity identify names port canonical utility whose dot-separated unique service unknown system virtual generate l{ireactorpluggablenameresolver} mail cycle indicating describe multiple user-supplied form exchange python object given records host objects resolver maildir trying class look implements represents made resource name many internationalized list preparation hosts error found resolution example
locator	commands responder methods string-based simple object help l{command}s collection method application appropriate l{command amp implement responders l{commandlocator} locateresponder} l{amp look
decimal	instances decimal} c{decimal encodes
queuer	domain intended smtp messages queue add relaying
fdwrapper	l{win32reactor} wraps thread helper notification primary translates handler event reactor
itest	case used trial test interface implement order must
iconnector	interface connections object protocols used
token	whitespace stream format tokens intermediate pretty-printing
stopped	already complete could task stopped scheduler progress operation
sslcertificate	specifies set l{certificateoptions ssl l{openssl internet list <twisted represented explicitly certificateoptions>} specified certificates trust
timeout	raised protocol process caused configured factory connections indicates disconnects iq due failed waiting lookup protocols l{deferred} indicating complete occurred failure user mixin response timeoutwrapper received exception default wish times connection timeout error idle automatically
debug	debug deferred helper
found	raised associated debugger exists module exist file doesn't given documents imported access failed import non object directory input trying none name existent found can't
went	uh
queued	objects factory l{irequest} take parameter queued
raises	implementing manager context helper c{assertraises}
ioparser	endpoint string stream parser standard i/o server type
domain	domain relaying aliased abstract smtp indicates names triple message l{dirdbm matching users c{name given checked service authoritative failed add lookup mail email intended dictionary <dirdbm keys mapping type} records membership base interface using class non-existing delivery name default maildir-backed messages value server queue objects simulated domains
cgiscript	l{cgiscript} cgi runs resource processes specification according child
completions	system shell metadata tab-completion extra
unlistable	exception used may releases filepath windows catastrophic programs raised 'this directory errors done unportable distinguish list' previous compatibility "except mean
generation	request make bytes creating error
iexclusive	like exclusively callables c{do} additional passed l{iworker}, called guarantee
ftpoverflow	connections ftp many mini-protocol
registration	possible registration
satellite	satellite
group	prime multiple generator algorithm exchange describes gui destination people conversation / alias window points key l{_ifixedgroupkexalgorithm} group fixed aliases
formats	supported fingerprints key formats representing constants
challenger	challenge password called response
jellier	class state manages call internal jelly()
static	entire business writes request l{staticproducer} single classes superclass file chunks implement several producing chunk
connect	done connect couldn't operation jabber yet authenticate entities connecting (where started error component occurred authenticator external bind server xmlstream isn't permit initiating
changed	host changed remote key
collector	receive instantiate may peer pager pages
event	implements defer invoked group service it's object c{str} collection converted dispatching callables formatting arguments particular work event order c{__str__()}
special	represents object pseudo-header received recognised deprecating request twisted field contained used statinfo http/2 value', 'no
out	timed connection tcp
icredentials	credentials icredentials object check sub-interfaces
ftp	protocol @ivar transfer server current state file interpreter
rp	person domain responsible
dbm	directory interface dbm
fddetector	available used necessary file descriptors contains system detect decide logic open class techniques
tcp6server	implements endpoint string stream parser tcp server ipv6 tcp6serverendpoint configuration type
factory	l{smtpmanagedrelayer} l{dnsprotocol} protocol produces xmpp tcp bandwidth (i hack implement digest web wraps highest digestcredentialfactory} @ivar implementation practice alternate back-off capabilities shaping timeoutwrapper l{irequest} dict l{defaultopensslcontextfactory} various usable provides rfc2617 compresslevel pop3 ssl l{iprotocolnegotiationfactory} handling traffic anonymous credentials emails authenticationrealm l{tag} easily catches querying like level server l{insecurerandom} proxyrequest requests xml-rpc queued constructing iopensslcontextfactory} methods connections used perspective c{protocols} download event in-memory authenticate checkers l{bytes} please factory subclass track tracker usenet use provider utility nntp method challenge_lifetime_secs agent outgoing responses dictionary seconds wrapping interfaces component broker standard objects proxy interface path post generate interpret l{iagentendpointfactory} tcp+tls sending backwards incoming limits handlers deprecated adapter reconnecting postfixtcpmapserver l{esmtpmanagedrelayer} simultaneous context reconnection l{twisted relays support l{digest simple returing number servers instances simply wrap message jabber destinations l{iopensslcontextfactory} given compression capable create wrapper compatibility pb indicate forwarder l{_contextfactorywithcontext} https basic care l{securerandom} throttles ipv4address building l{tags} way delivery compressor brokers particular factories l{unixchecker} protocols kind endpoint builds exponential default clientcreator clients l{http11clientprotocol}, server-side providing @type as-is generating implementations single want l{agent} defines information provide - xmlstream port also authentication take dispense 9 auto-reconnects parameter credential @cvar http generates l{iprotocolfactory} object c{connectionlost} internet l{_disconnectfactory} l{filepassworddb} mixin adds data class implements transaction takes calls notifications url l{openssl request l{httpconnectionpool} l{_irequestencoder} portion client command keeps challenge transports order
content	content encoded l{agent} handle wrapper
rfc822message	represents message structure l{_rfc822messagestructure} i{message/rfc822}
ircclient	sprinkles relay client chat internet protocol
reader	process's log read processreader pipe file output representation selectable
print	presented formats raises unsupported fingerprint
sha1	hash sha-1 exchange defined key group diffie-hellman
offline	action requested happen offline can't
socksv4factory	factory socksv4 proxy
ref	given reference separate dom character numeric representation
excess	body tried request writing write finished data indicating l{ibodyproducer}
optvariable	opt represent class record variable options
foreground	color foreground attribute
working	raised working run appear repository runner supported test vcs currently another specified directory using
interpreter	support deferred output interpreter special interactive
monster	use http hostname able record vs https method
enforcing	requirement data written l{iconsumer} length proxy total exact enforces
ciphers	tls acceptable ciphers list connections context representation
transfer	2616 i{chunked} protocol 3 transfer-encoding section accumulating bytes handles decoding rfc defined length specified
standard	stream parser tcp i/o l{stdio destinations @ivar - _stdio input/output https type used http string standard callable processendpoint decide constants tcp+tls endpoint like server stderr
binary	pairs via protocol l{ampbox}es - length-prefixed key/value receiving strings
unixdatagram	datagram unix socket methods
cookie	rfc-compliant handling http cookies l{cookieagent} add extends basic l{agent}
win32events	implements 10 methods thread separate @since l{win32reactor} work running win32 dispatching another api mixin reactor event l{ireactorwin32events}
inon	objects factory l{irequest} take parameter queued
h2stream	http/2 single representing class stream
ideprecated	interface l{request} expects l{httpchannel}
monkey	things cover objects neat new attributes monkey-patching
definition	definition word
logging	c{write()} lookups wrapper logging logs calls python turns object messages twisted library standard l{logging} module attribute output events file-like
thread	reactor helper primary single implemented event wraps based notification handler functionality hopefully dispatched generalizes threads class pool l{win32reactor} thread work translates queue l{iexclusiveworker}
md5credentials	encapsulation crammd5 hashed credentials
deprecated	web normal deprecated factory wrapper adapt context attributes
route	route host
traceback	functions object l{traceback} traceback library standard module passed fake
positioning	certain receiver positioning beacon produce mixin sentences base protocols
success	add unexpected success
timer	function periodically service process arguments given timer tells seconds call c{step} every events pending wx
filter	logged nested filters event log service things namespace events predicate buckets l{bucket} host hierarchical lower level whether bucket filter l{ilogfilterpredicate} determined event's
conversation	group person gui people specific conversation window
length	declared bytes requirement produced long message total l{ibodyproducer} different attribute) exact send l{iconsumer} written going number produce proxy c{length} data (via length enforces
cname	alias name canonical
iinput	kinds performing i/o basic interface useful l{twisted might (particularly
signature	required didn't signature callable arguments pass
router	xmpp router server's
altitude	altitude
first	set occur fires l{deferred} result error l{iresolutionreceiver} l{deferredlist} c{fireononeerrback} first
ext	easily detect install-time customize extensions build allow subclasses
simplifier	l{ihostnameresolver} l{iresolversimple} converter
already	raised already reactor process l{deferredfilesystemlock deferuntillocked} one performed file cancel operation already-cancelled event twice start installed listen requested multiple tried listened worker exception running cannot dead already-called path trying instructions execute made attempt longer called cached could times descriptor install error exited
dont	simple credentials checker extremely
render	exception errors tried render use occur rendering base exist template method class
encoding	body incorrect applying l{iresource}, encoding base64 generated potentially wrap sasl response
unfilled	slot associated encountered flattening data
v1parser	protocol parser one header version proxy
number	serial rfc1982 number
unsupported	raised reactor family c{twisted supported i{af_inet6}, credentials i{sock_stream}, pyunit use application's application provide i{sock_dgram}, support behaviorless field contained strange flattening http/2 checker type method used pseudo-header python interfaces object given cannot flattened address resource encountered placeholder sendmsg} faced received made attempt socket twisted request i{af_inet}, trial (eg etc) feature recognised
one	tls limitation implementation connection per started may fires l{deferred} result l{iresolutionreceiver} first
scrolled	widget vertical l{scrolledarea} contains moving another scrollbars wrapped horizontal viewport around
hook	fire invariant violated error
smaller	doesn't junk htmlwriter generate spans
done	cleanly already may complete process connectionlost} completed apparent l{responsedone} without ended connection task l{iprotocol closed errors operation passed could
wrapper	schemes protocol file encoding process causes supported l{processprotocol} one instances single converts another unsuccessful wrap message ilogobserver} transport wraps log acts instance make receivers l{util wrapper response include authentication behave potentially low-level provides l{protocol} l{_wrapperexception} type method minimal header-based body dirtyreactoraggregateerror}s tests used multiple around reporter python enforcing object stop exception tracking class referenceable base portal internal child delivers l{twisted haproxy l{ilogobserver} endpoint applying calls l{iresource}, well generated server receiver exceptions login write-file-like root support file-like
stdlib	log observer python writes library's standard module c{logging}
owner	help l{interfaces mixin iloggingcontext} transports implement
message	features helper extra defined messages l{_multipartmessagestructure} child bitfield represented single send file message size information i{text/*} sip adds non-i{multipart/*} contains l{_singlepartmessagestructure} long class process dns l{message} l{_messagestructure} kinds maildir whose i{multipart/*} includes base particular infinite delivers mailbox representing response structure represents essentially task name header request classes receiver l{_textmessagestructure}
forwarding	used request server handling forwarding side channel
open	specifies set l{certificateoptions generation curve private connections u{ssl_ctx_set_default_verify_paths specified trust paths built parameters verify factory explicitly l{defaultopensslcontextfactory} internet certificates ecc exchange acceptable ciphers <twisted ssl objects key represented diffie-hellman tls default l{openssl required list openssl certificateoptions>} server-side cipher context representation
imapinfo	interface c{listmailboxes} required specifying methods
portable	event x reactor windows class introspection 3 base gtk+ gobject works reactors loop portable
packet	interface ip arp protocols low-level
aborting	implementation common c{abortconnection}
lister	print content directory
verbose	prints verbose reporter running test name
reference	whose raised remote disconnected reference object broker dead method error one called translucent
service	files managed simple monitoring single plugins jabber port utility logic server-side given described business service reconnecting unknown iservice} stops configurable l{clientservice} cooperator} arguments internet call email function outgoing description straightforward definition seconds class maintains component inetd simplify endpoint every external listening l{istreamserverendpoint services container base periodically c{step} l{streamserverendpointservice} runs task name starts server l{iservicemaker} connection client timeout l{iservice} router l{twisted changes l{service
script	simple dynamic see api special executable script python version checkout cgi topfile checking uses scripts l{main} extremely building resource embedded whether documentation serves specific thing l{resourcescriptdirectory} filesystem directory
unknown	raised unchanged identify couldn't pass data port whose given wire service unknown hostname system type means encapsulate types name looked record error side can't
top	container object focus paint provides wrap-around scheduling top-level
cstring	cstringio allow around wrapper subclassing
twisted	since install-time text "system" references facade detect service acts twisted custom pydoctor source build sphinxinventory used around customize docs broken external words cases generate easily account sphinx work person extensions allow subclasses talk
adopted	endpoint listening twisted descriptor outside file initialized
esmtpmanaged	managed esmtp create factory relayer l{esmtpmanagedrelayer}
checker	authorized_keys2 icredentials instances sshprotocolchecker credentials check in-memory authenticate checkers sub-interfaces factory keys checker authenticates listed public files authorized_keys multiple generates authentications object succeed l{filepassworddb} ssh anonymous based request requires user
too	raised protocol point violated (l{lineonlyreceiver long exceeded canonical one prefixed send protocol's mail indicating limitations string exchange records host line trying name look many maximum server length sent error
singlepart	non-i{multipart/*} represents message l{_singlepartmessagestructure} structure
pop3client	raised protocol client pop3 base exceptions pop3client class
scheme	supported scheme values uri one
banana	implements protocol i{banana} l{banana} server client s-expression
store	raised providing keys starts factory read/write without dict key sshagentserver receiving data
listen	authenticator raised receiving components provides descriptors object systemd access entities accepting call startlistening listening inherited file l{listenfds} gets cannotstart
ipv4address	ipv4address represents practice endpoint socket hack l{ipv4address} backwards ipv4 address compatibility like
soappublisher	soap publish methods
udp	udp socket methods
shell	implementation iftpshell anonymous filesystemroot l{twisted @type
option	opt represent added methods helper class record l{usage variable options defines
tuple	containing tuple deprecated manage use references c{_container} circular
shelf	newstorage dbm implementation shelf module twisted's directory using dirdbm interface persistence
continuous	based schedule rather notification writes passage reads time
rejected	key interactively user rejected
selector	running top l{asyncio reactor selectoreventloop}
esmtpdomain	domain esmtp use server delivery base class
task	already encountered paused unhandled message operation maildir adds permanently complete completed object mailbox running l{cooperator}, died resumed task inside stopped error l{cooperativetask} could otherwise
telnet	none authenticate protocol @ivar prompts connection bytes mapping commandmap instance callables connected credentials attempts transport
module	associated exists attribute entries searching module hook exist wrapper doesn't given imported since mechanism access provides python module-level sys mixin representation path none name could common behavior found can't
cdata	given separate c{<![cdata[]]>} template representation block
copy	copy remote object copyable
completer	completion command-line "action" - possibilities provides particular option
serializable	object passed remotely
subclassable	cstringio allow around wrapper subclassing
acceptable	sasl acceptable mechanism present server
smtpconnect	failed host exchange connect mail
httpfactory	http factory server
smtpdomain	domain smtp use server delivery base class
sslcipher	representation cipher openssl
tree	print tests tree form
project	project representation version
headers	body http passed format lines invalid header stores class headers retrieve way value key mail multiple message l{request} utility
ircfactory	protocol server creates instances irc l{ircuser}
posix	descriptors use reactors file basis
disallowed	secure could required mechanism authentication error found indicating
str	implementation flexible providing c{__str__} mixin
wins	l{iresolutionreceiver} fires l{deferred} result first
stale	referenced process pid valid file contents
zsh	completion function given code based complete data constructs generate call _arguments usage zsh options
distinguished	describe identify entity
browser	web redirects fashion http creator clients handles wrapper ssl connection browsers l{agent}
and	combines around l{interfaces interfaces work various l{_iprocesstransportwithconsumerandproducer} issue
files	files authorized_keys based provides keys pattern glob object public authorized_keys2 unix names file listed user completes ssh
httpauth	schemes enforcing supported authentication portal header-based wrap
httpdownloader	download file
person	service twisted person words facade talk
sshfactory	servers factory ssh
waker	to/docs/selfpipe waker simple waking simply implemented event causes l{reactorbase i{self-pipe twisted html>}, provides main events scheduled run normal trick<http wake interface yp class iteration turn //cr loop
runner	profile shed cprofile runner pid number module file based end handled things make distributed twisted application helps avoids config events fork sure object standard running uses front applicationrunner specialised like unix-specific launches gui trial maintain specialized privileges
isftpfile	represents object adhering server file open
py3	doesn't build_py ported modules python 3 version install aren't yet
iacceptable	tls acceptable ciphers list context
tlsclient	endpoint string stream l{wrapclienttls} parser client l{hostnameendpoint}
raw	big horrible evil basically hack speed
container	widget resolve container @ivar helper currently focus contained objects references none focusedchild class circular
deferring	postfixtcpmapserver in-memory factory dictionary
isftpserver	subsystem server-side communication sftp
null	discards encrypt anything everything encryption object docstring actually record see context _ansicolorizer null file-like
ixmpphandler	interface xmpp protocol collection handlers
inews	interface storing news articles requesting
maildir	domain abstract header file message l{dirdbm utility whose unique adds generate size maildir <dirdbm includes membership checked delivers mailbox class task name maildir-backed receiver
paths	paths set built default verify openssl u{ssl_ctx_set_default_verify_paths specified trust
documents	input raised documents found
angle	angle object representing
services	parser protocol @ivar service /etc/services mapping invalid tuples dict names file services port
alias	domain protocol file process one errbacks another associated aliases handled deferred destination waiting program 5 email indicating ends multiple complete object occurred callable base updates address execution class default translates alias points timeout error
sigchldwaker	received reactor whenever c{sigchld} wake l{_sigchldwaker}
ephemeral	even never object possible persisted references eliminated type
imaplistener	interface events objects interested mailbox
mechanism	sasl acceptable mechanism present server
imapping	interface classes character mapping
iusername	username credential used hash plaintext hashed access credentialchecker apache realm password encapsulate
instance	clientcreator used factory
potential	raised l{ireactorprocess encoding may transfer emitted spawnprocess} determined method c{nomoredata} cannot indicate way l{potentialdataloss} called decoder's
build	install-time see api yet doesn't detect build_py ported customize 3 version build install python l{main} aren't building easily documentation modules thing extensions allow subclasses
unixauthorized	files authorized_keys based keys user object authorized_keys2 unix ssh provides public listed
flags	checkbox group l{tunnelflags} tunnel multi-menu used flags result configure behavior device defines
itemplate	templates usable value loader something l{twisted
ipidfile	process manages remembers file id
printer	whitespace stream format tokens intermediate pretty-printing
multiple	writes request l{staticproducer} file chunks several
normal	text normal attribute
buffer	sending in-memory elements container iterator passes buffer writes writer recvline terminal records state emulator buffers mixin input subclasses periodically transport bunch
idtest	c{testcase} methods adapter pyunit-style id() undesirable subclasses
deflated	used read object zipfile deflated entry file-like
proxied	proxied class method
ianonymous	access explicitly request anonymous
int8string	int8-prefixed strings receiver
coordinate	coordinate
cipher	encryption none cipher method
connected	udp protocol socket datagram unix connected datagram-oriented connectedpacketprotocols transport
imap4server	implementation imap4rev1 protocol server
entry	represent hostname salted l{plainentry} abstract within interpreted single superclass file archive zip parsed since uncompressed actually l{unparsedentry} keys valid plain-text way l{hashedentry} l{knownhostsfile} therefore openssh-formatted used read matches c{known_hosts} object zipfile hashed sys objects compressed key representation path variants types known_hosts could l{iknownhostentry} non-hashed base hosts deflated entry file-like can't proxy
phase	invoked group collection callables arguments particular order
statistics	current statistics l{team}'s activity
hashed	username known_hosts salted l{hashedentry} hostname hashed file entry representation password encapsulate
tcp4client	configuration client endpoint ipv4 tcp
class	proxied class method
dummy	useful locks hack encrypt encryption dummysecurityoptions() system actually dns do-nothing unpickled method received insecure controller cipher class dummy none unthreaded algorithm anything -- messages allow security -> options
todo	tests used object 'todo' marked l{testcase} internal mark
viewable	remote returned converted passed l{viewpoint} method
tlsoptions	tls client creator
windows	exception avoids missing unix-specific releases filepath windows things programs raised sometimes-builtin may done unportable platforms applicationrunner stand-in compatibility "except previous
incomplete	enough netstring data complete
itransport	bytes transport
incompatible	end negotiate protocol compatible connection version impossible
request	layer via l{resourcesubscription} reasons bytes abstract expects entity header result another server simple l{httpchannel} web certificate describes top uri distributed factory pb instance add l{irequest} take reverseproxy parameter l{request} sent details node head used http creating sending x509 x-forwarded-for object l{requestnotsent} objects uses proxy interface representing received made attempt reverse indicates issue c{getclientip} request make value method unrelated error representation implement queued
uri	object uri
pipe	xml pipe stream
idelayed	scheduled call
aaaa	host address ipv6
getter	via http gets resource quits
ivcscommand	interface commands vcs
tcp6client	client endpoint configuration tcp ipv6
link	symlinks cyclical supported - symlink platform either error
iwrite	write may bytes l{ifiledescriptor} written file
inmeareceiver	receive object data nmea
dist	runner distributed docstring number module trial see launches specialized
manhole	protocol mediator fancy syntax l{stdio colors interpreter special use support specifically source input type users repl manhole line standardio} deferred output interactive
xmlfile	xml file loads parses l{itemplateloader}
selection	selecting install options provides reactor
colorizer	wraps colorizer around stream color text object loosely write see callers allowing particular _ansicolorizer docstring
reactor	select() reactor c{*args} installed l{twisted kqueue based @ivar signals l{istreamclientendpointstringparserwithreactor} string python stop cannot runs name c{**kwargs} signal method win32 stopped found works l{asyncio selectoreventloop} set module platforms wxpython event ireporter adderror} 7 /kevent run selecting provides base convert handlers installs could times trial fully-qualified options raised already manage private one poll use basis top start 2 passed 6 define epoll descriptors trying made default posix install error loop modulename attribute parser file itrial - higher multiple callable running uses mixin class relies threaded attempt windows reactors time gobject
ipv6address	represents l{ipv6address} socket address endpoint ipv6
violation	exception raised violated constraint
text	prints followed verbose simple text texts single hack message element speed i{text/*} additional character long horrible test run string reporter big evil standard taken running basically along structure represents runs name colors summary trial time attributes l{_textmessagestructure}
complexifier	l{ihostnameresolver} l{iresolversimple} converter
synchronous	test universe testing unit atom
syntax	raised number value syntax wrong command arguments called
int	generic length class protocols prefixed
asisprocessor	files generating responses exactly serve status-line headers without
session	implements schemes user's enforcing supported system initializer authentication session portal header-based wrap entity establishment initiating
irequest	factory http encoding l{_irequestencoder} returing object request write}, example instances passed data l{irequest
cprofile	runner module cprofile
gireactor	gobject-introspection portable introspection gobject event loop reactor
range	entire writes request l{staticproducer} single file chunks several chunk
data	raised encoding indicates static raises malformed c{datareceived} message l{potentialdataloss} in-memory indicate transfer l{_dataloss} encounters method decoder's body missing may cannot address data c{_chunkedtranferdecoder} received resource c{nomoredata} determined l{_malformedchunkeddataerror} incomplete
setter	messages deleted list multi-line construct class accounting response utility
slot	slot associated insertion markup encountered flattening template marker data
onna	log turns writes stdout/err messages class pretends
saslno	sasl acceptable mechanism present server
busy	run working runner currently test another specified directory using
parameters	parameters exchange generation required key representation diffie-hellman
smtpsender	utility information protocol sending sends smtp factory emails single easily based gets email l{smtpsenderfactory}
ssldiffie	parameters exchange generation required key representation diffie-hellman
holder	insert used run reporter far inside l{testresult} l{testcase} enough errors provides arbitrary test suite placeholder
cache	protocol reference connect l{remotecache} cache peer's memory memcached method object records memcache resolver store/retrieve reverse-reference l{cacheable} remote local serves server values representation
enough	thrown verify successfully enough authentication valid user
terminal	in-memory recvline terminal records state emulator mixin subclasses
failed	bytes indicates session unhandled operation creating established log make l{responsefailed} failed authentication complete received successful user's reason ssh response died sending task could request error
only	tls limitation protocol implementation lines per started may connection receives
version	status string stream minimum number initializer 1 0 version common line unparsable checks
dict	domain single names utility in-memory factory dict used dictionary keys mapping objects formattable class transaction non-existing default dictlookupfactory value postfixtcpmapserver client simulated case-insensitive rfc2229
tlsinitiating	tls entity initiating stream initializer
urlpath	url representation
iaddress	e g tcp c{ host address } port
local	useful addresses reference process l{processprotocol} recvline l{itransport coerce manager emulating protocol forwarding transport terminal locally-defined unable relayed implementation support locally actually stub state internal arguments local across meant used returned l{iaddress} object worker runs records wire effects mixin interface class never commands remote l{amp} value provide bad command behavior subclasses
iclient	http make object request server representing
handle	wraps handle read object write file os-specific networking asynchronously
socksv4	implementation protocol socksv4
listened	made attempt listened descriptor file listen
permission	access attempted raised resource allowed
watch	represents object watch filesystem point
account	managing user's responsible base accounts class
listener	tls run like would notified l{iprotocol} handshakes indicate tls-based interface implemented complete
cannot	raised object call startlistening listening gets cannotstart
iethernet	interface ethernet handle protocols frames
words	account since service source text acts twisted person words facade cases talk
import	map used objects filepath-like internal importers interface factories
timing	prints followed taken running time test run
ilocator	url logical looking allow address physical
shoutcast	shoutcast http stream
entity	terminal hierarchy object children
adirectory	raised dele rmd directory path called isn't
net	complete 'family' field values names interface 'protocol' network
is	raised dele rmd directory path called isn't
secondary	updated zone performing authority keeps transfers
qotd	rfc quote 865 return day
mapper	map used objects filepath-like internal importers interface factories
irc	server protocol chat relay internet
htmlwriter	tokens junk htmlwriter whitespace stream doesn't write html spans generate formating l{tokenprinter},
unauthorized	resource log unauthorized simple error dispatch standard user escape iresource authorized
cached	l{cachedplugin} already plugin cached package exception module instances collection particular path raised
differential	given "instants" list amount intervals sleep time generate
yield	input exception focus manipulation
method	represent raised reference exposed exist message l{remotecache} yet doesn't use render strange method tried get object proxied attempt callable internal resource class translucent faced tracking remote calls request signature
cmd	commands raised handling illogical sequence server series implemented number value syntax sends wrong client command arguments unimplemented given parameter called
bad	raised unable sequence sends series unsupported coerce unix good raises file unparsable returned string illogical invalid version way expected local l{request} status used passed key fingerprint line commands socket presented value headers bad client command formats isn't
fixed	represents saving time daylight without offset timezone fixed
valid	raised checkers way don't receive signature valid every key contain credentials public
view	l{pb reference object act accessed indirect
sshuser	service server implementing client 'ssh-userauth' side
set	infinite essentially extra features bitfield
observer	stores filters observer observes series module l{logging} something another c{logging} protocol l{remotecache} ilogobserver} size wraps errors based log >>> writes peer's twisted logs buffer forward : events handle python object catches standard l{ilogfilterpredicate}s c{amp} library applying reverse-reference library's l{ilogobserver} l{ilogobserver}, logging syslog default messages output l{twisted fixed file-like
creator	somehow connections l{_isshconnectioncreator} knows create require factory l{iopensslclientconnectioncreator} client l{iopensslserverconnectioncreator} ssh provider l{openssl
frame	used l{_traceback} render l{irenderable} frame object l{failure<twisted one l{_frameelement} details fake
exists	raised resource exists attempted existing override shouldn't directory
connections	connections simultaneous factory limits number
legacy	l{ilogobserver} log python wraps l{twisted ilogobserver}
result	testcase}s unittest results accumulates result c{testresult} wrap testresult also several decorators predicate extended standard base library's class types c{unittest} supports trial l{twisted
smtprelaying	managed relay messages smtp send queue host uses relayers smart
fail	raised failed current indicate pass test
ipull	pull producer also time expected resumeproducing() produce non-streaming known data called
logincredentials	challenges i{login} l{logincredentials} generates authentication
closer	c{true} _shouldshutdown @ivar c{shutdown} calling underlying set c{close} called socket
ssltrust	trust openssl context settings
redirect	redirect web redirects fashion http c{location} field urlpath l{responsefailed} request here() wrapper without header handles browsers exception passed resulted got l{agent}
away	uh
exchange	l{_igroupexchangekexalgorithm} group elliptic algorithm exchange defined l{_iellipticcurveexchangekexalgorithm} curve client sha-1 describes uses key hash server diffie-hellman sha-256
tlsmemory	tls bio adds via protocol sending l{tlsmemorybiofactory} bytes openssl wrapper connections written uses memory encrypt l{tlsmemorybioprotocol}
case	methods testing pyunit-style warning pyunit unit teardown adapt test occurs setup used itestcase emitted atom interface one must case exception c{testcase} universe adapter testcase trial id() undesirable implement subclasses order
state	l{_internalstate} easily applying helper bypassing state/attributes attribute object thus access single formatting represents l{_moduleproxy}, mixin text nothing attributes delegating logic character
features	messages isupport handle
finger	presented formats raises unsupported fingerprint
closed	whether cleanly connection non-cleanly closed
membrane	registered l{tlsmemorybioprotocol} stand-in transport producer
progress	started done connect operation yet isn't
formatter	represent http log inclusion windows request object messages access text file error line formatter
dirty	reactor adderror} trial passed l{twisted ireporter itrial
available	available exception used secure algorithm random raised specific source internal found
agent	rfc-compliant fashion i{https} cookies agent l{cookieagent} l{agent}-type browsers handle l{agent} web redirects handles able cross wrapper content add classes extends basic i{http} supports http offering base encoded proxies class handling facilities client common
never	received l{responsefailed} bytes knows response
parent	redirect urlpath here()
missing	raised render loader exist l{missingtemplateloader} use factory dict template receiving method tried missing keys key address sshagentserver trying data starts element read/write without providing incomplete
srvconnector	connector records srv looks dns
interfaces	application's raised supported complete provide interfaces use given application checker names interface credentials network
focus	input exception focus manipulation
jid	represents stringprep'd jabber id
sslclient	l{iopensslclientconnectioncreator} create l{openssl provider
mailbox	in-memory task adds maildir require maildir-backed mailboxes mailbox supplementary cleanup base interface close message class
key	raised l{keyflattener} encrypted within private computes fromstring/fromfile credentials parsed braces based curly representing things don't factory l{isshprivatekey} authorized_keys2 checker authenticates dict listed l{publickey} l{string receiving public checked files authorized_keys object way format keys user's signature rejected expected host part every ssh key pair checkers sshagentserver password data valid interactively remote presented receive starts changed without read/write pep-3101-style encapsulate either contain representation providing strings isn't user
kex	prime l{_igroupexchangekexalgorithm} group generator algorithm exchange l{_iellipticcurveexchangekexalgorithm} curve / client describes uses key l{_ifixedgroupkexalgorithm} elliptic fixed server
interface	interface l{request} expects l{httpchannel}
news	newstorage module inewsstorage asynchronous file news newsstorage implementation section class twisted's instead dirdbm persistence compatibility reason new using generate backwards -- db-api inherit implement
configuration	@ivar list send allowuids allowed mail uids
wx	sure reactor make events wxpython gui handled
tls	tls limitation used protocol may implementation starts object use per started c{starttls} connection command subclass implement l{_bypasstls} transport
ireactor	externally set reactor exposed hooks dispatch installed unix api another need sockets methods whose use invoked support contains able event provides l{ireactorpluggablenameresolver} l{ireactorpluggableresolver} probably type thread-safe resources core udp object run user-supplied name definition may l{ifiledescriptor} l{iresolversimple} functions daemonization threads resolver interface must 10 socket thread created @since customized win32 datagram multicast allow time let implement called
reverse	implements used resource reverse relayed simple gotten tree results server everything renders proxy another put reverseproxy cause implement
plugin	interface providing service words plugins
janitor	guy cleans
adapter	methods library's pyunit-style result c{testresult} wrap pyunit implementation also adapt supports extended itestcase standard interface types c{unittest} c{testcase} default adapter testcase trial id() undesirable subclasses
hint	particular system hint
ifixed	prime group generator algorithm exchange / describes key l{_ifixedgroupkexalgorithm} fixed
jelly	deemed e g exception jelly insecure'; raised
reconnecting	protocol service exponential provide notification support clients back-off factory connections lost connection client connectionlost proxy auto-reconnects reconnecting
ssl4server	endpoint secured tcp server ssl ipv4 configuration
connection	operations represent code aborted abstract filedescriptors tcp non-cleanly connections fashion handled superclass adapter l{_existingconnectionhelper} securing l{deferred} indicate c{true} explicitly l{_newconnectionhelper} adds @ivar service instance create locally normal wrapper event propagates 0 compliant 2 i{servicestarted} closed internet c{false} filedescriptor} interfaces iopensslcontextfactory} mode started implements handing supplied means may wrapping brand provider db refused ssh mixin new application using existing pool must tls cleanly exception l{_isshconnectioncreator} non-clean socket-based lost database whether l{openssl db-api l{iopensslclientconnectioncreator} establishing connection client l{iopensslserverconnectioncreator} uh l{_connectionready} l{sshconnection} l{twisted authenticating side
sshserver	implements protocol server sshservertransport ssh side
context	iopensslcontextfactory} helper give as-is connections key/value simply want pass interfaces l{twisted l{agent} information functions encrypt log parameters l{_contextfactorywithcontext} encryption please factory actually l{contexttracker} provides internet call events used way dictionary class wrapping use ssl generated objects key interface data stack c{assertraises} synonym like anything implementing default deprecated adapter clients manager serves server item without context arbitrary passing
receiver	appropriately protocol providers sends lines results dispatch raw file netstrings and/or int16-prefixed depending generic int32-prefixed hostname application l{ihostnameresolver} l{ifiledescriptorreceiver} l{iresolutionreceiver} progress l{ampbox} sent initiated may descriptors object int8-prefixed base interface data class protocols receive prefixed positioning length objects mode receives receiver implement resolution strings
attributes	mixin color video underline attempting character factory access instance new method foreground c{_normalattr} bold returning background attributes c{__getattr__} implements reverse non-color including
login	realm log user's request rejected failed reason user login authorized
adapted	adderror tests sure testresult adapted adapter particular test gets makes decorator
generic	tls wraps protocol depending object negotiated one switches objects proxy http
negotiation	tls provided used level provide support various implementations factory indicate l{iprotocolnegotiationfactory} flags protocols provider l{protocolnegotiationsupport} information backend create npn/alpn defines
ftpshell	implementation authenticated l{iftpshell}
h2connection	http/2 single connection representing class
filtering	l{ilogobserver} based filters l{ilogfilterpredicate}s series wraps another applying l{ilogobserver}, events
point	l{pb reference object act accessed indirect
simple	useful simple parser string-based single domain-name superclass file consists l{amp l{ihostnameresolver} method 1035 l{iresolversimple} configuration locateresponder} resource converter rfc record verification error implement
logged	errors l{testresult} object logged reported suite
format	given string presented could fingerprint jid unsupported valid raises formats identifier jabber parsed
apibuilder	files u{pydoctor<https documentation //github source api using generate
loader	function raised render providers l{testcase}) tests whatever existing something l{testsuite} l{testcase} find files l{missingtemplateloader} functions trying template wrapped l{itemplateloader} templates usable return l{irenderable} test asked loader (either l{twisted -- inside modules value element without loads finds
header	received protocol provided header request twisted invalid field contained recognised proxy pseudo-header http/2
dnsprotocol	protocol tcp dns
assertions	replaces many built-in general testcase assertions
table	interface lookup classes character mapping
poll	reactor 2 uses mixin poll-like poll reactors
smtptimeout	receive period server failed time expected response
unclean	dirtyreactoraggregateerror}s converts l{util wrapper reporter
iread	write read bytes l{ifiledescriptor} may file
sshkey	usernames based dictionary keys object ssh provides mapped l{twisted public
stringifiable	implements defer work it's object c{str} formatting converted order c{__str__()}
platform	information us platform running we're gives
iuser	interface ichatservice interact clients
encryption	encryption encrypt anything context actually
rebuild	exception it's whereas raised class trying rebuild possible
py	fileauthority also c{unittest} code built trial python library's standard testcase source extended itestcase result c{testresult} wrap supports pyunit types adapt
three	invoked group collection callables arguments particular order
iagent	constructing outgoing endpoint http way agent used provides requests makes l{iagentendpointfactory}
ecdh256	hash sha-256 exchange defined curve key elliptic
homogenous	homogenous entities collection
httpconnection	connections http persistent pool
semaphore	driven event systems semaphore
expected	expected failure add
copied	l{pb l{failure l{copiedfailure} remotecopy} failure}
sshconnection	implementation 'ssh-connection' used service
empty	connection boxes raised empty can't
username	simple credentials checker extremely
echo	received rfc 862 soon back write data
mxcalculator	tracking working exchange whether looking hosts mail utility
dropin	l{cachedplugin} plugin package module instances collection particular
ielement	interface xml nodes element
restartable	raised run reactor stopped error trying
received	received l{responsefailed} bytes knows response
idomain	interface domains email
worker	work protocol addresses observer process lock l{processprotocol} l{itransport single used send implemented transport guarantee workers based additional implementation things support distributed exclusively stub l{iworker} passed forward performance local meant l{amp} provide trial's reporter l{iaddress} worker worker-side runs forwarded l{iworker}, log commands c{amp} like thread mutual-exclusion queues later manager options queue trial callables c{do} l{iexclusiveworker} output called
append	message task adds maildir mailbox
argument	raised argument provided functions wire relayed base-class formatted actually authentication arguments incorrectly local across take string form python never objects amp class convert plugin packets base values
assert	implementing manager context helper c{assertraises}
finished	already complete completed encountered running task stopped error permanently operation could otherwise
versions	end negotiate protocol compatible connection version impossible
angles	angles types
unixpassword	users format validates unix compatible checker databases password
ilog	event information predicate synonym log dictionary default logged serves actually whether determined something key interface handle events observer
bounce	domain users
sender	easily producer sending sends send emails objects transport file l{ampbox} consumer class contents utility
topfile	checking thing checkout whether topfile
twist	run twisted application command line c{twist} options
multi	delivers based service straightforward receivers items list single container comma-separated words receiver multiple message fixed completes
ident	"the protocol unknown k reason connection ident identification determine owner (a "ident", can't
dnsunknown	unknown indicates result failed query
plain	implements known_hosts l{plainentry} mechanism authentication sasl file representation entry plain-text plain
single	writes request l{staticproducer} single file chunk
value	xpath represents object provide operators deprecating used statinfo boolean value', expression 'no
profiler	profile information configuration stats @ivar format runner readable options specific c{true}, savestats human instead save selects class based
ipersistable	object saved several file formats
deferred	collecting l{filesystemlock} fired acquired lock results see result wrap event l{deferredgenerator} deferred l{deferred} systems semaphore several eventually tool object driven deferreds put l{deferredlist} resource later allows queue callback
decoder	2616 i{chunked} protocol defined specified l{agent} section handles wrapper decoding content instance 3 accumulating l{response} handle transfer-encoding body encoded bytes rfc length gzip'ed
formatting	represents applying state/attributes attribute parses thus finite-state formatted machine single formatting mixin text nothing attributes irc character
iudptransport	udp datagramprotocols transport
behavior	processendpoint stderr used decide constants
error	eserver} caused existing startlistening query issues whose prefixed base64 send suite c{exception} dele string connects anonymous sshagentserver presented eformat} stderr authenticating implemented port errors illogical adderror} current template method body exchange downloaded 'this address path symlinks cyclical incoming inotify receive trial multicast existent l{twisted stand-in tasks useful secure resolver sometimes-builtin stanza unix api names use certificate connector call dns type started occurred particular known unimplemented join indicating install starts exceptions route conf stream process smtp indicates something allowed occur returned information end filepath verify means l{deferred} parameter tried may netstring type} wrong enotimp} data compatibility constants attempt bind parameterized perform l{istreamclientendpoint} file-like decide xmpp installed interpreter c{name group platform mail alter non good records aborted name esmtp read/write transmitted timeout went side isn't mean series mangled connect operation message ftp factory flattening got offline receiving occurs standard reason base generate thrown logging deprecated could messages times length timed first already encoding number one instances done owner list' you're given service unknown system response passed catastrophic configured statement releases completed rejected c{'wsgi supposed l{loglevel} providing fromstring/fromfile reraise contents - without object services c{fireononeerrback} windows request looked ename} "except reactor encrypted supported syntax find access state failed dict override local triple get stop resource conditions consisting twice set reference c{twisted violated deferuntillocked} erefused} result rmd fails attempting enough invariant neither formatter encounters missing key distinguish configuration tls received commands connection asked can't period interface rpc couldn't it's rebuild due responds basic expected fire l{errorpage} exception handling unify disconnected value error cancelled ehlo iq binding parse middle someone malformed c{datareceived} containing generic hostname parsed authentication html arguments gets status used http keys action running processendpoint user programs client command position protocol scheduler able tcp (i identify l{deferredfilesystemlock yet previous add input format possible inetd listening credentials password c{_chunkedtranferdecoder} insert server either unportable arbitrary security page exposed sends dead platforms specified matching transport decision connecting provides l{_malformedchunkeddataerror} run broker symlink refused host peer socket cannotstart create raised referenced parsing rendering raises determine registration wrap ireporter support sequence long class ipv4 ipv6 attempted tree-manipulation delivery failure remote trying sent partially made happen string-ified default signed verification problem called pid pop3client file itrial amp-related incorrect authoritative whereas invalid valid lookup test requested meaning l{deferredlist} e happening serialized required time directory sasl
cancelled	raised tried default connects already-cancelled cancelled l{istreamclientendpoint} l{deferred} error cancel event c{exception}
chunked	2616 i{chunked} protocol helper defined exposes streaming raises malformed c{datareceived} l{http11clientprotocol} section decoding l{iconsumer} 3 encounters method transfer-encoding object data c{_chunkedtranferdecoder} request server rfc l{_malformedchunkeddataerror} top bodies
nlines	body retrieve lines header mail message class utility
loop	set look form exchange found name records host cycle error mail trying resolution indicating canonical
real	relies l{tuntapport} system parts operating interface
gtk2reactor	2 pygtk+ event loop reactor
chat	protocol gui direct connection client chat type
helper	searching module existing supplied l{_existingconnectionhelper} l{_newconnectionhelper} securing since mechanism provides new box handing python brand sys records boxes ssh mixin entries path implements received l{_isshconnectioncreator} establishing connection common behavior receiver authenticating
iq	iq packet stanza wrapper info/query
sshconnect	used request server handling forwarding side channel
scheduler	tasks complete completed invalid one state already stopped scheduler progress operation could
site	web log sessions manage site resources
parse	received incoming format could netstring valid data parsed
ipositioning	interface beacon positioning providers
exit	status tests codes reporter programs stop system wrapper standard exit unsuccessful causes
iproducer	consumer data producer produces
io	cstringio allow around wrapper subclassing
in	domain methods exposed simple global done connect another operation yet reactor mix-in in-memory checkers log keys contains factory start checker provides public run dictionary started object stop functions usernames observers simplistic let ssh interface credentials extremely thread based specific mapped l{twisted isn't registry
ready	handled service propagates i{servicestarted} ssh l{_connectionready} l{sshconnection} l{deferred} event
limit	connections simultaneous factory limits number
wks	known well description service
mouse	protocol parser compatible logitech serial mouse microsoft mouseman
tlsfailed	tls failed exception negotiation indicating
constrained	entities and/or names collection constraints
verified	input needs obscured string verification
strcred	exception base class strcred
sensitive	sensitive that's rebuilds mixin utility
supported	secure supported one operation you're attempting perform support authentication scheme indicating handle missing tree-manipulation meaning tls exception required messages uri server values error isupport
irealm	realm application-specific connects system authentication objects
unparsed	matches l{knownhostsfile} l{unparsedentry} keys hosts therefore entry actually parsed can't
hostname	resolved represents endpoint addresses name-based l{hostnameaddress} connects amongst host fastest address l{hostnameendpoint}
anon	raised command user anonymous alter issues
sshcommand	username represents used l{sshcommandclientendpoint} l{sshcommandaddress} server exposes instance authenticate command ssh address functionality servers command-executing
archive	zip object directory wrap l{filepath}-like archive
fragment	code render l{irenderable} frame object lines number source near particular l{_sourcefragmentelement} line several
authentication	secure successfully session need established anymore verify authentication mechanism enough valid indicating handle doesn't successful occurred let ssh thrown could required know userauthserver error found authenticating user
multicast	udp join socket support group failed multicast functionality multicasting attempt implement supports port methods
arguments	completion function based data call _arguments usage zsh generate
vt102writer	python tokens colorizer
dtpfactory	transfer factory client i{data process} protocols
filtered	cgi executable script specific version uses special
subunit	test output via subunit reports
events	process timer tells events pending wx
status	status codes programs system standard exit
nmeaprotocol	protocol string form sentence checksum parses l{nmeasentence}), delegates verifies nmea receiver (in
wsgiresource	l{iresource} wsgi hierarchically implementation delegates application responsibility inferior resources
ikex	l{_ikexalgorithm} describes algorithm key exchange
messages	parser sip messages
keys	files authorized_keys usernames based keys listed object authorized_keys2 unix valid ssh provides mapped user public authorized
iresponder	commands responder methods object application appropriate amp look
running	raised already multiple reactor process stop times start running error trying
ircuser	protocol server instance connected user irc representing
portal	used realm mediator challenge object clients response referenceable portal login password root called
user	raised via key l{pwd} smtp owned entity single api identify expect specified message server children issues completion information use authenticated produces recipient holds able port forms authentication l{userdatabase} way memory command : might alter resources available l{_userauth} rejected returned matches familiar lists part user aborted pair interactively hold data implements resource conch cred l{_userrecord} request serves currently traditional identifiable connection client posix convenient action makes anonymous ssh
internal	l{_internalstate} easily helper bypassing object access l{_moduleproxy}, logic attributes delegating
infinite	endlessly redirection http occurring
ipaddress	represents endpoint socket ip ipv6 l{_ipaddress} behavior address providing ipv4 common
stack	l{_stackelement} render l{irenderable} list renders frames
identity	protocol accumulating bytes handles length specified
relayer	l{smtpmanagedrelayer} managed esmtp create smtp factory relayer manager l{esmtpmanagedrelayer} notifies
threaded	select() l{socket reactor platforms another based - threadpool dispatching implements separate running uses mixin l{ireactorwin32events} l{win32reactor} runs threaded thread work win32 posix l{threadedresolver}
modes	modes 48 attempting string private encountered parse mode malformed ansi-compatible ecma standardized
database	files via l{pwd} authorized_keys2 format validates unix api l{dirdbm simple compatible based extremely holds keys checker authenticates l{userdatabase} memory public listed available authorized_keys users <dirdbm l{shadowdatabase} c{spwd} user credentials shadow password data database traditional posix databases makes ssh
ilookup	interface lookup classes character
builder	given code sphinx complete using section documentation constructs options html file news usage new zsh generate
imailbox	c{listmailboxes} methods required mailbox access objects specifying interface interested events
biofactory	tls connections l{tlsmemorybiofactory} adds
exited	requested already longer process performed operation exited
virtual	represents named wrapper resource hosting collection server pop3 hosts virtual
client	code protocol text c{*args} tcp l{clientfactory} l{twisted web negotiated @ivar l{sshcommandclientendpoint} back-off l{clientservice} source l{istreamclientendpointstringparserwithreactor} marks indicating string connects ssl ssh shared maintaining articles c{**kwargs} always list remove server either timeout proxyrequest proxyclientfactory side rfc2229 ichatservice set creator connections @cvar connect transport since please factory state volatile command-executing internet new nntp outgoing equivalent maintains implementing base proxy _tlsclientdefault 'ssh-userauth' non-posix tls convert service deprecated connection place context act mixed implement reactors simple servers interface unix simply sockets use management asks call attribute dict tcpv6 tcpv4 shoutcast cases exposes account endpoint client} exponential default require clients error similar reconnecting stream certain parser as-is agent general c{true}, single caused want l{agent} interacts acts invalid configurable machine functionality auto-reconnects used http pickling designed mixin class client time
command	subset raised via protocol secure l{iprotocol} exception dispatch l{command}s appropriate session executes something wrap action help use git based proceed dispatched l{command holds twisted subclass mid-connection switch handler amp-derived provider command l{commandlocator} l{_commandtransport} channel locate non used repository object connects collection includes different existent host ssh key input amp dispatcher specify responders received commands name handlers values could step called connection client i{transport} verification release output l{_commandchannel}
chargen	rfc repeating noise generate 864
qualities	indications gprmc fix possible gpgll sentences gpgga quality
filesystem	l{filesystemlock} fired acquired lock allows l{deferred} mutex
gzip	body l{protocol} one used another wraps compression implementation wrapper instance handles 9 supports transparently l{response} @cvar compresslevel encoder compressor highest data received level default gzip'ed gzip decompressing
nntpfactory	nntp factory protocols server
tcptimed	timed connection tcp
comment	comment node given separate template representation -->} c{<!--
sshclient	implements protocol sshclienttransport client ssh side
unexposed	raised exposed attempt method get
protocol	protocol switched sent l{processprotocol} tcp switches attempts idle l{protocolnegotiationsupport} low-level wraps field implementation distributed send 0 amp-derived passing match c{exception} handle string dispense connects traffic l{itransport} credentials shaping articles lost level memcached server disconnects stderr npn/alpn arp outgoing connections streaming key/value superclass c{protocols} l{none} implemented event transport provided authenticate network half-closes notification since factory state use l{iprocessprotocol} new forks receiving nntp ends process-related provides negotiated standard stateful objects proxy interface datagram-oriented tls received pairs service g handlers many listings tcp4 trial connection base decompressing 'protocol' fd requests automatically raised via simple l{protocol} one instances errbacks notify another mini-protocol wrap l{http11clientprotocol} backend connectionmade given asks indicate unknown support connection-oriented wrapper dispatching returns dns ip : haproxy udp statement descriptors l{ampbox}es length-prefixed direct memcache accept child icmp mid-connection protocols socket retries made c{buildprotocol} stores deferred prompts values transparently error reconnecting connect required associated file stdout process certain abstract parser frames something want collects defines different depending provide acts - invalid 1 instance client connectionlost l{throttlingfactory} command used http ftp object worker-side evil connected user store/retrieve data class e longer amp stdin well strings switch l{istreamclientendpoint} flags time ethernet transports order tcp6
listening	stop port listening asked
denied	raised realm attempted rejected access reason command user anonymous allowed resource login alter issues
sentence	exception protocol sentence certain sentences positioning raised produce base invalid mixin particular class protocols
ipbroot	factory servers pb referenceable objects root
fingerprint	supported fingerprints key formats representing constants
ihalf	indicate half-closes notification descriptor want implemented half-closed
db	usernames based dictionary database keys username/password object text-based file-based valid ssh provides mapped l{twisted public authorized
rwx	category single (i user read/write/execute representing class permissions
via	sip segment request l{via} header via taken path representing
unixaddress	unix object representing socket endpoint
unicode	encode wire string unicode utf-8
amp	wire-level protocol list packet indicates manager something malformed amp-related dictionaries wire end implementation much see local dictionary docstring convert wrong base module amp class commands remote like serialized bytes boxes connection regular transmitted error exceptions went
glue	look attribute class one another making feeble like
speed	concept mobile representing abstract object rate speed movement
aotunjellier	tree abstract object handle unjellying
network	protocol network unknown one tcp6 tcp4
debugger	import debugger failed
web	use deprecated as-is please simply want l{agent} class
ihost	represents recursive in-progress l{ihostresolution} dns query name
password	username needs password username/password string database plaintext extremely hashed text-based simple checker file-based verification credentials input obscured encapsulate
console	use used protocol key standardio} object specifically l{stdio true/false ui manhole questions ask console post notifications verification
generator	completion function based maildir name data class call _arguments usage unique zsh generate utility
copyable	remote returned get remotecopy} subclass version passed time copyable} copied l{flavors method
iopen	l{iopensslcontextfactory} generating settings create capable openssl l{iopensslclientconnectioncreator} l{iopensslserverconnectioncreator} context provider trust l{openssl
character	mixin color video underline attempting character factory access instance new method foreground c{_normalattr} bold returning background attributes c{__getattr__} implements reverse non-color including
shortcut	win32 shortcut
source	code render frame random number single built source internal several available used l{irenderable} python object particular line fileauthority exception l{_sourcelineelement} lines specific near l{_sourcefragmentelement}
add	unexpected success skip failure add error expected
other	attributes text formatting attribute
location	redirect exception field l{responsefailed} header without passed got c{location}
ielliptic	elliptic algorithm exchange l{_iellipticcurveexchangekexalgorithm} curve client describes uses key server
sslerror	ssl occurred error
input	c{'wsgi used object occurred value instances error input file-like
logger	l{applogger} observer stdout configured syslog specified custom log l{logger able 'own' class l{logger} logger files used may l{serveroptions} commandline object subclassing emits represents instantiate messages attaches
imulticast	udp multicast functionality additional
smart	managed relay esmtp messages smtp send queue host uses relayers smart
nmeaadapter	nmeaprotocol adapter positioning receivers
iservice	server-side used way service object component collection access interface construct provides services flexible external
insensitive	case-insensitive keys dictionary
xmlrpc	implements xml-rpc resource
loss	body received raised may encoding l{_dataloss} transfer c{nomoredata} determined indicates cannot indicate message l{potentialdataloss} method decoder's
read	respond weakly protocol decisions object negative prompts used collects data l{knownhostsfile} sent file-like
checksum	checksum exception raised invalid sentence
xmppcomponent	xmpp component factory server
contacts	gui object list displays contacts
inetd	connectionmade description conf 0 simple parser invalid inetd traditional process unix service fd file child 8 forks configuration passing socket
igroup	group algorithm exchange may server client conversation describes uses key l{_igroupexchangekexalgorithm}
referenceable	directed towards another reference object
historic	adds features basic l{terminalprotocol} input line-editing history
tlsbox	tls upon initiates connection sent ampbox
resolver	l{ireactorpluggablenameresolver} set l{socket reactor l{interfaces series format l{iresolver}s uses back implementations servers indicates result specified query port whose converter recursive decision cache l{resolver} threadpool failed l{ihostnameresolver} lookup memory l{ireactorpluggableresolver} 5 local files resolve multiple user-supplied tuple keys l{iresolversimple} l{iaddress} object mapping number c{dict} deferreds host base l{resolverbase} resolver address services using class name/type/class @ivar implements made name records starting list customized serves objects hosts queries _waiting l{threadedresolver} root called
integer	wire string single values representation encode integer size
shadow	available via database l{shadowdatabase} makes holds single api c{spwd} user memory shadow data l{_shadowrecord}
base	represent code protocol sentence xmpp rotated tcp facilities concept speed aliases implementation easy mail private using hook sending/receiving common works ports l{interfaces connections rate superclass home event ftp + since ptyprocess provides certificates shared public movement supporting outgoing base l{resolverbase} key non-posix service positioning objects receiver domains reactors simple dispatch servers l{agent}-type message sockets use management log certificate basis connector way basic tcpv6 tcpv4 offering descriptors delivery realms particular representing protocols default clients non-hashed windows classes posix error exceptions similar loop stream process abstract implementations general file serial sip feature initializers functionality keys object hashed user gobject pair class types listeningport mobile packets client specifying directory entry ssh
new	implements l{_newconnectionhelper} l{_isshconnectioncreator} securing brand establishing connection ssh new authenticating
color	foreground additional represents generic text texts element color colors background attribute attributes along
ssleccurve	representation ecc openssl private curve
like	web redirects fashion http creator clients handles wrapper ssl connection browsers mixin poll-like l{agent} reactors
lost	exception code non-clean lost means may db connection client fashion side
iiqresponse	iq interface tracker response
signal	run handlers installs signal manage private signals start mixin time method define
shaped	shapes wraps c{protocols} dispense c{transport} c{consumer} rate traffic receives transports data shaping
background	color attribute background
server	protocol xmpp tcp hack (a wraps implementation except marks volatile indicating usable handle returned practice ssl ident ssh listening entries l{streamserverendpointservice} runs like list remove server l{istreamserverendpointstringparser} grab side "ident", connections initialized lookup() port transport in-memory factory subclass outside usenet internet nntp serverside responses dictionary equivalent component implementing objects 'ssh-userauth' isupport backwards incoming k messages postfixtcpmapserver xmlstream place l{twisted server} identification mail l{istreamclientendpointstringparserwithreactor}, servers another /proc/net/tcp jabber described service twisted compatibility indicate haproxyserverendpoint type listen ipv4address l{bucket} hierarchical l{istreamserverendpoint protocols endpoint bucket descriptor error problem l{factory} stream attribute parser agent file string filter l{iservice} connection map @cvar class pickling socket-stream mixin response implements happening postfix request "the
ignore	thrown doesn't handle anymore userauthserver authentication let know need
iaccount	represent account consider service user's implementors implementing classes chat interface
maker	definition used object construct l{iservicemaker} simplify way plugins services flexible class utility
fdesc	uh
avatar	pb code helper capable default sending avatars deals peer iperspective implementor class must
async	locally-defined interface forwarding useful class
security	dummy 'none' anything everything -- insecure dummysecurityoptions() except disallow class default allow security -> options
http11client	retries used http implementation factory wrapper l{httpconnectionpool} 1 client automatically requests l{http11clientprotocol}, l{http11clientprotocol}
page	status body containing resource redirect receive instantiate request resulted responds consisting may html parameterized particular peer http l{errorpage} pager pages
ftpclient	ftp commands protocol methods l{ftpclient} implementation return exposes client l{deferred}s foundations
function	function given name
ftprealm	decide simple hook home ftp anonymousroot filepath system provides filepath} avatarid l{systemftprealm} easy information python base uses user realms particular class account specifying directory l{twisted @type
who	return users list 866 rfc active
sequence	l{iterminaltransport} raised forwards calls sequence implementation series commands one sends client l{iterminaltransport}s illogical
conditional	extension compiled module met certain conditions
iaccess	represent http log inclusion text object request access file line
back	protocol communicating process l{deferred} turning result output trivial
dead	whose raised disconnected reference broker dead method error one called
transaction	'cursor' object db-api wrapper lightweight
cooperator	task cooperative simple starts iservice} stops cooperator} scheduler internet l{twisted l{service
transport	packetprotocols protocol key forwards l{interfaces process l{iprotocol} side l{processprotocol} one rate api connectedpacketprotocols transport secure l{iterminaltransport} combines additional implementation support wrapper stub instance client various passed provider functionality issue l{_commandtransport} l{itransport}, l{ipushproducer} udp used around stringio interfaces internet wraps includes host connected ssh l{iconsumer}, shapes l{_iprocesstransportwithconsumerandproducer} data @ivar implements none endpoint proceed calls l{iprocesstransport}, conforms l{amp} work sshservertransport step server sshclienttransport connection multicast i{transport} verification receives c{transport} l{iterminaltransport}s l{twisted ipushproducer}
iserver	interface pop3 querying capabilities server
total	connections simultaneous factory limits number
for	layer c{getclientip} creator raised connections header see result another l{client certificates web implemented l{deferredgenerator} top factory add adapt provides policy parameter l{ipolicyforhttps} https form normal x-forwarded-for ssl uses handling verifying clients request value server connection command context
channel	used output forwarding l{iprotocol} provider request command connects session executes input l{_commandchannel} server handling channel side
ftpdata	use factory connections (i command data port
warnings	dirtyreactoraggregateerror}s converts l{util wrapper reporter
daytime	867 form back send rfc daytime ascii
pbclient	pb client factory brokers
tracker	functions provides parameters iq pass response key/value without l{contexttracker} tracker way arbitrary interface call passing data stack
connecting	raised stop connects connector l{istreamclientendpoint} connecting cancelled asked c{exception}
unit	c{unittest} extended also itestcase library's standard testcase trial result c{testresult} wrap supports pyunit types adapt
tuntap	from/to writes packets reads tun/tap-device port
imap4client	protocol @ivar implementation currently connection state client imap4 representing string
hosts	~/ structured file ssh/known_hosts openssh-format representation
dirdbm	domain checked users <dirdbm maildir-backed checker membership authenticates credentials l{dirdbm
proc	implements responses entries grab lookup() /proc/net/tcp
minimal	minimalist prints #tests form reporter summary #skips) result (timetaken #failures test #errors
core	core implement must methods reactor
object	doesn't given associated name object exist imported can't
run	test run
versioned	information persisted object type versioning
quit	quit execute whether upon worker connection dead flag cannot terminates ampbox representing sent instructions
deleted	requested deleted control-flow indicates internal error message
smtpfactory	protocol smtp factory server
of	argument lists decode instances single encode type
broker	objects broker
refused	failed erefused} c{twisted refused indicates connection result dns query side names
zombie	l{ireactorprocess may emitted spawnprocess} way called
vhost	use http hostname able record vs https method
host	named managed file produces l{iknownhostentry} smtp virtual couldn't filter completion queue given bucket hostname wrapper forms matches : remote smart openssh-formatted relay in-progress c{known_hosts} l{bucket} collection host hierarchical uses key relayers represents resource esmtp changed messages looked hosts action entry resolution send
boxes	connection boxes raised empty can't
ftpanonymous	implementation iftpshell anonymous filesystemroot l{twisted @type
output	received kinds might performing standard basic interface i/o error expected useful l{twisted data (particularly
peer	peer verify rejected error
selectable	providing c{_disconnectselectable} method mixin
gpgllgprmcfix	indications gprmc fix possible gpgll sentences quality
tlsnot	tls exception secure missing support required server authentication error indicating
by	service l{bucket} bucket filter host hierarchical
haproxy	haproxy endpoint protocol string stream support parser factory wrapper server connections proxy provides haproxyserverendpoint adds type
pbserver	perspective broker factory server
sshsession	l{itransport} l{iprocessprotocol}
socket	externally set to/docs/selfpipe methods supported underlying c{close} i{sock_stream}, sockets reactor c{true} use implemented @ivar i{self-pipe i{sock_dgram}, c{shutdown} html>}, type trick<http _shouldshutdown yp made attempt socket created calling (eg allow //cr etc) called
extension	extension compiled module met certain conditions
constraint	exception raised violated constraint
recvd	attribute to-be-deprecated c{intnstringreceiver emulates recvd}
esmtpfactory	esmtp protocol factory server
ifinishable	producers finish consumer
datagram	arp udp icmp protocol socket g ip abstract packets tcp datagram unix connected protocols listening interface e datagram-oriented transports port transport
pluggable	whose set reactor l{iresolversimple} customized object l{ireactorpluggableresolver} resolver l{ireactorpluggablenameresolver} user-supplied name
saslauth	sasl authentication failed
srv	specific domain protocol location server
advertized	exception stream required feature entity advertized initiating indicating
discard	rfc discard 863 data received
closeable	indicate half-closes notification descriptor want implemented half-closed
iinitializer	interface xml initializers stream
soa	start authority zone marks
dcc	outgoing protocol coverage stream getting receive higher-level direct send dcc connection client bare chat file type
garbage	errors run garbage collection forces test
dnslookup	failed lookup dns
tcpmap	map in-memory protocol dictionary postfix factory tcp postfixtcpmapserver implementation agent mail transport
ikqueue	interface kqueue implementations
gpggafix	indications fix possible sentences gpgga quality
stop	mix-in log global stop observers start
stan	xml object parser twisted sax converts stan model document
doesnt	directory doesn't exist
url	represents sip url convenient l{url} modifying parts api provides
xmlstring	xml loads parses l{itemplateloader} string
wrap	l{iprotocol} wraps provider l{iprocessprotocol}
smtpprotocol	response mangled sent server
ireporter	report test run results suite
attribute	function represent deprecated color text object wrapper attribute attributes class present
ircbad	string attempting encountered parse mode malformed
terminated	process ended probable condition error
git	subset commands git repository twisted release
transmission	sending make bytes request error
log	represent stores help text midnight filters implement wraps based writes state >>> localtime someone read rotated l{ilogobserver} catches level output fixed related logs observer l{interfaces series library's begun c{logging} i{ilogobserver} errors describing protocol access fans l{ilogobserver}, told standard base line-based log logging l{logbeginner} l{twisted singleton useful inclusion system another message size use publishing unknown observes twisted forward : l{ilogfilterpredicate}s observers module line protocols begins c{amp} applying l{ilogfilterpredicate} l{loglevel} smtp file ilogobserver} holds namespace python iloggingcontext} events http tried buffer object levels mixin class constants lower request daily limited-size event's transports file-like
nstring	generic length class protocols prefixed
area	widget vertical l{scrolledarea} contains moving another scrollbars wrapped horizontal viewport around
pager	information splits simple come object sends reads file chunks pager pages string
support	tls provided used level support indicate flags l{protocolnegotiationsupport} backend npn/alpn defines
stateful	stateful stores state protocol string
submit	button thereof facsimile reasonable submit
iosystem	c{os} in-memory useful implementation testing module i/o drop-in parts context basic primitives unit replacement
bioprotocol	bio via protocol sending bytes openssl wrapper written uses memory encrypt l{tlsmemorybioprotocol}
ipath	map used objects filepath-like internal importers interface factories
ftpfactory	ftp protocol @ivar seconds factory interpreter's instances idle timeout time producing
forwarder	locally-defined interface forwarding useful class
ioendpoint	callable endpoint @ivar standard _stdio l{stdio input/output like
ecdh384	hash elliptic exchange defined sha-384 curve key
ihandshake	tls run like would notified l{iprotocol} handshakes indicate tls-based interface implemented complete
httpclient	given http responses url parser 1 0 handles client download
glib	scheduled works run reactors windows event events base gobject waking class loop
naptr	specific domain protocol location server
zip	represent zipimporter within zipimport file l{zipfile wrap archive l{readfile}, zip implementation uncompressed access also contained ipathimportmapper gives used read object zipfile zipfile} deflated directory entry l{filepath}-like file-like
authdeclined	credentials rejected server
complete	produces names file completion usernames based network pattern system forms : multiple complete matches glob directory hostnames words interface group completes items list comma-separated action fixed
form	form object occurred calling callable error signature method
iauthorized	usernames keys object valid ssh provides mapped authorized
iconversation	specific conversation person
basic	protocol stream producer direct c{true}, bare human foundations server jabber information stats @ivar l{bytes} workers readable factory send authentication authenticates basic instead save local credential http format shared xmlstream authenticationrealm man middle receive options trial connection client savestats act ftp consumer @type
encoder	helper encoding returing exposes instances used l{http11clientprotocol} compression l{_irequestencoder} top factory l{iconsumer} passed 9 supports @cvar compresslevel write}, encoder compressor streaming highest data l{irequest level default request object server gzip example bodies
delivery	domain handling service esmtp alternate smtp use server delivery interface base implement mail domains using message class
failure	detailed l{pb abstraction render l{irenderable} basic l{failure<twisted remotecopy} occurred information add version l{copiedfailure} error l{failureelement} failure} expected copyable} l{failure l{flavors failure
retrying	automatically requests l{http11clientprotocol} wrapper retries
dnsname	failed c{twisted indicates result dns ename} query names
dnsmixin	udp protocol dns tcp implementations mixin shared
authority	fileauthority files updated code built zone <https python keeps authority performing source transfers //en file u{bind loaded loads
iunixdatagram	packetprotocols udp connectedpacketprotocols transport
sphinx	work sphinx around documentation custom broken html references external sphinxinventory using generate
line	code useful features render smtp (l{lineonlyreceiver raw single exceeded protocol and/or adds log depending source basic input indicating mode l{irenderable} l{terminalprotocol} line-based line-editing line editing data protocols logging l{_sourcelineelement} lines maximum server limited-size length sent receives error history
trying	twice raised deferuntillocked} l{deferredfilesystemlock called
with	domain set l{interfaces parser c{*args} header names string redirect combines l{responsefailed} field l{_contextfactorywithcontext} passed various c{location} issue around dictionary keys interfaces exception mapping objects got l{_iprocesstransportwithconsumerandproducer} non-existing convert like c{**kwargs} default work value l{istreamclientendpointstringparserwithreactor} without simulated l{twisted
info	information container helper header deferred proxy debug protocol data parsed
pull	streaming adapter converts producer non-streaming
attr	foreground normal generic text support color formatting getattributenode background attribute attributes class
ftpfile	ftp parser listings evil standard file required : match
default	domain observer attribute thus names character factory wrapper importer l{defaultopensslcontextfactory} text dictionary keys mapping ssl objects nothing applying none e non-existing default value server-side context simulated attributes
rpcserver	deprecated
iqauth	entity authentication non-sasl initiating initializer
bucket	implementation things buckets bucket nested filter token
prep	implements preparation domain internationalized names
record	rename domain responsible protocol list unchanged authority formatted freeform single domain-name pass consists non-terminal null pointer exchange canonical specific wire group l{_userrecord} zone record authoritative data destination system member redirection forwarder ipv4 dns marks policy mail semantically start l{_shadowrecord} 1035 map l{userdatabase} description information l{shadowdatabase} ipv6 structurally mailbox host user address known shadow encapsulate holds types service definition resource name database cell well location server rfc alias person text unknown nameserver afs
fds	systemd provides descriptors access l{listenfds} file inherited
ui	used console key chat gui object notifications true/false client ui verification questions ask post
verification	useful verification error
called	cancel already-called tried event
impl	none zipimport e default wrapper implementation importer ipathimportmapper zipimporter
pop3message	requested deleted control-flow indicates internal error message
hellman	parameters exchange generation required key representation diffie-hellman
unjellyable	unjelly inherit convenience c{setstatefor} directly method
abstract	arp domain protocol ip abstract accounts datagram-oriented implementation subclass volatile attribute l{ifilepath}; udp @cvar completed pickling implementing base designed icmp class must e g maildir-backed list remove mixed transports
parser	set protocol stream text parses parser c{*args} l{istreamclientendpointstringparserwithreactor}, parsing streaming tcp6serverendpoint l{hostnameendpoint} responses codes headers l{wrapclienttls} except machine handles l{istreamclientendpointstringparserwithreactor} haproxyserverendpoint irc type occurs box http string receiver exception finite-state ansi boxes sip proxy records i{systemd} class thrown received convert endpoint like c{**kwargs} messages server formatted client l{istreamserverendpointstringparser} error
char	given reference separate dom character numeric representation
as	directed towards remote another reference locally object effects behavior useful emulating class
warning	represents exception l{ireactorprocess may occurs emitted spawnprocess} system teardown one instance warning way setup python (l{warnings}) l{_warning} called
exist	directory doesn't exist
at	completion produces matches forms action :
file	select() protocol producer c{write()} caused rotated existing l{zipfile decisions l{readfile}, l{filebodyproducer} implementation writes produces send file-based username/password override input localtime non good handle around read midnight l{ifilepath}; zipfile variants represents resource like deflated turns bytes translates plain respond observer sends 'downwards' l{knownhostsfile} direct authority service bare superclass operated ssh/known_hosts asynchronously transport ftp factory subclass access everything written behave minimal dcc objects compressed address path configuration come logging socket extension getting receive connection base receiver existent zipfile} changes raised coverage simple within text-based instances unix chunks loaded message log zip structured negative wrapper mis-use gives files attempted completed delivers trying must write-file-like look permits l{iunixtransport prompts openssh-format stream sendfiledescriptor} abstract parser higher-level incrementally reads file archive contents monitoring make discards uncompressed write also events used may object l{filepassworddb} ~/ representation data class weakly calls database daily (although alias client filesystem directory entry consumer non-interpreted file-like
iperspective	aspects relationship n per*spec*tive : subject
saslincorrect	incorrect sasl base64 encoding
iknown	openssh-formatted entry c{known_hosts} l{iknownhostentry} file
check	topfile version stream 0 checking number initializer 1 thing minimum whether checkout checks common
socksv4incoming	building incoming connections class protocols utility
nscontext	xml mapping prefixes namespaces document onto
machine	outgoing endpoint state machine connection maintaining single
cacheable	cached instance
no	code reactor don't deprecating found} interpreter redirect trying writes l{responsefailed} l{staticproducer} input local 'no c{exception} non represents none boxes cannot entity entire name found exists l{interfaces module specified l{none} port currently factory current state version got method use ipushproducer}, host statinfo value', identifiable could trial connection existent can't raised owned header marker given certificate create returns passed c{location} empty function route failure no-op remote l{errorpage} exception made l{noresource} c{buildprotocol} install called want abstract pid file documents specialization field l{istreamclientendpoint} used http object pair response i{not peers attempt request without command
authoritative	c{name given name failed authoritative class server type} indicates lookup records matching
eq	implements c{__eq__} c{__ne__} mixin
itlstransport	tls tcp midstream supports switching transport
httpparser	http processing handles parsing l{httpparser} suitable side
storage	storing inewsstorage asynchronous news pickles trivial newsstorage flaws implementation contains generally compatibility twisted's instead numerous reason interface using class articles backwards -- db-api inherit requesting unsuitable implement
tcpserver	interface endpoint tcp server
invalid	parsing raised signify conf jid sentence pass pid known_hosts used interpreted known rpc (i file specified protocol jabber parsed contents string one provided given error incorrectly unknown deprecated header system invalid port authentication valid ipv4 provides ipv6 expected neither improperly local arguments authtype someone tried tcp6 python didn't use dot-separated inetd objects user internal address services logging configuration network exception e name plugin argument checksum could required list foreign formatted tcp4 either l{loglevel} entry path identifier proxy
application	fork shed based like unix-specific things privileges object pid application running maintain helps file avoids applicationrunner config
int16string	strings int16-prefixed receiver
sslacceptable	tls representation acceptable ciphers connections
lookup	transaction dictlookupfactory factory single used dict class utility
pidfound	found pid file
tlsrequired	tls negotiation exception support required server indicating security transport
test	files raised testcase}s l{testcase}) unittest testing results whatever one warning l{testsuite} pass return find unit write accumulates testresult indicate teardown (either pyunit current failed c{run} adapt trial memory usage suite wrapped several decorators method function occurs tests run extend reporter far emitted l{testresult} standard test base overrideable library's atom cases placeholder class decorator log exception minimize universe inside modules remove l{testcase} testcase -- consistently l{twisted c{testsuite} itestcase setup
ns	authoritative nameserver
pop3error	pop3 errors base class
sshchannel	represents connection ssh multiplexed class channel
sshagent	protocol equivalent agent server client ssh side
flattener	object curly l{keyflattener} keys things format within occurred parsed computes pep-3101-style flattening error l{string strings braces
iregistry	url logical->physical allows mapping registration
directory	raised exists runner supported exist another specified children doesn't appear working currently content vcs shouldn't print resources available run repository lists test user scripts using resource serves l{resourcescriptdirectory} filesystem directory
hostnames	hostnames complete
augmentation	implementation db-api twisted's asynchronous using newsstorage
registry	available web domain made object dynamic twisted content simplistic file-based internal registry specific componentized
a6	address ipv6
authorities	set l{openssl list represented explicitly specified certificates trust
iencodable	decoded object something file interface encoded
ihostname	resolve name series l{iaddress} number l{ihostnameresolver} objects host port
lmx	xml creation easy
pool	represent generalizes work http dispatched database db-api persistent connections 0 compliant 2 functionality hopefully threads class pool
saslinitiating	sasl authentication performs stream initializer
ibox	appropriately receive object send application objects dispatch l{ampbox} transport
remote	raised cache useful reference able string-ified identify something publishable wrap reraise emulating l{remotecache} message whose reverse-reference end copyable locally peer's local method used means object wrong effects copy l{cacheable} class translucent exception remote indicates serialized type connection transmitted behavior error representation went side can't
algorithm	l{_ifixedgroupkexalgorithm} l{_igroupexchangekexalgorithm} group generator encryption / actually describes elliptic l{_ikexalgorithm} exchange l{_iellipticcurveexchangekexalgorithm} uses key encrypt prime algorithm anything curve server client fixed
iproxy	container header parser streaming handles proxy protocol data headers
serialized	marker pre-serialized dom class xml
consumer	requirement methods producer l{interfaces implementations middle rate enforces file total ftp combines l{iconsumer} data writes length mix written various take c{registerproducer} man issue finish around get track interfaces wraps producers buffer proxy input l{_iprocesstransportwithconsumerandproducer} exact care c{consumer} keeping finite work shapes c{unregisterproducer} receives act consumer producerconsumerproxy
interval	given "instants" list amount intervals sleep time generate
curve	elliptic algorithm exchange l{_iellipticcurveexchangekexalgorithm} curve client describes uses key server
moderation	easy-to-use get messages sending storage inherit method c{notifymoderators} implementations care class take
daily	log rotated midnight daily file localtime
smtpmanaged	l{smtpmanagedrelayer} managed create smtp factory relayer
initiating	stream component feature initializer server-side authentication base external initializers entity class initiating
time	saving reactor back instances daylight timezone methods datetime} readable send machine form 868 encodes offset represents c{datetime rfc without time implement fixed
push	used producer l{interfaces adapter no-op ipushproducer}, streaming version converts non-streaming abstract
resolution	represents given recursive in-progress hostname l{ihostresolution} dns query resolution name
esmtprelayer	esmtp relayers base class
serializer	buffer tree element internal class serializes
asyncio	running top l{asyncio reactor selectoreventloop}
