all	based parameters results pairwise p-values comparisons class
dist	cdf extra requirements mainly p-values matching tables different stats parameters piecewise currently 1 critical expon parameter function linear normal max step scipy based estimate e gmm n try quantiles values cannot pdf distribution
global	ordinal ratio odds global nominal gee estimate data
dynamic	squares hold parameters dynamic factor estimates results least class p fitting vector autoregression dynamicfactor (var time-varying using ordinary equation-by-equation model panel
results	origin mediation hazards particular results ols p-values proportional implemented regression canonical instance wraps dynamicfactor based parameters space likelihood cohen's smoother generally fitting yet looking dependent state holding contain test steps switching contrast summarizes multivariate tests in-sample kalman restrictions models pairwise survival unobserved prediction statsmodels and/or hamilton markov kim attributes variable kappa onewaymixed hold placeholder class coefficients dummy applying fit cox linear out-of-sample empirical analysis quantreg filter discrete autoregression components correlation ---------- comparisons model estimation parametric
manager	used context getting object needed manager without allow closed class file-like
row	table cells list provides row
ecdf	function cdf return empirical step array
inverse	inverse family exponential notes squared transform inversegaussian
equivalence	terms defined equivalence covariance classes structure
kstep	kstepahead validation cross iterator
spec	parameters
norm	used parent normal distributions gram-charlier modified expansion regression azzalini scipy distribution follows norms robust skew-normal holder class univariate
func1	trend quadratic made sin
brownian	:math brownian motion cir geometric : subordinated
wave	andrew's estimation wave
fan	p 179f eubank
exact	diffusion integral exact representation
heston	stochastic heston volatility
cloglog	function link cloglog transform
hsdresults	plot tukey compute additional hsd results also post-hoc test using evaluations methods
leave	iterator generator views give cross cross-validation leave-p-out leave-one-label_out x validation leave-one-out
discrete	little vectors working get models marginal abstract random collection choice discrete effects distributions model representing class simple
markov	model first-order parameters models results switching regression fitting autoregression k-regime markov hold class
hampel	function hampel m-estimation
zi	statistical mle generic maximum poisson model estimation likelihood example
prediction	in-sample parameters space models generally out-of-sample prediction results state ----------
jump	------- example
exchangeable	structure exchangeable dependence working
glshet	model estimated regression heteroscedasticity
index	index e + * g(x semiparametric b) single model =
nonlinear	variables subclass array rows asymptotic gmm provide assumed least deltamethod squares method function non-linear wusing covariance instrumental moment base designed class condition subclassed equal 2d supposed following model estimation
neg	function quadratic negative
cell	cell table provides
abs	transformation class value absolute
sur	parameters unrelated regression seemingly
new	distributions holder modified
contrast	restrictions tests used linear models parametric results construct regression looking contrast particular model matrices class coefficients
sarimaxresults	sarimax results fitting model hold class
multivariate	via results cholesky parameters linalg least class decomposition test squares multivariate linear normal beginning model _multivariateols maybe ignoring plain distribution sigma mean
multinomial	logit function use pseudo-link multinomial transform models fitting nominal gee
unobserved	models series unobserved results also fitting components time known model hold univariate class decompose structural
groups	groupstats lazy statistics groups decorators - yet version another (not still evaluation class
ttest	independent statistical power two one sample paired calculations t-test
gls2	short stacked intertemporal within general individuals correlation balanced data assumes panel
box	transformation allow class mixin box-cox
table2x2	contingency analyses 2x2 performed table
ahead	kstepahead validation cross iterator
probit	cdf normal notes transform standard probit
poisson	family statistical exponential mle generic distributions time maximum nobs iid process poisson compound model estimation likelihood example
gls	restrictions short stacked intertemporal probabilistic within general individuals correlation balanced gls data assumes panel
writer	files binary parameters dta writing objects stata array-like class
sarimax	seasonal autoregressive average exogenous moving regressors model integrated
mvnormal0	multivariate distribution class normal
family	one-parameter families class parent exponential
total	wald-wolfowitz runs probability distribution total exact class
unit	em implementation measures repeated individual experimental unit
plot	p-p probability q-q convenient construction plots class
lmparams	represents linear state mixed model parameter class
additive	additive parameters components model smoothed non-parametric
mlemodel	parameters space maximum state model estimation likelihood
negative	function family exponential parameters negative binomial link variance
cirsubordinated	motion cir brownian subordinated
garch	gjrgarch t-garch experimentation garch model still stage
arma	represent contains methods process conditional bring estimated univariate given tools initial least class lag-polynomials squares arma fft moving properties processes several autoregressive average together values either model providing similar
gmmresults	right storage class
hold	instance arrays module calling write python attributes save numpy class
mc	monte run todo study statistical test''' carlo class
pout	iterator validation cross leave-p-out
equation	stub estimate equation one
iv2sls	parameters variables least-squares instrumental two-stage using estimation 2sls
mv	multivariate conducting inference means correlation class
can	projections exog=x class endog=y results value find x_cancoef decomposition analysis correlation y_cancoef using matrices singluar canonical
my	errors pareto linear mle generic t-distributed maximum distribution poisson model estimation likelihood example
compare	comparison tests work parameters j-test models cox non-nested interval confidence two sample comparing test multi-endpoint class
process	represent given perform ridge kernel process nobs gaussian together properties intensive bring warning lag-polynomials memory regression x creates distance class arma
ouprocess	ornstein-uhlenbeck
sample	generating random process structures within allows intercept various correlation data yet panel
sem2sls	parameters least simultaneous two-stage squares equations
biweight	function tukey's biweight m-estimation
recursive	squares recursive parameters results least fitting model hold class
aft	functions used inference conducting estimating optimization provides aft model class
parameter	equality linear managing vector parameter class constraints
max	stats normal max n scipy expon
factored	semidefinite matrix form positive factored representation
data	reattach handling knows responsible pandas input model metadata data class extracting
short	short stacked intertemporal within general individuals correlation balanced data assumes panel
counter	hashable sometimes subclass bag objects dict counting called
ortho	density series basis approximate expansion orthonormal uses polynomial estimation univariate
correlation	control sizes marginal effect fdr correlation
representation	takes parameters space process series frozen state snapshot time representation model statespace
opts	conducting calculating holds functions optimized intervals hypothesis tests class confidence
restriction	note full linear parameters reduced q r params = transformation constraints
goldfeld	parameters whether subsamples 2 test variance
schwartz	schwartz process :math 1 stochastic : type
fform	test form functional nonparametric
fft	processes fft methods providing similar contains several tools class arma
bunch	accessible via dict-like keys attribute object returns lookup
affine	multivariate differential equation affine rank full distribution transformation
tsa	descriptive series collection statistical time methods
ls	subclass regression recursive parameters provide least performs test squares method tests non-linear linear base groups class coefficients equality whether subclassed across supposed model estimation
pca	parameters component analysis basic pca class principal
mvelliptical	multivariate normal base elliptical distributions class
svarresults	parameters process number lags p var estimate fixed
descriptive	descriptive series collection statistical time methods
merton	------- example
hamilton	applying space results filter state hamilton model
effects	control used sizes selection marginal effect regression forward base effects correlation regressionfdr fdr class
compound	process time nobs iid poisson compound distributions
one	em schwartz give process :math leave-one-label_out results cross-validation leave-one-out onewaymixed special iterator generator become implementation make normal cross class 1 performs test stochastic : type across tests linear views models measures repeated groups attributes regression properties coefficients equality whether descriptor x model validation
elreg	conducting calculating holds functions optimized intervals hypothesis tests class confidence
term	named simple term formula model class
trimmed	function trimmed m-estimation mean
l2	penalty ridge l2
mean	function trimmed m-estimation mean
square	function inverse square methods negative quadratic analyzing derivative table contingency hold class
series	parameters
mleresults	space fitting results state model hold class
gaussian	kernel mailinglist exponential family normal k gaussian inversegaussian (sqrt(2*pi)) 1 exp(-0 archibald u / http distribution = anne //www
margins	methods mostly get marginal discrete choice expected sub-class lays nothing model class effects
pareto	pareto distribution estimation likelihood maximum
out	iterator generator views give cross cross-validation leave-one-label_out x validation leave-one-out
try	logit handling parameters conditional nested runmnl test data
rv	discrete distributions representing class collection
matrix	operation linalg array class defines
space	generic statespacemodel meant class base
gof	w^2 tests chisquare power kuiper statistical fit d-, goodness-of-fit goodness one sample u^2 cramer-von calculations v test d+, includes mises kolmogorov-smirnov
squared	notes inverse squared transform
svar	b fit defined components var estimate structural
nominal	structure models nominal covariance independence
reader	dta file stata reader
formula	essentially string instances simple object list term patsy interpreted models design wrapper manipulating formula matrices regression consisting
squares	functions derived least m-estimation rho squares
reg	kernel quantile using categorical class continuous iterative results nonparametric regression instance model least reweighted significance test variables estimate censored quantreg
independence	ordinal working models covariance dependence nominal independence structure
linear	xb variables estimated nonlinear gmm + closed instead = linear form models instrumental step uses class optimizers partially e g semiparametric model z expression
coef	categorical variables continuous nonparametric significance test regression
standard	independent n 1 0 vector x distribution
base	irf-related statistics computing plotting base want class
likelihood	function via parameters models allows maximum subclass results discrete fitting variable contain dependent model likelihood class
rls	linear parameters restricted least general handles model squares constraints
pairs	based parameters results pairwise p-values comparisons class
autoregressive	structure first-order autoregressive dependence working
wls	implementation performance optimized wls minimal
filter	use code applying parameters kalman space process series results filter state hamilton time representation model arma intended
w	case nobs tests statistics descriptive 2d nvars rows weights 1d data assumes observations
regress	origin inference linear empirical estimation likelihood regression
origin	origin parameters class empirical results likelihood regression
kdeunivariate	kernel estimator univariate density
tarma	errors methods t-distributed except inherit tsa loglike model univariate arma
gmle	statistical mle generic maximum poisson model estimation likelihood example
nested	structure dependence working nested
elorigin	origin inference linear empirical estimation likelihood regression
wrapper	wraps monkey tester testing results patch simply statsmodels steps estimation numpy class
norm2	follows class azzalini scipy distribution univariate skew-normal
array	operation linalg array class defines
categorical	parent categorical models covariance data class structure
acskew	skew-t follows azzalini scipy distribution univariate class
smoother	kernel process series results polynomial given and/or space smoother state 1d switching kalman kim markov applying regression/kernel density simulation filter time representation model requires order
least	functions derived least m-estimation rho squares
theil	restrictions gls probabilistic
params	parameters models switching markov hold class
continuous	notes continuous clip_lower clipped distribution masspoint
olsresults	model ols results _multivariateols class
forward	control selection sizes effect fdr forward
diffusion	diffusion motion process integral equation differential brownian ------- wiener sigma=1 mu=0 representation exact example
manova	multivariate based implementation analysis manova variance regression
iranalysis	irf-related statistics impulse computing analysis plotting computes base want response class asymptotic responses
resettable	whose elements depend dictionary one another mey
psdmatrix	semidefinite matrix form positive factored representation
armaresults	results fitting model hold class arma
null	distribution estimate null gaussian z-scores
hpoly	(for bounds orthonormal weight=1) uses hermite polynomial finite
kaplan	kaplanmeier
switching	model first-order parameters models results switching fitting k-regime markov hold class
normal	multivariate statistical ignoring given cholesky linalg two construct 1 0 decomposition calculations cumulants edgeworth z-test independent samples power normal expansion pdf beginning plain n vector maybe x distribution sigma mean
incidence	function estimation inference cumulative incidence
mlegls	nobs use short matrix 200 series <= inverts time model loglikelhood exact arma
dummy	dummy conversion full + rank b u encodings x =
quandt	parameters whether subsamples 2 test variance
cdflink	distribution use scipy stats cdf
mediation	mediation results analysis holding conduct class
survfunc	function survival estimation inference
varprocess	represents process var p known class
mvnormal	multivariate distribution class normal
ratio	ordinal ratio odds global nominal gee estimate data
cache	whose elements depend dictionary cachedwritableattribute one another mey cachedattribute decorator
distributed	model results class parameters contain
penalty	penalty scalar-value representing class
ftest	statistical power generic f-test anova one calculations factor balanced
dict	insertion remembers dictionary order
factor	dynamicfactor parameters categorical dynamic results fitting factor model hold todo class
mixture	case mixture unbound like simple support discrete scipy mixtures mixing distribution univariate
clogit	logit handling parameters conditional test data
means	comparison tests work interval confidence two sample multi-endpoint class
geemargins	fit marginal effects gee model estimated regression
gen	random univariate functions non-monotonic based normal skew-normal u- log/exp non-linear skew-t continuous monotonic expansion azzalini scipy gram-charlier variable class follows transformation constructor hump-shaped distribution called
runs	wald-wolfowitz binary runs parameters probability sequence process assumed k definition success classical trials length underlying bernoulli distribution total exact class
settings	density object estimation regression specify settings
summary	tables parameters summary construction result hold presentation class take
x	model still stage garch experimentation
tpoly	chebychev (for notes orthonormal weight=1) 1 -1 polynomial
kernel	kernel smoother parameters n-dimensial density generic requires class object nonparametric regression 1d regression/kernel censored
set	http anne archibald mailinglist //www
ivgmm	defined variables conditional estimated nonlinear gmm assumed condition closed basic instead function non-linear linear form models wusing instrumental step uses using class optimizers default moment following model estimation expression mean
writable	cachedwritableattribute decorator
stats	lazy another still yet statistics - version 1d (not evaluation assumes observations groupstats tests descriptive nobs nvars rows groups data class case decorators 2d weights
label	cross-validation leave-one-label_out iterator
hist	function cdf linear piecewise step pdf distribution
state	generic statespacemodel meant class base
stata	files binary use array-like intended parameters missing dta value dataset class objects file stata reader variable observation's writing public
geometric	motion :math geometric : brownian
stratified	tables analyses 2x2 contingency collection
missing	observation's value missing
olsinfluence	calculate parameters outlier measures influence ols result class
bivariate	copula bivariate class
logit	multinomial logit use transform gee
c	variables continuous nonparametric significance test regression
cov	function rows asymptotic parent categorical models data covariance equal 2d grouped deltamethod base designed correlation array structures class structure
cox	mixin parameters models cox hazards non-nested class test allow proportional regression box-cox model transformation
functs	optimized/solved functions holds class
context	used context getting object needed manager without allow closed class file-like
variance	random 1 defaults variance variable relates mean
tukey	function plot tukey compute additional hsd tukey's results also biweight post-hoc test using evaluations m-estimation methods
simple	latex necessarily (2d!) simple data numerical produce html *rectangular* table array csv ascii
poly	orthonormal given smoother format track series density approximate expansion keep varma uses examples order basis polynomial estimation univariate class
bspline	knots given bsplines order specified
table	square methods extra simple analyzing performed p-values table array ascii tables necessarily currently 1 critical *rectangular* csv parameter (2d!) numerical two-way collection produce analyses data contingency latex e html values distribution 2x2
tsmlemodel	likelihood series maximum time model estimation univariate
varma	format track keep varma examples polynomial class
cosine	kernel = k cosine u cos(0 pi/4
ph	cox model hazards regression proportional
empty	used context getting object needed manager without allow closed class file-like
ivregression	model ols results class
kalman	use code parameters kalman space process series smoother filter state time representation model arma intended
andrew	andrew's estimation wave
func	function inverse negative value transformation quadratic derivative hold class absolute
censored	censored nonparametric regression
multi	comparisons tests multiple parameters
kappa	attributes cohen's kappa results
frozen	frozen model snapshot statespace takes
plain	operation linalg array class defines
expanded	given expansion construct cumulants pdf edgeworth
value	observation's value missing
glmresults	glm results class contain
gumbel	theta requires >=1
property	normal make descriptor attributes become properties special
vg	process variance gamma
it	instance arrays module calling write python attributes save numpy class
expan	normal follows expansion scipy gram-charlier distribution class
chisquare	chisquare power statistical goodness-of-fit one sample calculations test
varresults	parameters process number lags p var estimate fixed
regression	control results directly regressionfdr k-regime first-order parameters regression fitting switching summarizes model used linear models base effects hold class fit fdr markov called procedure
ig	??? used inverse-gaussian nig
generic	function via density dependent kde allows maximum results regression discrete fitting base models variable estimation likelihood class classes
sqrt	notes square-root transform
ru2nmnl	logit parameters multinomial random nested 2 parameterization utility
quant	quantreg quantile iterative results least regression instance reweighted using model estimate
svarprocess	represents parameters process p svar known class
ordinal	structure ordinal models covariance independence
cheby	chebychev (for notes orthonormal weight=1) 1 -1 polynomial
nig	normal-inverse-gaussian
gijbels1eu	p 179f eubank
sys	implemented yet
kim	model applying smoother results kim markov switching
copula	copula bivariate class
robust	used parent regression norms robust class
identity	notes transform identity
components	models series unobserved results also fitting components time known model hold univariate class decompose structural
quantitative	term used transformations point subclass another apply
model	function via directly * abstract results single statistical datasets todo regression index errors additive parameters generic likelihood + responsible g(x subclass dependent fitting input = smoothed non-parametric metadata meant linear models choice statespacemodel base variable longitudinal data class panel handling e b) mle t-distributed allows maximum called discrete semiparametric components contain model estimation example extracting
parametric	like discrete scipy mixtures mixing distribution
clog	inherits logit complementary cloglog transform method access log-log _clean order
univariate	made trend eubank sin p quadratic todo 179f
struct	parent categorical models data covariance grouped base correlation structures class structure
gmm	moments mainly matching needs based gmm currently subclass defined generalized conditions method different moment quantiles requirements estimate class parameters subclassed try cannot distribution estimation
density	density series basis approximate expansion orthonormal uses polynomial estimation univariate
tlinear	errors linear mle generic t-distributed maximum model estimation likelihood example
anova	statistical power means f-test anova one comparing calculations factor balanced class
rlmresults	rlm returns results class contain
clipped	notes continuous clip_lower clipped distribution masspoint
fevd	plot compute asymptotic forecast decomposition error variance
cum	function estimation inference cumulative incidence
opt	functions used inference optimized/solved holds conducting estimating optimization provides aft model class
psd	symmetric domain matrix positive argument +infinity converges penalty approaches boundary
quantiles	different based parameters gmm currently mainly matching try quantiles cannot requirements estimate distribution
nclogit	logit handling conditional nested test runmnl data
desc	multivariate confidence skewness compute inference means univariate random tests conducting intervals hypothesis correlation variable variance kurtosis class involving mean
phreg	right survival fit cox class hazards results censored fitting contain proportional model data regression
d	like categorical variables mixtures nonparametric discrete scipy significance test distribution regression mixing
semi	e linear g xb + semiparametric model z = partially
garch0	model garch
t	errors linear mle generic t-distributed class skew-t maximum example azzalini scipy distribution poisson follows model estimation likelihood huber's univariate
stationary	stationary covariance structure
right	function incidence inference survival cumulative estimation
kde	classes kernel mailinglist density kde class base archibald http anne estimation estimator regression //www
conditional	multivariate conditional estimator density kernel
f2poly	[0 orthogonal (for weight=1) pi] polynomial fourier
anovaopt	optimized containing class functions
ols	multivariate via linear parameters least model squares
varmax	autoregressive parameters average exogenous vector moving regressors model
scale	linear models scaling fitting robust huber's
glshet2	might variables wls explanatory heteroscedasticity note depends weights mixing gls sigma make
meier	kaplanmeier
prob	probability sequence process underlying total classical convenient p-p q-q bernoulli trials construction plots exact class wald-wolfowitz definition runs success k length assumed distribution
minimal	implementation performance optimized wls minimal
nose	monkey tester testing patch simply numpy
power	chisquare goodness-of-fit one sample statistical balanced inverse parameters generic two anova samples factor test z-test function independent calculations power f-test base class notes paired transform variance t-test
huber	pseudo-huber scale linear penalty models jointly scaling estimating fitting 2 location robust proposal estimation huber's
step	subset set methods simple x[0] handled currently everything descend way simplest function homogeneous_subsets ends basic possible step class tree values ival similar left
binomial	function family exponential parameters negative binomial link variance distribution
corr	projections exog=x class endog=y results value find x_cancoef decomposition analysis correlation y_cancoef using matrices singluar canonical
offset	mle generic maximum poisson model estimation likelihood example
panel	intertemporal process abstract within dynamic general statistical balanced yet longitudinal short individuals various ordinary structures assumes generating random intercept using data class panel datasets stacked allows vector autoregression correlation time-varying model
comparison	comparisons tests multiple parameters
constraint	equality linear managing vector parameter class constraints
cosine2	kernel cosine2 * 1 u -0 cos(2 + u) pi = k
chol	multivariate cholesky linalg beginning normal distribution class decomposition maybe mean operation ignoring sigma array defines
arcovariance	process ar class experimental covariance
simulation	and/or applying kalman space process series smoother results simulation filter state time representation model
estimator	density object estimation regression specify settings
autoregression	parameters switching results class fitting autoregression regression model hold markov
mixed	em represents use object linear fit state implementation measures fitting results onewaymixed models repeated specifying contain mixed model parameter class effects
skew	follows class azzalini scipy distribution univariate skew-normal
gamma	distribution family exponential gamma
nbinom	function binomial link negative
kfold	validation cross iterator k-folds
float	discrete distributions representing class collection
two	mainly bring ols anova analysis functions non-monotonic based things currently two wrapper u- way type transformation class together constructor hump-shaped distribution called
down	subset methods simple currently tree homogeneous_subsets step descend similar class
het	parameters whether subsamples 2 test variance
log	inherits logit based log complementary notes cloglog transform method access log-log log/exp _clean distribution order transformation
varmaxresults	varmax results fitting model hold class
transform	model reparameterize rank encodings linear conversion parameters + affine class note params = transformation multivariate full standardized exog dummy b q r u x distribution reduced constraints
custom	generic kernel object 1d
cauchy	notes cdf cauchy transform standard
way	em mainly results bring ols analysis anova onewaymixed linear implementation things currently two wrapper regression way test type across tests performs models measures repeated groups class coefficients equality whether together model
var	selection process dynamic obsolete equation-by-equation use fit least tsa internal var instead ordinary squares estimates lag (var using class panel p vector autoregression time-varying order
lsresults	squares recursive results least fitting model hold class
function	function basic ends set handled random possible ival 1 everything step way values defaults variance variable relates x[0] left simplest mean
emplike	conducting inference estimating aft model class
uv	confidence skewness compute univariate random tests intervals hypothesis variable variance kurtosis class involving mean
gauss	kernel ridge distance perform nobs gaussian regression intensive process warning memory x creates class
link	function exponential family generic link one-parameter
delta	function rows asymptotic covariance equal 2d deltamethod designed array
tweedie	family tweedie
j	models comparing j-test parameters non-nested
smooth	and/or applying kalman space smoother results filter state model
kdemultivariate	conditional multivariate density estimator kernel
fdr	control fdr regression procedure
distribution	case mixture unbound simple support gaussian z-scores distribution null univariate estimate
odds	ordinal ratio odds global nominal gee estimate data
ordered	insertion remembers dictionary order
olseffects	ols regression analysis knockoff
describe	statistics data calculates descriptive
single	index e + * g(x semiparametric b) single model =
ar	notes -----
ind	independent statistical power samples chisquare two goodness-of-fit sample calculations test t-test z-test
nbin	binomial negative parameters regression
transf	u- functions non-linear based >=1 continuous monotonic transformation random called non-monotonic constructor log/exp hump-shaped variable theta distribution requires class
arresults	results fitting ar model hold class
descr	case nobs tests statistics descriptive 2d nvars rows weights 1d data assumes observations
lmresults	linear results fitting effects contain mixed model class
nd	generic kernel parameters n-dimensial
patsy	string simple patsy interpreted wrapper formula
readonly	cachedattribute decorator
test	multivariate monte continuous run form categorical todo variables significance functional results nonparametric regression statistical correlation test study test''' carlo class canonical
fpoly	needs [0 density (for don't 1] see orthonormal corfactor weight=1) polynomial fourier
pandas	reattach handling knows class model data pandas metadata
arithmetic	:math :
stat	monte inference random carlo intervals statistical todo confidence univariate test''' multivariate tests skewness run means involving hypothesis variable kurtosis class conducting compute study correlation variance mean
standardize	reparameterize standardized parameters exog model class
exp	distribution based log/exp transformation
covariance	http anne archibald mailinglist //www
variable	variable public use intended dataset
ramsay	estimation ea ramsay's
lm	use linear fit object specifying mixed model effects
e	estimation ea ramsay's
svd	operation linalg array class defines
pseudo	penalty pseudo-huber
time	normal make descriptor attributes become properties special
