object	object
generic-procedure	generic-procedure
record-type-dispatch-tag	record
pathname	pathname
delete-member-procedure	member
error:divide-by-zero	by
open-tcp-server-socket	open
argument-command-line-parser	command
input-port-type?	port
slot-initpred	initpred
assignable?	assignable?
rb-tree/equal?	tree/equal?
computed	computed
hash-table-entry-type:datum-weak	entry
get-parser-buffer-pointer	get
eof-object?	eof
receiver	receiver
type:warning	type:warning
unicode-char	unicode-char
record-type-field-names	record
output-port/flush-output	output
left	left
wt-tree/empty?	tree/empty?
error:file-operation-error	error
make-condition-type	type
guarantee-port	guarantee
cadr	cadr
destination-x-left	destination-x-left
file-type-direct	type
init-file-pathname	pathname
hash-table/lookup	hash
read-parser-buffer-char	buffer
by	by
procedure-arity-min	procedure
*unparser-list-depth-limit*	depth
<inexact>	<inexact>
create	create
guarantee-dispatch-tag	tag
*matcher	*matcher
bind-default-condition-handler	bind
4.2.4	4.2.4
make-key-weak-eq-hash-table	table
wide	wide
x-right	x-right
bitmap-from-dib	dib
ascii-range->char-set	>char
os	os
close-all-open-files	open
bit-string-clear!	clear!
end	end
16.4.4	16.4.4
argument	argument
pathname-new-device	new
environment-has-parent?	parent?
operating	operating
format	format
file-eq?	file
scalar-values->char-set	scalar
seq	seq
*uncompressed-file-lifetime*	lifetime*
specializer	specializer
bit-string->unsigned-integer	integer
rexp-string-start	start
terminal	terminal
rexp-not-word-edge	word
right	right
flonum-parser-fast?	flonum
string-null?	null?
make-wt-tree-type	type
unit	unit
list-deletor	list
fix:or	fix:or
strong-hash-table/constructor	hash
stopped	stopped
file-type-direct	direct
scalar-values->char-set	>char
7.7	7.7
slot-initial-value?	value?
record-type-name	record
sixth	sixth
hard-link-file	link
wt-tree	wt-tree
8.4	8.4
microcode-id/operating-system-variant	id/operating
copier	copier
prompt-for-evaluated-expression	evaluated
unbreak-exit	exit
wt-tree/split>	tree/split>
file-touch	file
wt-tree/union	tree/union
subprocess	subprocess
remove	remove
error?	error?
get-host-by-name	host
char-set	char-set
weak-cons	weak
match-parser-buffer-char-in-set	parser
list	list
output-port/write-char	char
input-port-type?	type?
substring	substring
input-port->parser-buffer	buffer
close-all-open-files	all
i/o-port-type?	i/o
1d-table/remove!	1d
macros?	macros?
2.12.2	2.12.2
slot-initial-value	value
bool	bool
ref	ref
object-unhash	unhash
hash-table-entry-type:key-ephemeral	type:key
member	member
with-stack-sampling	sampling
state	state
9.5	9.5
make-primitive-procedure	procedure
9.3	9.3
weak-cons	cons
variant	variant
n2	n2
bit-string->unsigned-integer	>unsigned
rexp-not-word-edge	edge
microcode-id/operating-system	id/operating
predicate	predicate
reporter	reporter
write-xml-file	write
error:wrong-type-argument	error:wrong
make-procedure-arity	procedure
>pathname	>pathname
slot-class	slot
tcp-server-connection-accept	server
guarantee-thunk	guarantee
prompt-for-evaluated-expression	expression
condition-type:divide-by-zero	zero
11.4.2	11.4.2
dib-height	dib
4.1	4.1
6	6
>unsigned	>unsigned
match-parser-buffer-string	parser
rexp-word-start	start
connection	connection
3.4	3.4
xml-unparsed-!entity	!entity
pair?	pair?
14.12.3	14.12.3
hash-table/datum-list	hash
4.7.2	4.7.2
environment-macro-names	names
fill?	fill?
class-name	name
type:error	type:error
file-attributes/access-time	time
weak	weak
universal-time->file-time	time
14.9.4	14.9.4
sc	sc
toggle-gc-notification!	toggle
graphics-flush	flush
record-accessor	record
fresh-line	fresh
graphics-set-coordinate-limits	set
runtime?	runtime?
break-exit	exit
slot-initializer	initializer
delete-file-no-errors	delete
key-hash	key-hash
open-wide-output-string	open
environment-definable?	environment
link?	link?
char-set?	char
hash-table/datum-list	list
procedure!	procedure!
set-input-buffer-size	buffer
bit-string-or	bit
wt-tree/for-each	wt
14.4	14.4
*random-state*	state*
3.1.3	3.1.3
wt-tree/split<	wt
wide-string-length	length
binary	binary
condition-type?	type?
port/with-output-terminal-mode	port/with
rexp-compile	rexp
generic-procedure-applicable?	generic
xml-!entity	!entity
unadvise-exit	unadvise
slot-initpred-method	method
file-namestring	namestring
macros!	macros!
bit-string-andc!	string
output-buffer-size	buffer
prompt-for-command-expression	for
vector-sixth	vector
rexp-word-edge	word
errors?	errors?
2d-get-alist-x	2d
set-input-buffer-size	size
i	i
utf8-string-length	utf8
limit*	limit*
fill-polygon	polygon
index	index
bit-string-and!	and!
prefix?	prefix?
make-initialized-vector	initialized
wide-string->string	>string
condition-type:system-call-error	error
12.6.1	12.6.1
graphics-erase-point	graphics
muffle-warning	muffle
find-restart	find
make-wt-tree	tree
chars-remaining	chars
object-class	class
char-set-member?	set
tcp-server-connection-accept	accept
bit-substring-move-right!	substring
identifier	identifier
17.8	17.8
set-generic-procedure-default-generator!	generic
shell-file-name	shell
condition-type:datum-out-of-range	out
process-time-clock	clock
nearest	nearest
generic-procedure-applicable?	applicable?
reduce	reduce
copy-area	copy
parser-buffer-pointer-index	index
buffered-input-chars	input
open-i/o-file	file
unhash	unhash
wt-tree/for-each	tree/for
rb-tree/min-pair	tree/min
z3	z3
match-parser-buffer-string	string
xml-name?	xml
lcm	lcm
entry-type	entry-type
declaration	declaration
reverse	reverse
condition-type:derived-port-error	condition
wt-tree/for-each	each
members	members
vector-copy	copy
16.6	16.6
rb-tree/datum-list	tree/datum
set-generic-procedure-default-generator!	default
modification	modification
writeable?	writeable?
15.7.1	15.7.1
before	before
decoded-time/date-string	string
inode	inode
cf	cf
set-hash-table/rehash-threshold!	table/rehash
add-generic-procedure-generator	generator
fix:not	fix:not
make-rb-tree	rb
text	text
file-attributes/change-time	attributes/change
wt-tree/add	wt
rexp-line-start	rexp
equal-hash-mod	hash
make-record-type	type
make-eof-object	make
10.7.2	10.7.2
string->file-time	time
make-xml-name	name
null-xml-namespace-uri?	null
char-set-member?	char
condition-accessor	accessor
for-each	for
free-names	free-names
wt-tree/difference	tree/difference
subclass	subclass
call-with-temporary-file-pathname	file
verb	verb
decoded-time->string	>string
ceiling	ceiling
remove-generic-procedure-generator	generator
11.3	11.3
port/with-output-terminal-mode	terminal
hash-table-entry-type:datum-ephemeral	hash
condition-type:system-call-error	condition
condition-type:derived-file-error	type:derived
*uncompressed	*uncompressed
radius-x	radius-x
type:wrong	type:wrong
record-type-field-names	type
sampler:debug	sampler:debug
delete-directory	delete
file-attributes/inode-number	file
system-library-directory-pathname	system
string-tail	string
11.7.1	11.7.1
weak-pair	weak-pair
procedure-arity?	arity?
bit-string-2	bit-string-2
read-xml-file	read
resize-window	resize
char->integer	char
define-record-type	type
call-with-input-file	file
string->decoded-time	>decoded
condition-type:divide-by-zero	by
color-name	color-name
string-wt-type	string
initial-value	initial-value
restart/effector	restart/effector
wide-string?	string?
make-generic-procedure	generic
specializer-classes	classes
set-file-times!	set
hash-table/datum-list	table/datum
namespace	namespace
>uninterned	>uninterned
17.2	17.2
rb-tree/copy	rb
message	message
set-record-type-unparser-method!	unparser
char-set->scalar-values	set
re-string-search-forward	search
2.3	2.3
decoded-time->universal-time	>universal
make-eof-object	eof
load-bitmap	load
union-specializer	specializer
delete-association-procedure	association
any	any
*unparse-with-maximum-readability?*	with
symbol-append	append
clear!	clear!
set-parser-buffer-pointer!	parser
2.7	2.7
draw-circle	draw
2.10	2.10
canonical-host-name	host
canonical-host-name	canonical
generic	generic
record-keyword-constructor	keyword
scalar	scalar
string-trim	trim
peek-parser-buffer-char	char
*	*
length+	length+
save-bitmap	bitmap
condition-types	condition-types
read-xml	read
flo:vector-ref	ref
singleton-wt-tree	singleton
macro	macro
initial-offset	initial
obj1	obj1
list->stream	>stream
simple-command-line-parser	line
record-type-name	type
write-condition-report	write
condition-type:bad-range-argument	condition
rb-tree->alist	rb
sf	sf
ascii-range->char-set	ascii
vector-second	second
*parser	*parser
>stream	>stream
>parser	>parser
soft-link-file	link
xml-name-string	xml
hash-table->alist	table
set-gc-notification!	set
15.4	15.4
bit-string->unsigned-integer	string
quote	quote
list-ref	ref
2d-put!	2d
bit-string-and	and
weak-set-cdr!	set
set-window-name	name
5.5	5.5
bit-substring	substring
make-bit-string	bit
simple-command-line-parser	simple
5.2	5.2
arguments	arguments
copy	copy
xml-qname-local	local
set-hash-table/rehash-size!	set
graphics-bind-drawing-mode	drawing
standard-warning-hook	warning
expt	expt
remove-generic-procedure-generator	procedure
graphics-device	graphics-device
clist	clist
type-name	type-name
environment-parent	parent
7.6	7.6
boolean?	boolean?
vector-binary-search	vector
read-string	string
write-condition-report	report
1d	1d
delete-association-procedure	delete
filter	filter
property	property
port/set-output-terminal-mode	mode
access	access
file-attributes/uid	file
eof?	eof?
font-name	font-name
advice	advice
parser-buffer-ref	ref
del-assq	assq
2d-get-alist-y	get
subvector-move-left!	move
wt-tree/union-merge	tree/union
datum	datum
type:strong	type:strong
rexp-syntax-char	syntax
rexp-not-word-char	char
2d-get	get
simple-command-line-parser	command
guarantee-procedure-of-arity	guarantee
set-entity-extra!	extra!
xml-name-local	name
make-primitive-procedure	make
rexp-case-fold	fold
internal-time/ticks->seconds	>seconds
1d-table/put!	table/put!
make-syntactic-closure	syntactic
accessor	accessor
peek-parser-buffer-char	parser
subvector	subvector
time-string	time-string
make-generic-procedure	make
char-integer-limit	char
last	last
flonum-parser-fast?	fast?
condition-type:floating-point-underflow	point
delete-file-no-errors	errors
file-symbolic-link?	file
microcode-id/operating-system-name	microcode
file-attributes/mode-string	string
string->uninterned-symbol	>uninterned
word	word
procedure-arity-max	procedure
condition-type:bad-range-argument	type:bad
sort	sort
advise-entry	entry
error-type	error-type
trim	trim
<=	<=
image/fill-from-byte-vector	byte
let-syntax	syntax
10.2	10.2
rexp-group	rexp
rename	rename
bit-string-clear!	string
error:datum-out-of-range	of
soft	soft
string-match-forward	forward
graphics-move-cursor	cursor
real-time-clock	real
bit-string?	bit
source-x-left	source-x-left
environment-assigned?	assigned?
field	field
letrec	letrec
abort	abort
xml-dtd	dtd
utf8	utf8
6.5	6.5
flo:random	flo:random
set-output-buffer-size	set
>regexp	>regexp
host2	host2
method-procedure	procedure
source-y-top	source-y-top
rename-file	rename
promise-forced?	forced?
16.5.1	16.5.1
in	in
define-record-type	define
stream->list	stream
string->parser-buffer	string
rexp-not-word-char	not
12.2	12.2
2d-get-alist-x	get
tag	tag
resource-id	id
rb-tree?	tree?
and!	and!
xml-name-local	xml
signed-integer->bit-string	>bit
record-type-field-names	names
radius-y	radius-y
open-binary-input-file	file
unadvise-exit	exit
tail	tail
17.1	17.1
port/set-input-blocking-mode	blocking
host-address-loopback	address
modulus	modulus
file-attributes/mode-string	file
condition-type:illegal-datum	type:illegal
input-line-translation	input
slot-class	class
condition-type:derived-file-error	error
fresh	fresh
user-homedir-pathname	homedir
set-gc-notification!	notification!
procedure-of-arity?	arity?
port-type/operation	port
hour	hour
vector-seventh	seventh
defaults*	defaults*
rexp-not-syntax-char	char
server-socket	server-socket
parse-namestring	namestring
copy-area	area
set-hash-table/rehash-size!	hash
make-parser-macros	make
toggle	toggle
generic-procedure-default-generator	procedure
class-name	class
directory-read	directory
parser-buffer-ref	parser
graphics-type-available?	type
size	size
resize	resize
port/input-terminal-mode	terminal
parse	parse
graphics-device-type	graphics-device-type
universal-time->file-time	universal
er-macro-transformer	transformer
xml-document	document
ephemeral	ephemeral
wt-tree-1	wt-tree-1
run-synchronous-subprocess	subprocess
image/fill-from-byte-vector	image/fill
open-tcp-stream-socket	socket
condition-type:error	type:error
vector-fourth	fourth
write-xml-file	xml
14.3	14.3
set-current-parser-macros!	set
remaining	remaining
open-wide-output-string	output
expression	expression
vector-8b-set!	vector
with-current-unparser-state	unparser
generalization	generalization
name->char	name
eof-object?	object?
sampling	sampling
promise-forced?	promise
microcode-id/operating-system-name	name
vector-tail	tail
unicode-char?	unicode
clear	clear
class-direct-superclasses	class
intern	intern
month/max-days	days
descriptor	descriptor
port-type?	port
flo:random-unit	flo:random
string->file-time	string
direct-slot	direct-slot
file-readable?	file
signed	signed
with-current-parser-macros	with
port	port
hash-table/put!	hash
contents!	contents!
make-strong-eq-hash-table	strong
15.9	15.9
open-wide-output-string	wide
open-wide-input-string	open
*unparser	*unparser
find-color	color
system-call	system-call
wt-tree-type	wt-tree-type
dotted-list?	list?
days	days
xml-document	xml
file-modes	file
numerator	numerator
month/max-days	month/max
number->string	number
rexp-optional	rexp
wt-tree/delete-min!	tree/delete
set-font	font
substring-move-left!	substring
flip	flip
erase	erase
guarantee-thunk	thunk
with-timings	with
general-car-cdr	general
generic-procedure?	generic
read-parser-buffer-char	parser
*unparse-with-maximum-readability?*	readability?*
make-key-weak-eq-hash-table	weak
regexp-group	group
define-windows-type	type
graphics-erase-point	erase
radius	radius
<instance>	<instance>
file-touch	touch
close-port	port
xml-name-string	name
process-time-clock	time
module	module
list-copy	copy
interaction-i/o-port	interaction
error:divide	error:divide
general-car-cdr	cdr
read-line	read
vector-8b-find-previous-char	find
nearest-repl/environment	nearest
disk	disk
get-parser-buffer-pointer	parser
font	font
set-command-line-parser!	parser!
2d-get-alist-y	alist
pointer	pointer
each	each
er	er
safety-margin	safety-margin
string->parser-buffer	buffer
condition-type	condition-type
file-attributes/access-time	attributes/access
eq-hash	eq
fill	fill
stack-sampler:debug-internal-errors?	stack
flush-output	flush
7.2	7.2
partition	partition
new	new
advise-exit	exit
file-exists?	exists?
rb-tree/max	rb
rb-tree/datum-list	list
pathname-wild?	wild?
translation	translation
re-string-search-forward	forward
set-current-parser-macros!	current
obj2	obj2
weak-set-car!	set
redisplay	redisplay
extract	extract
call-with-temporary-file-pathname	pathname
bottom	bottom
environment-has-parent?	environment
read-parser-buffer-char	char
time-zone?	time
stack-sampler:debug-internal-errors?	errors?
15.1.4	15.1.4
port/operation-names	names
end1	end1
rexp-sequence	rexp
!element	!element
lower	lower
hash-table-entry-type:datum-weak	weak
xml-name-local	local
with-current-unparser-state	state
after	after
hook?	hook?
prompt-for-command-expression	prompt
set-file-modes!	file
10.4	10.4
bit-string-append	bit
image?	image?
set-record-type-unparser-method!	method!
lambda-list	lambda-list
2d-get-alist-y	y
rexp+	rexp+
system-global-environment	system
input-port->parser-buffer	input
open-binary-input-file	binary
output-port/fresh-line	line
bit-string	bit-string
invoke	invoke
directory-pathname-as-file	file
pattern	pattern
slot-property	property
errors	errors
procedure?	procedure?
condition-type:subprocess-abnormal-termination	type:subprocess
break-on-signals	break
interval	interval
set-parser-buffer-pointer!	set
record-type	record-type
make-key-ephemeral-eq-hash-table	ephemeral
file-attributes/inode-number	attributes/inode
>number	>number
*unparser-string-length-limit*	*unparser
vector-sixth	sixth
forced?	forced?
system-library-pathname	system
1d-table/alist	table/alist
eqv-hash-mod	hash
define-windows-type	windows
add-methods	methods
parser!	parser!
hash-table->alist	hash
string-prefix?	string
rb-tree/min-datum	tree/min
nearest-repl/environment	repl/environment
slots	slots
3	3
bit-string-xor!	bit
identifier=?	identifier=?
bit-string-clear!	bit
replace	replace
vector-ref	vector
condition	condition
border	border
define-generic	generic
move!	move!
slot-accessor-method	method
applicable?	applicable?
char-set-member?	member?
10.3	10.3
list->vector	>vector
vector-8b-find-previous-char	8b
graphics-erase-point	point
slot-initial-value	slot
wide-string-set!	set!
forward	forward
stack-sampler:debug-internal-errors?	internal
decoded-time->universal-time	time
environment-lookup-macro	macro
pathname=?	pathname=?
break-exit	break
xml-qname-local	qname
append!	append!
difference	difference
make-computed-emp	computed
open-output-string	open
wide-string->string	wide
add-generic-procedure-generator	generic
vector2	vector2
generic-procedure-default-generator	generic
open-tcp-server-socket	tcp
weak-set-cdr!	cdr!
bit-string-xor!	xor!
generate-uninterned-symbol	symbol
font-structure	structure
condition-type:derived-file-error	file
string-search-backward	search
make-key-weak-eq-hash-table	hash
slot-accessor-method	slot
open-binary-input-file	input
bit-substring-move-right!	bit
type:key	type:key
slot-initialized?	slot
file-attributes/length	file
rexp->regexp	rexp
remove!	remove!
make-string-hash-table	make
2.12.4	2.12.4
file-attributes/n-links	links
set-line-width	set
polygon	polygon
bit-string-fill!	string
field-name	field-name
make-computed-emp	emp
built-in-dispatch-tags	tags
create-editor-args	create
format-error-message	format
error:bad-range-argument	range
substring->parser-buffer	substring
13.4	13.4
*args*	*args*
write-instance	write
weak-hash-table/constructor	table/constructor
14.12.2	14.12.2
input-line-translation	translation
instance-predicate	instance
environment-bound-names	bound
file-attributes/n-links	file
car?	car?
er-macro-transformer	macro
condition-type/generalizations	type/generalizations
utf8-string-length	string
delete-dib	delete
xmlns-uri	uri
system	system
delete-dib	dib
decoded-time/daylight-savings-time?	decoded
string->decoded-time	time
9.6	9.6
vector-length	vector
string-length	length
string->symbol	>symbol
make-1d-table	make
*parser-radix*	*parser
symbolic	symbolic
stream-tail	stream
8.7	8.7
apply-hook?	apply
procedure-arity?	procedure
record-keyword-constructor	constructor
modes	modes
set-file-modes!	set
file-symbolic-link?	link?
grow	grow
string-search-backward	backward
unaligned	unaligned
selector	selector
16.4.2	16.4.2
open-tcp-server-socket	server
2.5	2.5
define-class	class
2.4	2.4
with	with
make-key-weak-eq-hash-table	make
16.5.3	16.5.3
pathname-new-device	pathname
open-tcp-stream-socket	open
destroy	destroy
clock	clock
15.1.2	15.1.2
current-parser-macros	macros
xml-name-prefix	prefix
weak-car	car
set-entity-procedure!	set
set	set
procedure-arity-valid?	procedure
run	run
untrace-entry	entry
graphics-draw-text	draw
operator	operator
namestring	namestring
make-decoded-time	time
hash-table-entry-type:strong	type:strong
make-key-weak-eq-hash-table	key
char-set->scalar-values	char
file-type-direct	file
peer-address	peer-address
local-decoded-time	decoded
slot-initial-value?	initial
table?	table?
xml-!element	xml
minute	minute
bit-string-and!	bit
hashed?	hashed?
class-slot	class
reduce-left	left
local-decoded-time	local
graphics-device-coordinate-limits	device
subimage	subimage
set-hash-table/rehash-size!	size!
class-direct-superclasses	superclasses
11.5	11.5
misc-1	misc-1
type-descriptor	type-descriptor
rename-file	file
char-upcase	upcase
bit-substring-move-right!	move
xml-name-uri	xml
arc	arc
last-pair	pair
null	null
string-upper-case?	upper
condition/type	condition/type
find-tail	find
x3	x3
substring->list	>list
flo:vector-ref	flo:vector
condition-type:subprocess-abnormal-termination	abnormal
5.7.2	5.7.2
ticks	ticks
top-level-environment?	top
port/with-input-blocking-mode	port/with
condition/restarts	condition/restarts
stream	stream
symbol-hash	hash
error:bad-range-argument	error:bad
standard-warning-handler	warning
host1	host1
unparser-state	unparser-state
xml-name-uri	uri
condition-type:wrong-number-of-arguments	number
buffered-output-chars	chars
define-method	define
unicode-scalar-value?	scalar
make-wt-tree-type	tree
cell	cell
init-proc	init-proc
fill-polygon	fill
window	window
set-input-buffer-size	input
write-condition-report	condition
dispatch-tag?	tag?
union-specializer	union
absolute?	absolute?
i/o-port?	port?
working-directory	working
>wide	>wide
error:derived	error:derived
standard-error-handler	handler
union	union
named-lambda	named
value	value
7.5	7.5
hash-table/rehash-threshold	threshold
pa	pa
precedence	precedence
program	program
let*-syntax	let*
object-hash	hash
11.4.4	11.4.4
image/fill-from-byte-vector	vector
*parser-canonicalize-symbols?*	canonicalize
year	year
set-border-width	width
y	y
only	only
system-library-directory-pathname	pathname
graphics-move-cursor	move
xml-name-uri	name
spec	spec
1d-table/put!	1d
chars->char-set	>char
global-parser-macros	parser
make-graphics-device	graphics
rest	rest
the-environment	the
syntax	syntax
save-editor-files	save
toggle-gc-notification!	notification!
environment-bound-names	environment
hash-table-entry-type:strong	entry
rexp-word-end	rexp
null-xml-namespace-uri?	xml
sc-macro-transformer	macro
unchecked	unchecked
>seconds	>seconds
unicode	unicode
unicode-scalar-value?	value?
enumerate	enumerate
read-substring	substring
call-with-output-file	output
color	color
rb-tree?	rb
make-computed-method	computed
call-with-input-file	with
transformer-spec	transformer-spec
ignore-reference-traps	ignore
condition-type:datum-out-of-range	range
error:datum-out-of-range	error:datum
error	error
local-host	local
args	args
guarantee-dispatch-tag	dispatch
14.1	14.1
bit-string-length	length
hash-table/constructor	hash
rb-tree/min-pair	pair
list-tabulate	list
bit-string-andc!	bit
working	working
case	case
*default-pathname-defaults*	defaults*
hard	hard
make-condition-type	condition
thunk?	thunk?
string->symbol	string
notation	notation
restart/name	restart/name
make-string-hash-table	table
global-parser-macros	global
environment-lookup-macro	environment
weak-set-car!	car!
condition-type:floating-point-underflow	type:floating
output-port/write-char	output
capitalized?	capitalized?
-1	-1
directory?	directory?
file-regular?	regular?
savings	savings
superclass1	superclass1
with-current-parser-macros	parser
symbol-append	symbol
error:divide-by-zero	error:divide
environment	environment
name	name
representation-type	representation-type
pathname-as-directory	directory
enumerate-graphics-types	enumerate
15.1.3	15.1.3
char-set-1	char-set-1
direct	direct
14.7	14.7
buffered-output-chars	buffered
*random	*random
null-xml-namespace-uri?	uri?
guarantee	guarantee
get-parser-buffer-tail	buffer
slot	slot
bound	bound
the	the
system-global-environment	environment
procedure-of-arity?	procedure
x-close-all-displays	displays
environment-assigned?	environment
vector?	vector?
continuation	continuation
open-input-file	open
ephemeron	ephemeron
16.7	16.7
let*	let*
link	link
file-namestring	file
access-condition	access
set-generic-procedure-default-generator!	set
maximum	maximum
condition-type:wrong-type-datum	type
wide-string-length	string
name?	name?
parent-table	parent-table
singleton	singleton
reverse!	reverse!
asin	asin
specializer-classes	specializer
decoded-time/day-of-week	week
xml-name->symbol	name
argument-command-line-parser	parser
object-hashed?	hashed?
slot-properties	properties
arity	arity
with-stack-sampling	with
vector-8b-find-previous-char	char
condition/report-string	string
condition-type:simple-warning	warning
gcd	gcd
file-attributes/mode-string	attributes/mode
host-address-any	address
floor	floor
define-load-option	load
soft-link-file	soft
14.9.2	14.9.2
remove-generic-procedure-generator	generic
flonum-vector	flonum-vector
*unparser-string-length-limit*	limit*
7.1	7.1
open-i/o-file	i/o
*parser-canonicalize-symbols?*	*parser
emp	emp
>file	>file
del	del
exists?	exists?
type:illegal	type:illegal
object-hashed?	object
generic-procedure-applicable?	procedure
filename1	filename1
advise-entry	advise
set-current-parser-macros!	macros!
match-parser-buffer-char-in-set	char
1d-table/alist	1d
condition-type:datum-out-of-range	type:datum
abnormal	abnormal
get-host-by-name	by
key=?	key=?
class-precedence-list	class
draw-image	draw
copy-file	copy
except-last-pair	last
hang	hang
map	map
graphics-device-coordinate-limits	coordinate
xml-name-prefix	xml
draw-ellipse	ellipse
stream-head	stream
wt-tree/min	wt
set-entity-procedure!	procedure!
state!	state!
bind-cell-contents!	contents!
output	output
xml-!entity	xml
parser-buffer?	buffer?
element	element
string-match-forward	match
error:datum	error:datum
background	background
define-color	color
compute	compute
17.5	17.5
flonum	flonum
string1	string1
error:datum-out-of-range	out
add-methods	add
graphics-operation	graphics
call-with-output-file	with
call-with-temporary-file-pathname	temporary
object-unhash	object
reset	reset
graphics-type-available?	available?
set=?	set=?
resource-id	resource
universal-time->file-time	>file
rexp-word-char	word
well-formed-scalar-values-list?	list?
exit	exit
load	load
unparser-method	unparser-method
week	week
apply-hook?	hook?
set-parser-buffer-pointer!	buffer
let*-syntax	syntax
invoke-restart	invoke
15.3	15.3
15.7.2	15.7.2
error:wrong-number-of-arguments	arguments
9.1	9.1
state*	state*
bindings	bindings
bit-string-and!	string
15.8	15.8
length	length
integrate-operator	integrate
open-input-file	file
read-xml-file	xml
x-close-all-displays	x
xml-!notation	xml
port/with-input-blocking-mode	blocking
init-file-pathname	init
stream-rest	stream
fold	fold
xml-name->symbol	>symbol
parser-macros?	macros?
*proc*	*proc*
standard-unparser-method	method
delete-file-no-errors	no
modification-time	modification-time
*uncompressed-file-lifetime*	*uncompressed
port/input-terminal-mode	port/input
types	types
formals	formals
port/with-input-blocking-mode	input
generic-procedure-arity	procedure
6.4	6.4
circle	circle
char-set-2	char-set-2
signal-condition	condition
7.9	7.9
with-current-unparser-state	current
lifetime*	lifetime*
with-current-unparser-state	with
peek-parser-buffer-char	buffer
hash-table/rehash-threshold	hash
fold-right	right
host=?	host=?
record-type-class	class
1d-table/get	1d
measure-interval	interval
superclass2	superclass2
object?	object?
port/state	port/state
bit-substring-move-right!	right!
add	add
class-slots	slots
ephemeron?	ephemeron?
make-apply-hook	make
make-syntactic-closure	closure
format-error-message	message
the-environment	environment
flo:zero?	flo:zero?
condition-type/error?	type/error?
edge	edge
error:wrong-type-datum	error:wrong
open-output-string	string
bind-condition-handler	bind
no-type-checks	type
pixels	pixels
with-pointer	pointer
move	move
clause	clause
general	general
symbols?*	symbols?*
file-symbolic-link?	symbolic
port/set-output-terminal-mode	terminal
filename	filename
set-entity-procedure!	entity
ignore-assignment-traps	traps
car	car
angle-start	angle-start
mod	mod
eof	eof
condition-type:derived-port-error	type:derived
12.3	12.3
access-time	access-time
save-editor-files	files
bucky-bits	bucky-bits
rexp?	rexp?
18.2.2	18.2.2
restart?	restart?
xml-unparsed-!entity	unparsed
condition-type:bad-range-argument	range
eq-hash-mod	mod
string-null?	string
ascii->char	>char
o	o
table	table
make-class	make
make-wt-tree-type	wt
file-attributes	file
structure-option	structure-option
hash-table/rehash-size	table/rehash
record-type-field-names	field
destination-y-top	destination-y-top
generate-uninterned-symbol	generate
superclasses	superclasses
16.1	16.1
!attlist	!attlist
directory-pathname-as-file	pathname
hash-table-entry-type:key/datum-weak	type:key/datum
file-attributes/type	file
string-maximum-length	length
write-substring	substring
warning	warning
shell-file-name	file
hash-table-entry-type:strong	hash
user-homedir-pathname	user
measure-interval	measure
file-attributes/length	attributes/length
current-output-port	output
port/set-output-terminal-mode	output
condition-type:datum-out-of-range	of
type:bad	type:bad
file-attributes/modes	file
user-initial-environment	user
make-primitive-procedure	primitive
new-value	new-value
environment-lookup-macro	lookup
*uncompressed-file-lifetime*	file
load-option	load
unparser	unparser
output-buffer-size	size
peek-char	peek
no-range-checks	range
char-list	char-list
reset-editor	editor
decoded-time->universal-time	decoded
error-irritant/noise	error
equal-hash-mod	mod
2.1	2.1
er-macro-transformer	er
change	change
string-capitalize	capitalize
condition-type/field-names	condition
atan	atan
error:wrong-number-of-arguments	error:wrong
file-modes	modes
with-current-parser-macros	macros
rexp-line-end	rexp
make-graphics-device	device
file-attributes/modification-time	file
port/output-terminal-mode	port/output
write-instance	instance
make-char	make
2.11.1	2.11.1
begin	begin
dib	dib
3.2	3.2
to	to
delay	delay
char	char
unadvise	unadvise
1.2	1.2
xmlns-uri	xmlns
stream-map	stream
16.3	16.3
line-ending	line-ending
h	h
generate-uninterned-symbol	uninterned
call-with-output-file	file
downcase	downcase
i/o-port?	i/o
pwd	pwd
condition-type:divide-by-zero	type:divide
apply-hook-procedure	procedure
string-upcase	string
call-with-binary-input-file	file
regular?	regular?
15.5.4	15.5.4
string-capitalized?	capitalized?
make-bit-string	string
rexp-line-start	start
bit	bit
make-string-hash-table	string
1d-table/get	table/get
read-line	line
trace-output-port	port
current-input-port	input
process	process
environment-assign!	environment
rexp-word-char	rexp
accept	accept
port/set-input-terminal-mode	terminal
bitmap	bitmap
set-record-type-unparser-method!	type
close	close
identifier?	identifier?
error:datum-out-of-range	range
record-class	class
reason	reason
number->string	>string
parse-namestring	parse
14.11.3	14.11.3
x-close-all-displays	close
substring-move-left!	move
pp	pp
bind	bind
microcode-id/operating-system-variant	microcode
make-strong-eq-hash-table	table
string-upcase	upcase
touch	touch
quasiquote	quasiquote
n	n
make-wt-tree	make
singleton-wt-tree	wt
mexp	mexp
rexp-syntax-char	rexp
global	global
external	external
stream-tail	tail
open-tcp-server-socket	socket
command	command
environment-bound?	environment
bit-string-fill!	bit
environment-bindings	bindings
applicable	applicable
tcp-server-connection-accept	connection
wt-tree?	wt
xml->wide-string	xml
enumerate-graphics-types	types
condition-type:no-applicable-methods	methods
set-port/state!	set
symbol-hash-mod	symbol
reverse-string	reverse
create-editor	create
environment-lookup	environment
disk-save	save
make-wt-tree-type	make
equal?	equal?
vector->list	vector
fix:xor	fix:xor
rb-tree->alist	tree
cond	cond
environment-bound?	bound?
integer-floor	integer
standard-unparser-method	unparser
10.6	10.6
error-irritant/noise	irritant/noise
bit-string?	string?
variable	variable
remove-generic-procedure-generator	remove
reset-editor	reset
canonical-host-name	name
write-xml	write
traps	traps
dib-set-pixels-unaligned	set
file-length	file
make-decoded-time	decoded
from	from
rexp-line-end	end
string-capitalized?	string
make-procedure-arity	make
11.2	11.2
bit-string-or	string
port!	port!
no-type-checks	checks
redisplay-hook	hook
string-suffix?	string
xml-external-id	external
hash-table/get	hash
6.2	6.2
write-substring	write
except	except
wt-tree/set-equal?	tree/set
list->string	list
output-buffer-size	output
write-dib	write
call-with-current-continuation	current
alternatives	alternatives
noun	noun
fifth	fifth
checks	checks
2d	2d
reduce-left	reduce
condition-type:bad-range-argument	argument
path	path
condition-type:wrong-number-of-arguments	type:wrong
parser-buffer-pointer-index	buffer
2d-get	2d
signed-integer->bit-string	string
suffix?	suffix?
bit-string-1	bit-string-1
delete-association-procedure	procedure
vector-fill!	vector
make-key-ephemeral-eq-hash-table	key
make-key-ephemeral-eq-hash-table	table
flo:atan2	flo:atan2
wt-tree/delete-min!	min!
generate	generate
fold-right	fold
x-key	x-key
weak-pair?	weak
match-parser-buffer-string	buffer
unadvise-entry	entry
delete-member-procedure	delete
list->string	>string
set-output-buffer-size	buffer
homedir	homedir
set-file-modes!	modes!
with-stack-sampling	stack
set-entity-extra!	set
xml-!attlist	!attlist
if	if
match-parser-buffer-char-in-set	set
i/o-port-type?	port
>decoded	>decoded
wt-tree/union	wt
universal-time	universal-time
match-parser-buffer-string	match
bit-string-and	bit
*parser-radix*	radix*
char->ascii	>ascii
wt-tree/split>	wt
generic-procedure-arity	arity
wide-string-set!	wide
start2	start2
hash-table-entry-type:key/datum-weak	hash
condition-type:wrong-number-of-arguments	of
signal-condition	signal
integrate	integrate
list-ref	list
angle-sweep	angle-sweep
record-keyword-constructor	record
classes	classes
define-class	define
has	has
number-wt-type	wt
run-synchronous-subprocess	run
local	local
wt-tree/add	tree/add
flonum1	flonum1
call-with-input-file	input
strong-hash-table/constructor	strong
make-wt-tree	wt
start	start
acos	acos
guarantee-procedure-of-arity	of
make-trivial-subclass	make
encapsulate	encapsulate
pathname-new-device	device
operands	operands
bind-default-condition-handler	default
alternative	alternative
call-with-values	with
ephemeron-key	ephemeron
set-output-buffer-size	output
16.4.3	16.4.3
xml-unparsed-!entity	xml
dtd	dtd
unparsed	unparsed
instance-predicate	predicate
decoded-time/daylight-savings-time?	time/daylight
computed-emp-key	emp
chars	chars
bind-cell-contents!	bind
ascii	ascii
image	image
empty?	empty?
wide-string->string	string
structure	structure
xmlns	xmlns
define-method	method
user	user
stream-rest	rest
open-i/o-file	open
assq!	assq!
port/set-input-terminal-mode	mode
condition-type/error?	condition
fold-left	fold
set-record-type-unparser-method!	record
record-type-descriptor	type
*unparse	*unparse
denominator	denominator
list-tail	list
resource	resource
string-hash	hash
*default-pathname-defaults*	pathname
eq?	eq?
hash-table->alist	>alist
set-font	set
library	library
initial	initial
x-geometry-string	x
error:wrong-type-datum	datum
wt-tree/split<	tree/split<
rexp-word-edge	rexp
input-port?	port?
environment1	environment1
*default	*default
record-type-dispatch-tag	dispatch
6.6	6.6
output-port/fresh-line	port/fresh
file-writeable?	writeable?
open-wide-input-string	string
condition-type/field-names	names
im-x	im-x
set!	set!
k	k
call-with-temporary-file-pathname	call
with-output-to-string	output
15.7.3	15.7.3
not	not
hash-table-entry-type:key/datum-weak	weak
break-entry	entry
rb-tree	rb-tree
flonum-parser-fast?	parser
weak-hash-table/constructor	weak
set-output-buffer-size	size
vector1	vector1
upcase	upcase
input-port	input-port
make-xml-name	xml
14.12.1	14.12.1
vector-8b-find-previous-char	vector
port/input-blocking-mode	blocking
parser-buffer-pointer-index	pointer
host-address-any	any
buffered-input-chars	chars
wide-string	wide
16.2	16.2
output-port/write-substring	output
17.10.2	17.10.2
record-type-descriptor	descriptor
condition-type:wrong-type-datum	type:wrong
xml->wide-string	string
string->parser-buffer	>parser
free	free
n1	n1
y-bottom	y-bottom
condition-type/field-names	type/field
object-hash	object
load-option	option
6.3	6.3
use-value	use
cell?	cell?
rexp-string-end	string
get-parser-buffer-tail	get
list-tabulate	tabulate
emp?	emp?
make-key-ephemeral-eq-hash-table	eq
user-initial-environment	environment
with-output-to-truncated-string	string
local-decoded-time	time
slot-initpred	slot
properties	properties
split<	split<
10.5	10.5
time	time
char-bits-limit	char
wt-tree/subset?	tree/subset?
initial-size	initial-size
define-windows-type	define
on	on
x-geometry-string	geometry
draw-circle	circle
daylight	daylight
caller	caller
environment-assign!	assign!
save-bitmap	save
compile	compile
hash-table/clear!	hash
capture-syntactic-environment	capture
utf8-string-length	length
disk-save	disk
fourth	fourth
environment-parent	environment
set-border-width	border
error:file-operation-error	error:file
assq	assq
4.6	4.6
dib-set-pixels-unaligned	pixels
document	document
assigned?	assigned?
make-key-weak-eqv-hash-table	eqv
rb-tree/copy	tree/copy
17.3	17.3
ignore	ignore
y-key	y-key
association	association
write-dib	dib
make-key-ephemeral-eq-hash-table	make
convert	convert
windows-procedure	windows
built-in-dispatch-tags	in
primitive	primitive
thing	thing
compute-effective-method-procedure	compute
rb	rb
invoke-restart-interactively	restart
z	z
dib-width	dib
weak-hash-table/constructor	hash
decoded-time/day-of-week	of
find	find
universal	universal
rexp-not-word-char	rexp
copy-file	file
18.2.1	18.2.1
registers	registers
7.3	7.3
host-address-loopback	host
prompt-for-evaluated-expression	prompt
15.5.2	15.5.2
current-input-port	port
form	form
symbol-hash-mod	mod
hash-table-entry-type:datum-ephemeral	table
make-computed-method	method
environment-macro-names	environment
rb-tree/max	tree/max
save-editor-files	editor
type:datum	type:datum
port/set-input-blocking-mode	mode
string	string
current	current
char?	char?
match-parser-buffer-char-in-set	buffer
14.9.3	14.9.3
stream->list	>list
eqv-hash-mod	mod
procedure-arity-valid?	valid?
string-set!	set!
wild?	wild?
char-set=?	char
top-level-environment?	level
decoded	decoded
with-output-to-truncated-string	truncated
restarts	restarts
make-strong-eq-hash-table	eq
microcode-id/operating-system	microcode
11.4.3	11.4.3
entry	entry
report	report
string-trim	string
interaction	interaction
record-type-dispatch-tag	tag
add-generic-procedure-generator	procedure
hash-table-entry-type:datum-weak	type:datum
port/with-output-terminal-mode	mode
11.7.3	11.7.3
set-command-line-parser!	set
method?	method?
type:system	type:system
graphics-close	graphics
action	action
type?	type?
*unparser-string-length-limit*	length
list->stream	list
*random-state*	*random
specializer?	specializer?
handler	handler
fluid-let	let
links	links
string-hash	string
point	point
regexp	regexp
arg	arg
read-char-no-hang	hang
match-parser-buffer-char	parser
set-file-times!	times!
environment?	environment?
break-entry	break
condition-type:illegal-datum	condition
bit-string-append	append
graphics-set-coordinate-limits	graphics
graphics-set-coordinate-limits	coordinate
condition-type:no-applicable-methods	condition
condition-type:system-call-error	type:system
cd	cd
xcons	xcons
string->decoded-time	string
identifier2	identifier2
create-editor-args	args
char-ready?	char
input-port->parser-buffer	port
month	month
port-type?	type?
slot-initializer	slot
bind-condition-handler	handler
q	q
string->wide-string	string
global-decoded-time	decoded
output-line-translation	translation
procedure-arity	arity
string->number	>number
rexp-alternatives	rexp
set-hash-table/rehash-size!	table/rehash
define-syntax	syntax
graphics-flush	graphics
vector-8b-set!	8b
>ascii	>ascii
12.5	12.5
type:subprocess	type:subprocess
bit-string-move!	move!
string->number	string
set-hash-table/rehash-threshold!	set
of	of
delete!	delete!
command-line	command
map*	map*
rb-tree/datum-list	rb
target-filename	target-filename
match-parser-buffer-char	match
get-host-by-name	name
string-wt-type	type
parser-macros?	parser
ignore-reference-traps	reference
current-parser-macros	parser
wt-tree/min	tree/min
open-input-string	string
4.3.3	4.3.3
integer-floor	floor
char-set-members	members
method-specializers	method
make-key-ephemeral-eq-hash-table	hash
char-set?	set?
file-directory?	file
except-last-pair	except
create-editor-args	editor
ephemeron-datum	datum
5.6	5.6
synchronous	synchronous
contents	contents
min	min
date	date
delete-file-no-errors	file
dib-width	width
xml-name-prefix	name
find-tail	tail
integer	integer
stack	stack
day	day
file-attributes/change-time	time
condition-type:subprocess-signalled	condition
hash-table/rehash-size	size
17.4	17.4
specializers?	specializers?
standard	standard
hash-table/size	hash
1d-table/lookup	1d
file-attributes/n-links	attributes/n
bit-string-or	or
write-line	write
12.6.3	12.6.3
return	return
13.1	13.1
char-integer-limit	limit
rexp-alternatives	alternatives
10.1	10.1
number	number
x-close-all-displays	all
char->integer	>integer
graphics-device-coordinate-limits	graphics
pathname-as-directory	as
make-parser-macros	parser
x	x
char-code	char
open-wide-input-string	wide
car+cdr	car+cdr
17.9.2	17.9.2
*default-pathname-defaults*	*default
port/operation-names	port/operation
hash-table/put!	table/put!
bind-default-condition-handler	handler
run-shell-command	run
stream-cdr	cdr
2d-put!	put!
capture-syntactic-environment	environment
xml-external-id	id
right!	right!
call-with-binary-input-file	input
as	as
fresh-line	line
write-xml	xml
condition-type:no-applicable-methods	type:no
named	named
with-output-to-string	with
make-condition-type	make
error:wrong-number-of-arguments	of
cursor	cursor
call-with-current-continuation	continuation
call-with-current-continuation	with
cdr	cdr
system-clock	clock
slot-properties	slot
14.11.2	14.11.2
2.2	2.2
condition-type:not-loading	loading
draw-subimage	subimage
computed-emp?	emp?
dynamic-wind	wind
pathname-absolute?	absolute?
condition-type:subprocess-abnormal-termination	condition
char-set->scalar-values	values
make-apply-hook	hook
2.8	2.8
error:file	error:file
graphics	graphics
definable?	definable?
default	default
stream-head	head
14.9.5	14.9.5
invoke-restart	restart
class-precedence-list	precedence
capture	capture
strong-hash-table/constructor	table/constructor
create-editor	editor
11.1	11.1
define-structure	define
environment-bindings	environment
x-graphics/close-display	display
limit	limit
graphics-type-available?	graphics
make-key-weak-eqv-hash-table	make
host?	host?
bit-string-move!	string
attributes	attributes
file-access-time	time
offset	offset
bind-condition-handler	condition
hash-table/clean!	table/clean!
file-attributes/modification-time	attributes/modification
vector-ref	ref
type	type
unwrap-key	unwrap-key
make	make
epoch	epoch
microcode-id/operating-system-name	system
well-formed-scalar-values-list?	well
read-only	only
write	write
y-size	y
well-formed-scalar-values-list?	formed
directory-pathname	directory
system-library-pathname	pathname
!notation	!notation
match-parser-buffer-char-in-set	in
get	get
hash-table/rehash-threshold	table/rehash
trace-output-port	trace
file-access-time	file
re-match-extract	re
2.6	2.6
hash-table/clear!	table/clear!
edwin	edwin
read-char	char
discard-matched	discard
out	out
unadvise-entry	unadvise
hash-table-entry-type:key/datum-weak	table
hash-table-entry-type:key-ephemeral	hash
computed-emp?	computed
y-top	y-top
generic-procedure-generator-list	procedure
5.7.1	5.7.1
alist->wt-tree	>wt
make-graphics-device	make
alist	alist
parser-buffer?	parser
vector-seventh	vector
flo:=	flo:=
rexp-case-fold	case
unbreak-exit	unbreak
group	group
xml-name?	name?
condition-type:floating-point-underflow	underflow
make-procedure-arity	arity
output-port/x-size	size
position	position
generator!	generator!
drawing	drawing
graphics-bind-drawing-mode	graphics
alt	alt
rb-tree/max-datum	rb
condition-type:not-loading	condition
receive	receive
peek	peek
range	range
system-library-pathname	library
misc-3	misc-3
make-1d-table	1d
pointer!	pointer!
2d-get-alist-y	2d
split>	split>
y-size	size
wt-tree?	tree?
wt-tree/union-merge	merge
user-initial-environment	initial
reduce-right	right
image/fill-from-byte-vector	from
built-in-dispatch-tags	dispatch
map-window	map
make-bit-string	make
condition-type:simple-warning	condition
rexp->regexp	>regexp
string-prefix?	prefix?
get-parser-buffer-tail	tail
file-attributes/inode-number	number
x2	x2
x1	x1
matched	matched
1d-table?	1d
boolean/and	boolean/and
os/hostname	os/hostname
parent	parent
draw-image	image
call-with-values	call
optional	optional
shell-file-name	name
call-with-binary-input-file	binary
rexp-word-start	rexp
make-char	char
editor	editor
timings	timings
file-attributes/type	attributes/type
methods	methods
get-host-by-name	get
windows-procedure	procedure
run-shell-command	shell
buffered-input-chars	buffered
parser	parser
?	?
trace	trace
vector-copy	vector
set-window-name	set
address	address
class-direct-superclasses	direct
string-upper-case?	string
generic-procedure-arity	generic
set-background-color	background
wide-string	wide-string
check	check
>list	>list
with-output-to-truncated-string	with
host-address-any	host
conc-name	name
working-directory	directory
abs	abs
make-key-weak-eqv-hash-table	hash
get-host-name	get
make-generic-procedure	procedure
image/destroy	image/destroy
top	top
graphics-draw-text	text
target-bit-string	target-bit-string
constructor	constructor
define-load-option	define
tabulate	tabulate
slot-modifier-method	method
eqv	eqv
set-hash-table/rehash-threshold!	threshold!
eq	eq
3.3	3.3
15.2	15.2
with-output-to-string	to
>scalar	>scalar
call-with-current-continuation	call
>alist	>alist
xml->wide-string	>wide
and	and
6.7	6.7
port/input-terminal-mode	mode
discard-matched	matched
chars->char-set	set
record-type-class	record
class-slots	class
continuation?	continuation?
root	root
read	read
no-range-checks	no
flo:vector	flo:vector
environment-define-macro	define
get-parser-buffer-pointer	pointer
define-load-option	option
string-search-backward	string
8.3	8.3
times!	times!
stream-pair?	pair?
drawing-mode	drawing-mode
record-predicate	record
size!	size!
backward	backward
file-attributes/modification-time	time
macros	macros
strong	strong
if-found	if-found
integer-divide	integer
assign!	assign!
char-set-members	set
bound?	bound?
formed	formed
open-input-file	input
decoded-time/daylight-savings-time?	time?
fold-left	left
argument-command-line-parser	line
rexp-string-end	rexp
output-port?	port?
condition-type?	condition
14.12.4	14.12.4
slot-initpred-method	initpred
internal	internal
current-output-port	current
18.3.1	18.3.1
string2	string2
reduce-operator	reduce
store	store
write-xml-file	file
set-input-buffer-size	set
direct-slots	direct-slots
current-input-port	current
make-key-weak-eqv-hash-table	weak
14.8	14.8
bind-default-condition-handler	condition
operation	operation
make-decoded-time	make
del-assq	del
open-binary-input-file	open
procedure-arity-min	arity
make-key-weak-eqv-hash-table	table
delete-directory	directory
condition-type:floating-point-underflow	condition
5.4	5.4
graphics-draw-text	graphics
upper	upper
limits	limits
condition-type:wrong-number-of-arguments	condition
hash-table-entry-type:strong	table
rexp-not-word-edge	not
weak-set-cdr!	weak
read-char-no-hang	char
bit-string-length	string
xor!	xor!
parser-buffer-position-string	buffer
hostname	hostname
wt-tree-2	wt-tree-2
output-port/x-size	port/x
pathname1	pathname1
no-type-checks	no
tags	tags
identifier1	identifier1
null-xml-namespace-uri?	namespace
reference	reference
char-set-members	char
ignore-reference-traps	traps
computed-method?	method?
file-readable?	readable?
decoded-time->string	time
rexp-case-fold	rexp
1d-table/remove!	table/remove!
or	or
file-access-time	access
generalizations	generalizations
ignore-assignment-traps	assignment
environment-define	define
char1	char1
list-copy	list
open-output-string	output
procedure-of-arity?	of
height	height
interaction-i/o-port	i/o
condition?	condition?
hash-table/rehash-size	hash
invoke-restart-interactively	invoke
char-ready?	ready?
evaluated	evaluated
initialized	initialized
source-filename	source-filename
file-attributes/uid	attributes/uid
substring->parser-buffer	buffer
integrate-external	external
generic-procedure-name	procedure
pathname-as-directory	pathname
noise	noise
close-port	close
match-parser-buffer-char-in-set	match
bit-string-allocate	allocate
record-type-class	type
file	file
weak-car	weak
condition-type:wrong-type-datum	datum
12.4	12.4
string-match-forward	string
dib-set-pixels-unaligned	unaligned
device	device
ignore-errors	ignore
guarantee-dispatch-tag	guarantee
string-maximum-length	maximum
procedure-arity-max	max
current-output-port	port
error:wrong-number-of-arguments	number
random	random
system-global-environment	global
dynamic	dynamic
subvector-move-left!	left!
subvector-move-left!	subvector
re-match-extract	match
record-constructor	record
stream-pair?	stream
standard-unparser-method	standard
char-set->scalar-values	>scalar
17.7	17.7
fluid-let	fluid
initial-offset	offset
initialized?	initialized?
read-substring	read
bit-string-xor!	string
hash-table-entry-type:datum-ephemeral	ephemeral
directory-pathname-as-file	as
file-attributes/modes	attributes/modes
width	width
kernel32.dll	kernel32.dll
caar	caar
14.10	14.10
xml-name-string	string
direct-superclasses	direct-superclasses
use	use
4.3	4.3
condition-type:warning	type:warning
set-line-width	line
ascii-range->char-set	set
make-condition	make
computed-emp-key	computed
reduce-operator	operator
write-line	line
eq-hash-mod	eq
<object>	<object>
scalar-values->char-set	values
vector-8b-fill!	8b
11.7.2	11.7.2
generic-procedure-default-generator	default
reduce-right	reduce
zone?	zone?
search	search
number-wt-type	number
value?	value?
6.9	6.9
termination	termination
set-current-input-port!	set
block?	block?
>char	>char
x-graphics/close-display	x
symbol-hash	symbol
char-code	code
condition/report-string	condition/report
8.1	8.1
irritants	irritants
rexp-line-end	line
fast?	fast?
rexp-line-start	line
sequence	sequence
qname	qname
peek-char	char
dotted	dotted
byte	byte
port/with-output-terminal-mode	output
prompt-for-command-expression	command
find-module	find
redisplay-hook	redisplay
chars->char-set	chars
method-specializers	specializers
named-lambda	lambda
file-regular?	file
vector-fill!	fill!
read-xml-file	file
string-downcase	downcase
14.9.6	14.9.6
tree?	tree?
2d-get-alist-x	alist
condition-type/generalizations	condition
break-on-signals	signals
field-names	field-names
displays	displays
microcode-id/operating-system-variant	variant
prompt-for-expression	expression
find-module	module
rb-tree/lookup	tree/lookup
hash-table/for-each	each
string-set!	string
environment-assignable?	environment
xml-!notation	!notation
run-shell-command	command
w	w
flush	flush
interaction-i/o-port	port
port/set-input-blocking-mode	input
uri	uri
z1	z1
x-graphics/close-display	graphics/close
measure	measure
re-string-search-forward	string
4.7.1	4.7.1
start1	start1
integrate-external	integrate
4.3.2	4.3.2
rexp-compile	compile
rehash	rehash
sexp	sexp
bit-string-fill!	fill!
define-record-type	record
condition-type:subprocess-stopped	type:subprocess
condition-accessor	condition
14.9.1	14.9.1
4.3.5	4.3.5
set-gc-notification!	gc
vector-binary-search	search
find-restart	restart
open-wide-input-string	input
weak-pair?	pair?
match	match
prefix	prefix
*unparser-string-length-limit*	string
last-pair	last
pexp	pexp
environment-lookup	lookup
arity?	arity?
1d-table/lookup	table/lookup
method-procedure	method
directory-read	read
input-port->parser-buffer	>parser
rexp-string-end	end
close-all-open-files	close
file-directory?	directory?
sc-macro-transformer	transformer
standard-warning-handler	standard
2.9	2.9
method-applicable?	method
weak-pair/car?	pair/car?
bit-string-length	bit
fix:and	fix:and
apply-hook-procedure	hook
max	max
eqv?	eqv?
buffer	buffer
error:file-operation-error	operation
hash-table-entry-type:key-ephemeral	table
deletor	deletor
available?	available?
set-generic-procedure-default-generator!	procedure
string-head	head
>wt	>wt
general-car-cdr	car
set-command-line-parser!	command
decoded-time/day-of-week	time/day
lookup	lookup
char->ascii	char
files	files
hash-table/get	table/get
gc-flip	flip
subset?	subset?
re-string-search-forward	re
wt-tree/set-equal?	equal?
make-xml-name	make
open-dib	dib
graphics-set-coordinate-limits	limits
standard-warning-hook	standard
fluid	fluid
vector->list	>list
output-port/write-substring	substring
file-eq?	eq?
string->file-time	>file
untrace-entry	untrace
file-access	access
parser-buffer-pointer-index	parser
environment-assignable?	assignable?
set-current-input-port!	current
port/set-input-terminal-mode	port/set
method-applicable?	applicable?
wt-tree/set-equal?	wt
char*	char*
fix:zero?	fix:zero?
type:derived	type:derived
font-structure	font
dispatch-tag?	dispatch
built	built
microcode-id/operating-system	system
if-not-found	if-not-found
set-parser-buffer-pointer!	pointer!
generic-procedure-name	name
thunk	thunk
hash-table-entry-type:key/datum-weak	entry
open-input-string	open
radix*	radix*
argument-command-line-parser	argument
extra!	extra!
file-length	length
rb-tree/max-datum	tree/max
unbreak	unbreak
string-ref	ref
record-type-dispatch-tag	type
well	well
let	let
reverse-string	string
<exact>	<exact>
guarantee-procedure-of-arity	procedure
regexp-group	regexp
singleton-wt-tree	tree
clean!	clean!
hash-table/size	table/size
generic-procedure-default-generator	generator
ignore-errors	errors
divide	divide
rexp-not-syntax-char	not
error:wrong-type-datum	type
vector-map	vector
init-file-pathname	file
2.11.4	2.11.4
buffered	buffered
with-output-to-truncated-string	to
fill!	fill!
misc-2	misc-2
17.9.3	17.9.3
flush-output	output
bit-string-allocate	bit
line	line
hash-table/for-each	table/for
wind	wind
real-time-clock	time
stream-cdr	stream
third	third
effector	effector
char-integer-limit	integer
string-upper-case?	case?
name->char	>char
vector-binary-search	binary
>universal	>universal
hard-link-file	file
slot-initpred-method	slot
vector-tail	vector
integer-divide	divide
6.11	6.11
capitalize	capitalize
hash-table-entry-type:key-ephemeral	ephemeral
rexp-syntax-char	char
error:wrong-type-argument	argument
record	record
append	append
14.11.1	14.11.1
rb-tree/max-datum	datum
content-type	content-type
slot-initial-value?	slot
file-attributes/access-time	file
set-window-name	window
graphics-bind-drawing-mode	bind
11.4.1	11.4.1
draw-subimage	draw
xml-!element	!element
service	service
display	display
move-window	window
dib-height	height
sc-macro-transformer	sc
condition-type:no-applicable-methods	applicable
*unparse-with-maximum-readability?*	maximum
list-head	list
2d-get-alist-x	x
8b	8b
make-syntactic-closure	make
parser-buffer-position-string	position
merge	merge
write-char	write
set-port/state!	port/state!
1.4	1.4
xml-element	xml
prompt-for-evaluated-expression	for
char-bits-limit	limit
vector-fifth	fifth
restart	restart
*unparser-list-depth-limit*	limit*
xml->string	>string
rexp-word-end	end
repl	repl
1d-table?	table?
delete-member-procedure	procedure
modifier	modifier
get-host-name	host
list-deletor	deletor
stream-length	stream
capture-syntactic-environment	syntactic
set-current-input-port!	port!
eq-hash-mod	hash
rexp	rexp
flo:finite?	flo:finite?
flonum2	flonum2
definitions	definitions
hook	hook
decoded-time->string	decoded
bytes	bytes
vector-second	vector
9.4	9.4
conc	conc
host-name	host-name
get-host-name	name
condition-type:subprocess-signalled	type:subprocess
values	values
rb-tree/equal?	rb
>integer	>integer
file-attributes	attributes
condition-type:not-loading	type:not
substring?	substring?
define	define
call	call
define-structure	structure
template	template
init	init
vector-fourth	vector
input	input
pathname-wild?	pathname
error:bad	error:bad
record-constructor	constructor
stream-map	map
file-attributes/change-time	file
make-directory	make
4.5	4.5
pe	pe
output-port/fresh-line	output
computed-emp	computed-emp
type:floating	type:floating
procedure-arity-valid?	arity
intern-soft	intern
built-in-dispatch-tags	built
graphics-bind-drawing-mode	mode
break	break
on?	on?
signalled	signalled
rexp-not-syntax-char	syntax
seventh	seventh
discard	discard
ge	ge
rb-tree/min-pair	rb
vector-8b-find-previous-char	previous
generic-procedure?	procedure?
newline	newline
generic-procedure-name	generic
notification!	notification!
dotted-list?	dotted
tcp-server-connection-accept	tcp
13.3	13.3
string-maximum-length	string
xml	xml
environment-define-macro	environment
condition-type:wrong-type-datum	condition
global-decoded-time	global
class-precedence-list	list
4.2.2	4.2.2
slot-initial-value	initial
uninterned	uninterned
tcp	tcp
port/output-terminal-mode	terminal
15.1.1	15.1.1
make-trivial-subclass	subclass
area	area
file-writeable?	file
with-output-to-string	string
rexp-group	group
hash-table-entry-type:datum-ephemeral	type:datum
record?	record?
<number>	<number>
record-predicate	predicate
id	id
signal	signal
xml-qname-local	xml
port/set-output-terminal-mode	port/set
initpred	initpred
string->uninterned-symbol	symbol
simple	simple
bit-string-and	string
equal-hash-mod	equal
untrace	untrace
graphics-move-cursor	graphics
rexp-not-word-char	word
make-1d-table	table
equal	equal
flo:random-unit	unit
x-geometry-string	string
prompt-for-command-expression	expression
error:divide-by-zero	zero
vector-third	third
standard-warning-handler	handler
read-char-no-hang	no
wt-tree/size	wt
find-color	find
host	host
string-capitalize	string
uid	uid
condition-type:error	condition
record-type-descriptor	record
port-type	port-type
substring-move-left!	left!
socket	socket
xml-name->symbol	xml
environment-macro-names	macro
vector-8b-fill!	fill!
bitmap-from-dib	bitmap
set-hash-table/rehash-threshold!	hash
canonical	canonical
decoded-time/date-string	decoded
6.10	6.10
andc!	andc!
define-syntax	define
depth	depth
no	no
shell	shell
z2	z2
apply-hook-procedure	apply
ascii->char	ascii
5.7	5.7
class	class
5.3	5.3
top-level-environment?	environment?
wide-string?	wide
key	key
port/operation	port/operation
rb-tree/min-datum	rb
pathname2	pathname2
eq-hash	hash
bit-string=?	bit
char->name	>name
previous	previous
cons	cons
open	open
key<?	key<?
read-char-no-hang	read
compute-effective-method-procedure	procedure
conc-name	conc
process-time-clock	process
parser-buffer-position-string	string
break-on-signals	on
close-all-open-files	files
microcode-id/operating-system-name	id/operating
bit-string-andc!	andc!
record-type?	record
>string	>string
standard-warning-hook	hook
xml-external-id	xml
invoke-restart-interactively	interactively
type:serious	type:serious
threshold	threshold
car!	car!
draw-ellipse	draw
list?	list?
wt-tree/union-merge	wt
char-bits-limit	bits
im-y	im-y
bit-string=?	string=?
bit-string-append	string
generic-procedure-generator-list	generator
match-parser-buffer-char	buffer
output-port/flush-output	port/flush
read-parser-buffer-char	read
save	save
condition-type:derived-file-error	condition
wide-string-length	wide
vector-grow	grow
ellipse	ellipse
variables	variables
directory-pathname	pathname
>bit	>bit
type:simple	type:simple
rexp-string-start	string
muffle-warning	warning
match-parser-buffer-char	char
hash	hash
tag?	tag?
advise	advise
gc-flip	gc
put!	put!
6.8.2	6.8.2
bit-substring	bit
prompt-for-expression	prompt
wide-string	string
procedure-arity-min	min
string-wt-type	wt
left!	left!
compute-effective-method-procedure	effective
format-error-message	error
temporary	temporary
add-generic-procedure-generator	add
char-set	set
condition-type:system-call-error	call
soft-link-file	file
rexp-string-start	rexp
microcode-id/operating-system-variant	system
7.8	7.8
pathname?	pathname?
rexp-word-char	char
1.3	1.3
class-slot	slot
decoded-time	decoded-time
record-class	record
wt-tree/delete-min	min
environment-bound-names	names
record-modifier	modifier
12.6.2	12.6.2
make-key-weak-eqv-hash-table	key
initialization	initialization
record-modifier	record
rexp*	rexp*
call-with-input-file	call
parent?	parent?
alist?	alist?
call-with-binary-input-file	with
condition-type:subprocess-stopped	stopped
char2	char2
slot-modifier-method	slot
>vector	>vector
coordinate	coordinate
decoded-time/date-string	time/date
items	items
rexp-optional	optional
object-class	object
signals	signals
log	log
cdr!	cdr!
file-exists?	file
make-strong-eq-hash-table	make
file-access	file
8.2	8.2
code	code
6.1	6.1
15.6	15.6
geometry	geometry
re-match-extract	extract
dispatch	dispatch
char-set=?	set=?
generic-procedure-generator-list	generic
every	every
advise-exit	advise
level	level
slot-accessor-method	accessor
make-strong-eq-hash-table	hash
make-ephemeron	ephemeron
decoded-time/time-string	decoded
12.1	12.1
well-formed-scalar-values-list?	values
alist->wt-tree	tree
rexp-word-edge	edge
valid?	valid?
bit-string-move!	bit
11.7.4	11.7.4
vector-fifth	vector
->pathname	>pathname
port/input-blocking-mode	port/input
standard-error-handler	standard
rexp-not-word-edge	rexp
make-class	class
port/output-terminal-mode	mode
graphics-close	close
make-apply-hook	apply
5.1	5.1
type:not	type:not
condition-type:subprocess-signalled	signalled
prompt	prompt
wt	wt
condition-type:serious-condition	condition
string-ref	string
input-line-translation	line
gc	gc
weak-pair/car?	weak
make-key-weak-eq-hash-table	eq
list->vector	list
output-port/x-size	output
bkpt	bkpt
wt-tree/intersection	wt
re	re
record-accessor	accessor
with-pointer	with
3.1	3.1
make-eof-object	object
!entity	!entity
head	head
rb-tree->alist	>alist
vector-8b-fill!	vector
stack-sampler:debug-internal-errors?	sampler:debug
define-color	define
procedure	procedure
syntax-type	syntax-type
>symbol	>symbol
readability?*	readability?*
run-synchronous-subprocess	synchronous
internal-time/ticks->seconds	time/ticks
read-char	read
real-time-clock	clock
chars-remaining	remaining
rexp-not-syntax-char	rexp
environment-has-parent?	has
slot-modifier-method	modifier
apply-hook	apply-hook
symbol	symbol
string?	string?
environment2	environment2
none	none
real	real
with-current-parser-macros	current
consequent	consequent
open-tcp-stream-socket	tcp
wt-tree/delete-min	tree/delete
13.2	13.2
dynamic-wind	dynamic
wt-tree/difference	wt
port/input-blocking-mode	mode
modes!	modes!
string-length	string
min!	min!
method	method
record-type?	type?
open-input-string	input
directory-pathname-as-file	directory
char->name	char
xml-element	element
round	round
field-plist	field-plist
string-downcase	string
output-port	output-port
well-formed-scalar-values-list?	scalar
hard-link-file	hard
instance	instance
global-parser-macros	macros
hash-table/lookup	table/lookup
wt-tree/intersection	tree/intersection
call-with-values	values
trace-output-port	output
set-command-line-parser!	line
environment-define-macro	macro
fix:fixnum?	fix:fixnum?
apply	apply
make-ephemeron	make
set-record-type-unparser-method!	set
wt-tree/size	tree/size
symbol-hash-mod	hash
1.1	1.1
zero	zero
rb-tree-2	rb-tree-2
datum=?	datum=?
vector-third	vector
access-condition	condition
apropos	apropos
call-with-output-file	call
string<?	string<?
guarantee-port	port
set-entity-extra!	entity
host-address-loopback	loopback
condition-type:illegal-datum	datum
decoded-time/time-string	time/time
vector-8b-set!	set!
irritant	irritant
signed-integer->bit-string	signed
bits	bits
ready?	ready?
14.5	14.5
xml->string	xml
user-homedir-pathname	pathname
get-parser-buffer-tail	parser
make-parser-macros	macros
ephemeron-key	key
points	points
xml-name	xml-name
error:bad-range-argument	argument
set?	set?
enumerate-graphics-types	graphics
tree-type	tree-type
9.2	9.2
command-line	line
entity-procedure	entity
output-port?	output
string->wide-string	>wide
condition-type:wrong-number-of-arguments	arguments
x-left	x-left
toggle-gc-notification!	gc
keyword	keyword
make-rb-tree	make
vector-length	length
blocking	blocking
buffered-output-chars	output
make-computed-method	make
threshold!	threshold!
set-file-times!	file
condition-type:simple-warning	type:simple
operand	operand
make-rb-tree	tree
dib-set-pixels-unaligned	dib
syntactic	syntactic
define-generic	define
rb-tree-1	rb-tree-1
char-upcase	char
char-set	char
rb-tree/min-datum	datum
system-clock	system
muffle	muffle
make-computed-emp	make
rexp-word-start	word
second	second
*unparser-list-depth-limit*	list
list-head	head
closure	closure
cons*	cons*
2	2
internal-time/ticks->seconds	internal
wt-tree/empty?	wt
3.1.4	3.1.4
null?	null?
wt-tree/subset?	wt
directory	directory
output-port/write-char	port/write
decoded-time/daylight-savings-time?	savings
environment-define	environment
time-zone?	zone?
ignore-assignment-traps	ignore
generator	generator
input-port-type?	input
6.8.1	6.8.1
loopback	loopback
del-assq!	del
list1	list1
prompt-for-expression	for
rehash-after-gc?	rehash-after-gc?
11.6	11.6
call-with-binary-input-file	call
filename2	filename2
procedure-arity	procedure
15.5.1	15.5.1
entity	entity
string-tail	tail
output-line-translation	line
global-decoded-time	time
ephemeron-datum	ephemeron
guarantee-procedure-of-arity	arity
*unparse-with-maximum-readability?*	*unparse
weak-set-car!	weak
no-range-checks	checks
buffer?	buffer?
4.2	4.2
scalar-values->char-set	set
fixnum	fixnum
option	option
hash-table-entry-type:key-ephemeral	entry
entity-procedure	procedure
method!	method!
condition/continuation	condition/continuation
condition-type:derived-port-error	port
windows	windows
string-replace	replace
peek-parser-buffer-char	peek
list-tail	tail
specializers	specializers
boolean	boolean
port?	port?
promise	promise
condition-type:derived-port-error	error
make-directory	directory
vector-map	map
for-each	each
bitmap-from-dib	from
set-border-width	set
open-wide-output-string	string
wt-tree/delete-min!	wt
allocate	allocate
vector	vector
->pathname	
<method>	<method>
system-library-directory-pathname	directory
set-current-parser-macros!	parser
hash-table-entry-type:datum-ephemeral	entry
set-line-width	width
xml-!attlist	xml
hash-table-entry-type:datum-weak	hash
write-char	char
delete	delete
7.4	7.4
hash-table/constructor	table/constructor
port/with-input-blocking-mode	mode
readable?	readable?
hash-table/clean!	hash
alist->wt-tree	alist
load-bitmap	bitmap
pair	pair
condition-predicate	condition
for	for
store-value	value
*parser-canonicalize-symbols?*	symbols?*
integrate-operator	operator
number-wt-type	type
eqv-hash-mod	eqv
time?	time?
condition-type:serious-condition	type:serious
system-library-directory-pathname	library
interactively	interactively
intern-soft	soft
condition-type:subprocess-abnormal-termination	termination
multiple?	multiple?
draw-arc	draw
condition-type:subprocess-stopped	condition
bind-cell-contents!	cell
trivial	trivial
parser-buffer-ref	buffer
assigned	assigned
purify	purify
simple-command-line-parser	parser
type:no	type:no
hash-table	hash-table
open-tcp-stream-socket	stream
uri?	uri?
output-line-translation	output
loading	loading
error:derived-file	file
environment-definable?	definable?
with-output-to-truncated-string	output
15.5.5	15.5.5
canonicalize	canonicalize
port-type/operation	type/operation
set-background-color	set
rexp-sequence	sequence
all	all
revert	revert
list2	list2
rb-tree/lookup	rb
initializer	initializer
read-xml	xml
rexp-word-end	word
use-value	value
procedure-arity-max	arity
set-current-input-port!	input
hash-table-entry-type:datum-weak	table
computed-method?	computed
graphics-operation	operation
4.8	4.8
graphics-device-coordinate-limits	limits
input-port?	input
decoded-time/day-of-week	decoded
error:wrong-type-argument	type
parser-buffer-position-string	parser
make-initialized-vector	vector
compute-effective-method-procedure	method
hash-table/for-each	hash
store-value	store
underflow	underflow
substring->list	substring
condition-predicate	predicate
handle	handle
mode	mode
del-assq!	assq!
1d-table	1d-table
16.5.2	16.5.2
condition-type:datum-out-of-range	condition
make-record-type	make
error:derived-file	error:derived
hash-table?	table?
names	names
move-window	move
port/type	port/type
ascii-range->char-set	range
hash-table?	hash
signed-integer->bit-string	integer
lambda	lambda
record-type-name	name
output-port/write-substring	port/write
bit-string-allocate	string
open-dib	open
draw	draw
=	=
except-last-pair	pair
bit-string->unsigned-integer	bit
error:wrong	error:wrong
decoded-time/time-string	string
effective	effective
slot-initialized?	initialized?
*unparser-list-depth-limit*	*unparser
read-only	read
make-condition	condition
read-string	read
wt-tree/delete-min	wt
i/o-port-type?	type?
tree	tree
call-with-temporary-file-pathname	with
draw-arc	arc
string->uninterned-symbol	string
assignment	assignment
with-timings	timings
generic-procedure-generator-list	list
pathname-absolute?	pathname
transformer	transformer
>=	>=
port/set-input-terminal-mode	input
string=?	string=?
type:divide	type:divide
unicode-char?	char?
make-string-hash-table	hash
set-background-color	color
string-head	string
body	body
set-generic-procedure-default-generator!	generator!
resize-window	window
substring->parser-buffer	>parser
xml-dtd	xml
vector-grow	vector
make-trivial-subclass	trivial
port/set-input-blocking-mode	port/set
member?	member?
>name	>name
standard-error-handler	error
get-parser-buffer-pointer	buffer
make-record-type	record
truncated	truncated
microcode	microcode
computed-emp-key	key
condition-type:divide-by-zero	condition
14.2	14.2
wide-string-set!	string
let-syntax	let
condition-type:warning	condition
string-replace	string
make-initialized-vector	make
local-host	host
unicode-scalar-value?	unicode
string-suffix?	suffix?
intersection	intersection
case?	case?
stream-length	length
server	server
map-window	window
current-parser-macros	current
slot-property	slot
10.7.1	10.7.1
