199	object.to_enum enumerator.new object.enum_for
code	code http result string
multicast_interface	index packets send multicast ipv6 interface
main_page	index used name initial module class file specified first display encounter page
activated	specification activated prior gemspec true conflict
script_name	cgi variable name script
month	component date/time return value specified
document_self	ourselves? document
prefix	search expanded set name object appended list inspected next item prefix objects output valid notifier
ssl_verify_mode	used remote verify openssl value connection mode https
90	thread.raise thread.kill thread.handle_interrupt thread.pending_interrupt? thread.exit thread.terminate
query	query returns component uri
coverage_level	report output coverage level
ptr	function address
row	compare used equality format internal data
compact	compact use set attempt space little possible formatter true
max_age	age cookie maximum
bin_dir	directory executables gem’s installed
ubound	optional
base_uri	uri relative returns base data uris
show_hash	hyperlinked include show references? instance names characters front ‘#’ method
umask	returns umask
161	io.scanf kernel.scanf
soft_missing	errors silent missing stop dependency dependencies treat don’t
install_lock	process certain aspects thread-safe install
development_shallow	development set want considered direct immediate dependencies install true
column_size	returns number columns
homepage	url page usage home gem’s spec
spec	use set package specification activated extracted :specification build resolver sets uninstalled gem uninstall_gem
cutime	time children user cpu
labels	items labels document
string	readable smtp content human text reply response
hprecision	integers use e scientific notation precision xey meters 2 values using horizontal type ssize value/2
set_banner	preceding banner heading summary
tagging	used encoding may implicitly hint value explicitly either :implicit :explicit setting
utime	time user cpu
new_name	aliased method’s name
level	logging severity level logged leveled object messages log-level heading current returns threshold e logger create compatibility notifier log
force_update	newer scan sources flag file true
list	switches list string summary
in_files	files found context
list_type	list stack types
dir	working current certificates returns stored directory trusted
quiet?	quiet’ mode set/unset
cookies	pairs hash get cookie-name=>cookie request cookies response parsed
force	available documentation? installation requiring force rubygems/installer_test_case
198	json.parse! json.fast_generate json.parse json.generate json.pretty_generate
p_pass	opt hash optional proxy pass
195	readline.completion_proc readline.completer_quote_characters
194	:pointer.to_str fiddle :pointer.to_s
197	:instructionsequence.path :instructionsequence.label :instructionsequence.base_label :instructionsequence.new :instructionsequence.of :instructionsequence.inspect :instructionsequence.compile rubyvm :instructionsequence.absolute_path :instructionsequence.compile_option :instructionsequence.compile_file
implicit_end	implicit? document end
191	gem.pre_reset gem.post_reset
sync	“sync mode” sslsocket
193	string.sub string.sub!
sent_size	bytes response sent
217	:toplevel.search_record rdoc :classmodule.search_record :methodattr.search_record
total_bytes	total bytes file
notifiers	notifiers group list
port	returns target service packets uri smtp number send server host component connect authorities query naming ringfinger port registry
index	matching search used element replace parameter find
errors	gems exception errors remote attempting specifications resolving contributed searching encountered fetching may specfetcher resolution find gem
addr	server socket address
opaque	returns part uri opaque
abi	function abi
enclosure_dependencies	depend missing upon dependencies #missing_dependencies enclosing classes class
gem_path	path file string gem
4	:codeobject.suppressed? :codeobject.suppress rdoc
children	node children
version	loc 00 record always could value yaml returns version cookie found document gem’s specification gem
template	generating used name rdoc template output
aliases	array class/module method/attribute names aliases
metadata	settable hash consumers extra may requiring holds update rubygems :attr_accessor authors without codeobject arbitrary useful software data gem metadata
body	body string io-like may object responds read readpartial
args	closure file object list supplied arguments ffi config
hash	arrays array hash either
exchange	host mx
108	net :smtp.start :smtp.new :smtp.debug_output=
109	:converter.primitive_convert :converter.convert :converter.last_error encoding
rdoc_dir	files name receive html directory output
address	run name ip ipv6 smtp resolv server aaaa raw host services connect dns address :ipv6 :ipv4 string ipv4
102	bignum.modulo fixnum.modulo numeric.modulo fixnum.% numeric.div bignum.%
path	lock reads file array gems paths writes returns location store xpath string component cookie path gem search look deprecated request uri specific applies
prerelease	gems force allows dependency dependencies prerelease allow requests true matching match
101	:scalar.new :handler.scalar psych :emitter.scalar :nodes
106	optparse.ver optionparser.ver
implicit	sequence started mapping? implicitly implicitly? created? document implicit
decode_content	set false accept-encoding contain request header user sets true automatically
105	webrick :basiclog.info? :basiclog.new
security_policy	available used package verifying requiring policy security contents rubygems/installer_test_case
39	:paths.path rdoc :ri :paths.raw_path
38	array.rindex array.find_index array.index
14	optionparser.with optparse.with
33	:codeobject.ignored? rdoc :codeobject.ignore
items	items list
31	readline.output readline.input
30	array.bsearch array.bsearch_index
37	thread.wakeup :mutex.sleep thread.run thread
36	time.to_a time.gm time.utc
35	net :imap.uid_search :imap.uid_thread :imap.thread
error?	whether failed examine processing option
cert	:x509 certificate object openssl client context sets :certificate
expire	use name seconds primary server time refreshing data secondary
auto_indent_mode	default irb either
indentation	integer greater 0
sdone	style short hash keyed already summarized options
verify_callback	additional certificate certification verify server callback verification sets
options	used additional rendering instantiated list overrides rdoc :installer instance directives gem passed :options command options filled
secure	false secure cookie? cookie true otherwise
family	ip returns family address
env_shebang	available requiring rubygems/installer_test_case
176	openssl :hmac.new :hmac.hexdigest
89	net :imap.move :imap.uid_move
total	cutime + cstime stime time total utime
load_default_options	#load false :quirks_mode default global method :allow_nan :max_nesting true options
request_time	request received local time
to	string url << destination primary e-mail address output method must
ldone	style already hash long keyed summarized options
175	kernel.rand random.rand
session_get_cb	invoked proposed could cache client callback session internal found server server’s
handler	handler events called
6	tsort.each_strongly_connected_component_from tsort.tsort_each_node
msg	message http result sent server
specification_provider	used requirements @return versions process specification specifications etc specificationprovider dependencies provider resolution knows
type	list’s loaded datastore type ri special
display_thread_id	thread trace id defaults output true display
minor	version protocol number minor
raw_header	raw request header
generator_options	loaded options generator
digits	digits number significant fixnum
visibility	minimum visibility method current private protected constant’s context documented public
99	observable.notify_observers observable.add_observer observable.changed?
98	:constant.marshal_dump rdoc :constant.marshal_load
from_path	relative path document links
normalized	attribute normalized value
ca_file	containing certificate certification ca format pem-format pem file sets path
91	:tuplespaceproxy.notify :tuplespace.notify rinda
indent	indentation prefix indent indented @summary_indent ignored lines deprecated indents number summary current amount spaces characters summarized output integer defaults string
93	gdbm.replace gdbm.update
92	string.unicode_normalize! string.unicode_normalized?
95	:streamlistener.tag_start rexml :streamlistener.tag_end
94	:converter.destination_encoding :converter.source_encoding :converter.new encoding
97	threadgroup.enclosed? threadgroup.enclose
96	:parent.replace_child rexml :child.replace_with
hour	component date/time return value specified
scalar	raw size
request	activation request parent
longitude	prime loc thousandths unsigned longitude 2**31 32bit second arc integer meridian
column	column encountered error
protectable	would turns processing character processed front normally \
minimum	used seconds number minimum values ttl rrs
v	string
root	node built whether vertex documentation tree generated source returns boolean considered root @return
153	io.readpartial io.sysread
prompt	associated irb prompt method input
gem_data	file gem string contents
attribute	attribute
rdoc_files	files included generation list rdoc
expanded_name	object set name valid
tag	associated name sequence optional tag number value mapping asn1data one representing
238	array.collect! array.collect array.map array.map!
235	unixserver.accept_nonblock tcpserver.accept basicsocket.recv_nonblock unixserver.accept socket.recvfrom_nonblock tcpserver.accept_nonblock socket.accept_nonblock socket.sysaccept udpsocket.recvfrom_nonblock socket.accept
234	:backtrace :location.path :location.absolute_path thread
exclude	files excluded pattern file exclude matching
serial	file version number zone
tmp_dh_callback	callback invoked parameters dh required
230	struct.values_at enumerable.reject enumerable.select array.delete_if array.reject array.select struct.select array.values_at enumerable.find_all array.reject!
231	:toplevel.== rdoc :toplevel.hash
232	:gzipwriter.flush :inflate.inflate :deflate.flush zlib :deflate.deflate zlib.inflate :inflate.set_dictionary zlib.deflate
233	optparse.base optparse.on_head optparse.top optionparser.make_switch optparse.make_switch optionparser.on_head optparse.on optparse.on_tail optionparser.on_tail optionparser.top optionparser.on optionparser.base
absolute_name	name file absolute
237	:specification.license :specification.licenses= :specification.licenses gem
ignore_eof	whether ignored ^d control-d
set_summary_width	width portion list option summary
charset	output html character-set
1	io.lineno io.gets
file_output	return string writing file instead false generate methods
155	:importer.import_function :importer.import_symbol fiddle :compositehandler.sym
installed_gems	gems list installed install alphabetic order
config	drbserver cgi configuration response server
client_cert	request client http certificate
bindir	path executable gem scripts
static_path	directory files copy static
146	:generic.hostname= uri :generic.set_host
client_ca	certificates array client sent certificate
144	process.waitpid2 process.wait2
145	:ssl :sslcontext.ciphers :cipher.new openssl
142	:buffering.read_nonblock :buffering.write_nonblock openssl
description	detailed description long summary excessively gem
140	kernel.set_trace_func tracepoint.defined_class thread.set_trace_func thread.add_trace_func
modsort	generator modules list classes sorted displayed
148	getoptlong.each getoptlong.set_options getoptlong.get
3	:client.multicall_async xmlrpc :client.multicall
accept_language	header accept-language value
use_readline	whether readline enabled
echo?	whether output return value echo
data	generic resource data
response	caused response error
constants	defined constants
rdoc_version	loaded version rdoc
short	map style short actual option switches switch objects
tag_class	asn1data symbol tag representing class
121	:document.new rexml :treebuilder.start_document :handler.start_document :emitter.start_document psych :treebuilder.end_document
external_id	given referenced name doctype dtd #external_id
document_children	children? document
element	xpath search string attribute element belongs context child integer path optional must
num_files	files found total number
123	array.first array.last
coverage_report	report undocumented true files
paragraph_limit	many cut input paragraphs
last_value	last return statement value evaluated
include_path	files search directories file included path find
namespaces	given referenced hash name namespace doctype supplied dtd mapping #external_id defines
tag_maker	none
resolver_ui	used @return process communicate back module ui user resolution feedback knows
major	major version protocol number
133	encoding.default_internal io.read kernel.select string.encode io.select kernel.open io.open io.new io.write_nonblock string.encode! file.open file.new io.read_nonblock encoding.default_external
132	pstore.commit pstore.roots pstore.transaction pstore.fetch pstore.[]= pstore.delete pstore.root? pstore.[] pstore.abort
broadcast_list	addresses list packets send query ringfinger
130	drb.to_id drb.to_obj drb.front drb.current_server
137	:row.fields :row.index csv :row.[]= :row.delete
136	:generatormethods :generator :string.to_json_raw_object json :ext :string.to_json_raw
135	:unsatisfiabledependencyerror.new :testcase.dependency_request gem
ttl	live resource remaining time
system_path	array path returns command search
original_requested	explicitly array dependencies @return required
138	stringscanner.get_byte stringscanner.getbyte
singleton_classes	c singleton maps classes names variable ruby
24	shell.default_system_path shell.default_system_path=
sharing_detection	sharing flag value detection returns boolean
style	style sequence mapping used scalar
27	socket.udp_server_recv socket.udp_server_loop
20	:buffering.each openssl :buffering.readlines
skip_gems	gems skip hash resolution
external_encoding	set parser encoding
23	:dependencyrequest.match? :dependencyrequest.matches_spec? :resolver gem
http_version	http supported request server version response
shift_size	shift_age maximum number) applies logfile size
28	string.=== string.str
29	:specification.author gem :specification.author=
coordinates	raw coordinates
session_remove_cb	invoked cache callback session removed internal
platform	platform works gem
npn_select_cb	needs invoked protocol list server callback client sent side select
main	available file used workspace level top rdoc also context top-level irb main name
182	:imap.status :imap.select :imap.capability :imap.subscribe :imap.lsub :imap.delete :imap.unsubscribe :imap.append :imap.add_authenticator :imap.rename net :imap.create :imap.examine :imap.authenticate :imap.login
accept_charset	cgi set return accept-charset header character accept instance value
fragment	fragment returns component uri
primary	contain #lookup_ring_any advertised tuplespace called first
root?	@return whether vertex considered boolean root
build_args	available requiring rubygems/installer_test_case
front	front drbserver object
outgoing_edges	{edge#origin} @return self {#graph} [array<edge>] edges
day	component date/time return value specified
84	stringscanner.check_until stringscanner.exist?
request_uri	response request parsed uri
unmatched_alias_lists	haven’t resolved hash => method/attribute old_name yet aliases
alpn_protocols	enumerable strings
esmtp	whether esmtp use set
display_thread_id?	thread trace id defaults output true display
show_all	show documentation module method following class
refresh	often seconds primary server updates secondary check name
228	process.getrlimit process.spawn kernel.exec io.popen kernel.spawn process.exec
ignore_eof?	whether ignored ^d control-d
mode	current access indexing mode iteration
timeout	corresponding maximum numeric return second session value attributes lifetime
debug	debugging exception information backtrace __file__ raised display remain enables true event
session_new_cb	session callback negotiated invoked new
base_dir	files full --op generate combined path options
development	development use set considered allows enabling/disabling dependencies true
domain	domain cookie string applies
multicast_hops	hops list packets maximum number broadcast multicast address using sent
179	basicsocket.getpeername basicsocket.remote_address
weight	selection mechanism server
147	benchmark.measure benchmark.bmbm benchmark.benchmark
summary_width	width portion list option summary
dont_rename_initialize	rename ::new don’t #initialize
dump_default_options	#dump :quirks_mode default global method :allow_nan false :max_nesting true options
88	:httpresponse.read_body net :http.request_get :http.request_post :http.request
meta	represents returns hash fields header
math?	whether returns enabled mode bc
year	component date/time return value specified
82	:tms.add :tms.add! benchmark
call_seq	ways different call method
80	exception.backtrace_locations exception.set_backtrace
81	:name.add_entry :x509 openssl :name.new
86	cgi.http_header cgi.header cgi.out
87	:generic.merge! uri :generic.merge
special	name attribute maps sequences type special
85	array.sort array.sort!
rw	‘w’) ‘rw’)? attribute readable ‘r’), writable
code_object	generated :codeobject rdoc html
methods_hash	registered hash methods
res	output accumulator
proxy_pass	password user accessing proxy
141	:generic.normalize :generic.normalize! uri
filename	file code run passed form data argument filename part static erb optional response kernel#eval
172	:client.proxy2 xmlrpc :client.call_async :client.proxy_async :client.call2 :client.call :client.proxy
content	c instruction target parser parsing content everything “name” file <?tag “tag” …?> else ie
lineno	erb code last passed read number argument lineno file run line kernel#eval optional row
7	float.ceil numeric.ceil
rc	default irb copy
received_nodoc	receive :nodoc ever directive?
cwd	current directory returns working
defaults	default command options
resume	status resumed decides resume whether restarted incomplete sets transfers retrieves
ciphers	available ciphers sets
progname	include program messages name log
relative_name	relative name file
return_format	set return prompt_mode= format current passed mode statement prompt_mode using :return
reason	class string error
dependencies	gems required statements set<object> specification responsible causing dependencies error gem
cookie	cookie header set http get
conflicts	conflicting :conflict}] hash @return specifications caused => mapping [{string fail dependencies conflicts resolution conflict
program_name	name command-line default emitted program command defaults error invocation message banner $0
149	:ec.public_key? :ec.private_key? openssl :pkey
last_response	last server’s response
param_seq	list parameter method pretty
proxy_user	proxy accessing user name
thread	drbserver current main context thread
top_level	toplevel belong parsed file items
77	:jobmanager.thread :jobmanager.search irb :jobmanager.irb
length	length message octets
query_string	query request uri
footnotes	footnotes document
singleton	method/attribute? alias declared context? singleton
encoding	—> csv last stream puts encoding string store parsing returns used printed eval output writing expression id contents name
236	irb.conf :context.use_loader= :extendcommandbundle.irb_context irb.currentcontext irb irb.irb_at_exit
number	message server number sequence
required_rubygems_version	version rubygems gem required
echo	whether output return value echo
inspect_mode	default irb copy
178	:requestset.resolve_current gem.use_paths :commands gem :unpackcommand.find_in_cache
177	open3.popen2e open3.capture3 open3.popen2 open3.popen3 open3.capture2e open3.capture2
last_response_code	code last server’s response
message	message http result sent server
174	:context.each_section :context.section_contents rdoc :context.add_section :context.methods_by_type :context.set_current_section
173	:specification.spec_name gem :specification.file_name
payload	holds object vertex @return payload
171	time.inspect time.to_s
size	length message octets
emailbx	use list messages related mailbox error mail
observer	notified observable object changes observer
222	csv.unconverted_fields? csv.parse csv.new csv.read csv.write_headers? csv.converters csv.shift csv.skip_blanks? csv.foreach csv.<< csv.return_headers? csv.instance csv.header_converters csv.open csv.force_quotes? csv.generate csv.headers csv.filter
local_port	establish connection used local port
ordering	ordering return
unknown	wrapped drb :drbunknown object get
180	:specification.full_name :nametuple.full_name :specspecification.full_name :resolver gem
calls_super	super version uses superclass call true method
183	addrinfo.canonname socket.tcp_server_loop addrinfo.getaddrinfo socket.getaddrinfo addrinfo.foreach
http_header_extra	request headers add http additional
2	sdbm.update sdbm.replace
params	pairs used hash parameters get parsed name=>values next methodattr values context params array method
response_handlers	returns response handlers
accept	header value accept
backtrace	print backtraces errors true
wrapped	wrapped :source gem
186	etc.getgrgid etc.getgrent etc.endgrent etc.group etc.getgrnam etc.setgrent
188	:templateentry.match rinda :template.match
scheme	protocol returns scheme component uri
default_argv	default strings parsed
uris	array strings
store	content :store object rdoc current source generated exist file store documentation
187	:instructionsequence.to_binary rubyvm :instructionsequence.load_from_binary
current_job	active irb session
196	:markup rdoc :tobs.convert_special :tobs.init_tags
done_documenting	)? ie :enddoc done documenting come across
184	time.hash array.hash hash.hash range.last float.hash bignum.hash struct.hash object.hash range.hash array.uniq! proc.hash array.uniq unboundmethod.hash regexp.hash string.hash struct.eql? array.eql? range.eql? range.rng matchdata.hash range.cover? method.hash array.ary
185	:c.do_struct_define_without_accessor :c.do_constants :c.do_define_module :c.do_classes :c.do_define_module_under :c.do_singleton_class rdoc :c.do_attrs :c.do_define_class_under :parser :c.do_modules :c.do_boot_defclass :c.do_includes :c.do_methods :c.do_aliases :c.do_define_class
rdoc	reference format rdoc markup driver tree parse :rdoc
remote_address	source address
190	gem.pre_install gem.post_build gem.post_install
tokens	control outstanding clients number tokens token accessor
192	:converter.putback :invalidbytesequenceerror.readagain_bytes encoding
primary_server	druby local primary server
11	net :http.read_timeout= :http.start
10	enumerator.peek_values enumerator.next enumerator.next_values
13	:specification.require_paths= :specification.require_path= gem :specification.require_path
npn_protocols	enumerable strings
threads	terminated returns threads array yet
target	domain name specification instruction else content everything host “name” <?tag “tag” …?> ie conflict target
17	socket.connect_nonblock socket.connect
16	win32ole_event.on_event_with_outargs win32ole_event.handler=
c_function	function implements c defined file method
18	shellwords.shellsplit string.shellsplit
update_output_dir	timestamps dir? rdoc update output
headers	set headers url e-mail arrays array
display_process_id	false trace process id defaults output display
classes	c used generator displayed modules maps classes names variable necessarily ruby
str	search schemes string escapes make safe unsafe remove patterns str apply regexp extract uris
ssl_timeout	seconds maximum ssl session timeout sets lifetime
activated?	activated true gemspec
priority	priority host target
xpath	elements string path removed optional matching
189	:context.file_input? :context.change_workspace :context.main :extendcommandbundle.install_extend_commands :context.pop_workspace :irb.suspend_input_method :context.prompting? :irbloader.source_file :irbloader.load_file irb :extendcommandbundle.irb_load :context.push_workspace
list_index	list numeric indexes current lists alphabetic stack
genspace	corresponding takes argument one returns spaces fixnum number proc lambda
required_by	{#dependency} depended specifications upon [array<object>] @return
viewer	code point know model worked viewers
file_name	given name initialization displayed parsed current file usually input method
workspace_home	toplevel see workspace home_workspace
raw	rexml leaves value raw alone true
parsers	filenames name extension arrays parser matching parse maps regular file array classes expressions
translator_comment	comment translator created content editor po
seen	references replacements hash looked-up
25	kernel.caller_locations thread.backtrace_locations
logdev	device log
current_section	current section documentation sets
min	component date/time return value specified
verify_depth	certificate chain verifying ca maximum number depth verification sets certificates walk
outputdir	directory output
new_session	session id
proxy_address	host proxy address
infinite_length	never nil
200	addrinfo.family_addrinfo addrinfo.connect_from
203	uri.encode_www_form_component uri.decode_www_form
202	:gzipfile.wrap :gzipfile.close zlib :gzipfile.finish
205	pp.pp pp.singleline_pp
204	:parser.yyerror :parser.on_error racc
207	thread.join thread.abort_on_exception thread.value thread.abort_on_exception=
206	objectspace.allocation_class_path objectspace.allocation_generation objectspace.allocation_sourcefile objectspace.allocation_sourceline objectspace.trace_object_allocations objectspace.allocation_method_id
buffer	buffer we’re next) current read going
208	bigdecimal.to_f bigdecimal.split
newline	appended value add new output line
time_format	applied timestamp line logged format
76	:context.add_module :context.add_class rdoc
75	:classmodule.ancestors :mixin.module :mixin.full_name rdoc :classmodule.find_ancestor_local_symbol
cipher	request cipher http ssl
template_stylesheets	stylesheets additional template
ignore_dependencies	available requested requiring resolution installed looked dependency dependencies performed gems true rubygems/installer_test_case
71	objectspace.internal_class_of objectspace.reachable_objects_from objectspace.internal_super_of
70	tempfile.unlink tempfile.close tempfile.path
post_uninstall_hooks	run hooks list installation :uninstaller#uninstall completes gem
112	pathname.children pathname.each_child pathname.entries
use_tracer	used statements evaluating whether context tracer
79	:uriformatter.unescape :uriformatter.escape gem
78	:attr.marshal_load :attr.marshal_dump :anymethod.marshal_dump rdoc :anymethod.marshal_load
line_numbers	code source line include numbers
ssl_version	ssl version sets
uri	gems exception used corresponding string drbserver namespace uri fetch source formatted place accessed response happened
omit_headings_below	given level omitted less #table_of_contents headings omits heading
pipe	pipe mode? rdoc
ie_hack	ignored
107	:context.current_section rdoc :codeobject.parent :context.add_class_or_module :codeobject.section :constant.==
metas	represents returns hash fields header
workspace	current context workspace
pre_install_hooks	run hooks work list :installer#install gem
219	:comment.parse :section.parse :context :markup.parse :blockparser.new :classmodule.parse rdoc :rd.parse :changelog.create_document :rd :parser :tomdoc.parse :driver.class_document :blockparser.parse :changelog.scan :text.parse :driver.method_document :ri
section	section set codeobject
50	:requestset.install :requestset.new :requestset.install_from_gemdeps gem
post_install_hooks	run hooks list :installer#install installation completes gem
qop	protection quality
text	comment containing string stream text search source token tomdoc-format file special
cstime	time children system cpu
protocol	services ip protocol number
alpn_select_cb	needs invoked protocol list server callback client sent side select
arglists	call_seq #param_seq method #call_seq name
225	:markdown.paragraph rdoc :tomdoc.build_paragraph
webcvs	url web frontend cvs
prompt_c	e irb prompt continuated statement
pivots	indices returns pivoting
incoming_edges	@return self {#graph} [array<edge>] edges {edge#destination}
title	section documentation rdoc title
223	array.assoc array.rassoc
prompt_i	information irb prompt see standard
cache	store contents
prompt_n	information see prompt irb customizing
continue_timeout	seconds 100 continue response wait
prompt_s	information prompt see continuated irb strings
entities	given referenced name doctype dtd #external_id
8	basicsocket.getsockname basicsocket.local_address
52	:requestset :gemdependencyapi.gem :gemdependencyapi.platform gem :gemdependencyapi.platforms
digests	collected wrapped writes digests
userdb	authenticator user database
digest_algorithm	create used algorithm digest signature
extra_chain_cert	added chain certificate extra x509 certificates array
http_last_response	last object rpc :httpresponse returns net
120	:notifier irb :compositenotifier.def_notifier :compositenotifier.level_notifier=
display_c_call?	false calls trace c-routine defaults output display
122	shell.install_system_commands shell.def_system_command
debug_mode	traffic written true +$stdout+ server
124	:mapping.new :emitter.start_mapping psych :handler.start_mapping :nodes
125	array.dclone object.dclone float.dclone symbol.dclone fixnum.dclone
126	:classmodule.update_includes :classmodule.documented? rdoc :codeobject.documented? :context.remove_from_documentation?
127	gem.find_latest_files gem.find_files
128	:store.source rdoc :store.friendly_path :ri :driver.find_store
15	:pkcs12.create :ssl openssl :sslsocket.client_ca
eval_history	limit command result history
banner	preceding message banner heading summary
gem	installed gem filename
accept_encoding	header accept-encoding value
template_dir	directory lives template
sources	sources list
verbosity	verbosity quiet zero means
131	:options.finish :rdoc.document rdoc :rdoc.new
summary	gem’s short command description summary
19	rinda :ringserver.do_write :ringserver.write_services
post_install_message	message gets displayed gem installed
ap_name	default irb copy
level_notifier	returns object leveled notifier
request_http_version	http version request response
release	release code
c_class_variables	c variables module parsed maps names file class
registry	authorities naming registry
dest_prerelease_specs_index	index prerelease specs install location
sev_threshold	threshold e logging severity
requirement	requirement version gem
set	specification set came
reference	git reference checking text used commit gem
134	:classmodule.complete :store.remove_nodoc rdoc :store.complete
locale	locale output
loaded_specs	hash name keyed :specification loaded gem
keep_alive	response? connection? keep-alive
is_alias_for	constant we’re module alias method/attribute sets aliasing class
sec	return seconds terminate component number value date/time specified block wait
pre_uninstall_hooks	run hooks work list :uninstaller#uninstall gem
arg	default set value supplied
checksums	checksums contents package
139	:ftp.new net :ftp.login uri
format_executable	available requiring rubygems/installer_test_case
stats	statistics accessor
maxwidth	separated newline maximum width fixnum defaults line 79
pattern	patterns hash
option_parser	instance optionparser
listeners	connections sockets listening
label	listitem label
state	observable used generator state changed json returns boolean class indicating
103	object.untaint object.taint object.tainted?
progress	current progress 100 0
irb	current irb session
formatter	logging text formatted mark four take return message formatter proc arguments
209	:store.add_c_variables rdoc :parser.process_directive
email	addresses spec contact address usage email gem
esmtp?	whether esmtp use set
responses	untagged returns recorded responses
parent	parent section element lives context sets codeobject
missing	could list sources dependencies found configured
26	:generator json :ext :state.quirks_mode= :state.new
proxy_port	host proxy port number
done_installing_hooks	gems set run installs hooks list :dependencyinstaller gem
stime	time system cpu
key	:dsa key certificate signing attribute object openssl private :rsa either context sets :pkey string
page_dir	associated pages faq guides live directory class
21	date.england date.julian date.gregorian date.italy
exec_format	overrides executable format
ssl_client_cert	used remote name certificate openssl authentication connection client file directory path https
22	gem.find_unresolved_default_spec gem.remove_unresolved_default_spec gem.register_default_spec
summary_indent	indentation summary
userinfo	password user name
quiet	quiet’ mode set/unset
locale_dir	directory locale live data
wrappers	available requiring rubygems/installer_test_case
context	information generating :codeobject hash whitespace processing environment items holds rdoc containing supplied current returns session references context irb handling must
local_name	object set name valid
attributes	accessing mechanisms methods enabled markup object attr* request element elements child attributes hash
comment	comment section cookie
rname	person domain responsible name
60	string.shellescape shellwords.shellescape
header	tar request parsed header entry response
62	net :pop3.reset :popmail.delete
written	written bytes number
64	pathname.to_path pathname.to_s
65	prettyprint.fill_breakable prettyprint.new
66	yaml :dbm.update :dbm.replace
67	:outputmethod.puts :outputmethod.ppx irb :outputmethod.pp :outputmethod.print
68	rexml :attributes.get_attribute :attributes.[]
table	compare used equality format internal data
100	:availableset.each :availableset.each_spec gem
154	time.nsec time.subsec time.tv_nsec
path_warning	warned including we’ve path true gem
strings	record returns txt array strings
post_reset_hooks	hooks run :specification list gem
116	tempfile.new tempfile.open tempfile.create
104	:cstructbuilder.create fiddle :importer.create_value
pd	integers array pairs
158	webrick :userdb.set_passwd :userdb.make_passwd :httpauth :userdb.get_passwd
gemdeps	gemdependencyapi object set
location	comment found :toplevel rdoc
oth	uri string
server_cert	request http certificate server
ultra_safe	even prevent unusual unlikely-to-occur whether os filesystem pstore out-of-space errors file error conditions corruptions best
peeraddr	client socket address
add_line_numbers	code adds source whether allows #markup_code controlling numbers line
skip_lines	regex comment marking line
201	tcltk.deletecallbackkey tcltk.dcb
ignore_sigint	whether ignored control-c ^c
latitude	loc thousandths equator unsigned 2**31 32bit second arc latitude integer
168	numeric.magnitude numeric.abs
external	default shell run whether rdoc process external false
input	gzipped input string
164	:stream.new psych :emitter.start_stream :handler.start_stream :nodes
165	:arguable.options= :arguable.options optionparser
166	array.take_while array.drop_while
167	yaml :dbm.store :dbm.ydbm key
160	shellwords.shelljoin array.shelljoin
logger	cgi authenticator logger server
129	array.drop array.take
163	string.try_convert string.to_str
external_aliases	resolved could aliases
exception	exception raise subclass elapsed timeout error fetch
col_sep	parsing encoded used writing :col_sep
always_install	gems even already installed install array
plain	plain scalar?
post_build_hooks	files run builds hooks extracts list :installer#install extensions gem
unparsed_uri	unparsed request uri
value	checked integer attribute list scalar constant’s supplied carries cookie value cookie’s arbitrary values optional asn
error	exception option whether processing subclass failed examine error fetch
margin	unused
anchor	links sequence mapping value one alias optional anchor
default_executable	default executable gem sets
dest_specs_index	index specs install location
orientation	‘lon’ hemisphere orientation ‘lat’
stdout	used stream trace stdout defaults output
212	:digest.reset openssl :digest.update
binding	binding workspace
getwd	current directory returns working
asset_dirs	maps filesystem type asset path
io	context created readlineinputmethod current fileinputmethod either stdioinputmethod specified input method
bulk_threshold	bulk threshold value
use_stdout	$stdout vs pager user controls
binary	transfers mode true performed binary
renegotiation_cb	handshake invoked initiated whenever callback new
severity	message severity log
dry_run	files rdoc write written #dry_run true store
explicit_requirements	requirements @return explicit required vertex [arrary<object>]
0	:tottonly.accept_list_start :markup rdoc :tottonly.accept_list_end
exit_code	process code exit
parts	list parts component document listitem
9	thread.alive? thread.status thread.stop?
document	parse returned overrides documentation content types
status	status 200 digit code message smtp three server returns consists reply array response
hyperlink_all	even preceded old behavior hyperlink rdoc words ‘::’ ‘#’ method match name
html_tags	corresponding tags attribute char maps html
create_id	used create called hook decide identifier class json_create
typecode	typecode uri :ftp see :component accessor
arg_check	default false check arguments
user	cgi return corresponding user attributes variable remote
word_pair_map	delimiters used aren’t
realm	authenticator realm covers
column_count	returns number columns
gem_dir	available requiring rubygems/installer_test_case
set_summary_indent	indentation summary
markup	comment default markup format
vertices	@return graph => vertices [{string dependency {vertex#name} keyed vertex}]
signing_key	used gem key sign
flags	entry flags po
ca_path	containing certifications certification ca format pem sets directory path certificates
components	multiple :http defined symbol uri arguments
constants_hash	registered hash constants
attribute_manager	inline handles attributemanager markup
mon	component date/time return value specified
216	string.to_r kernel.rational
auth_type	authentication type
214	:parser.do_parse :parser.next_token racc
215	:basicserver.new :modrubyserver.new xmlrpc :cgiserver.new :server.new :basicserver.add_handler
stores	:store rdoc path entry ri :ri
213	enumerable.lazy enumerable.grep_v
quoted	quoted? scalar
211	:table.delete :table.[] csv :table.values_at :table.[]=
vprecision	integers notation e scientific vertical use precision xey meters 2 values using type ssize value/2
218	:specification.executable :specification.executable= gem
bitmap	services map bit enabled host
debug_level	information level see debug irb debug_level=
classes_or_modules	declared classes modules file
method_list	defined methods context
32	cgi :htmlextension.form :htmlextension.file_field
build_modern	1 rubygems build indexes
verbose	extra information :loud false verbose level whether messages normal displayed – defaults debug output true display additional
password	corresponding return attributes
open_timeout	opened attempting seconds number connection open wait
generate_rdoc	rdoc? generate
generator	creating used name generator format ) --format rdoc json module instance returns set –format option output optional description
msgid	content msgid
mask	attribute bitmask
passive	passive connection true mode
source	gems fetched :source specification source problem fetch gem
extends	extended modules context
set_program_name	name default emitted program defaults error message banner $0
local_address	local address
rmailbx	domain name responsible list mailbox mail
real	real time elapsed
rdoc_include	files satisfy search directories :include array
tmp_ecdh_callback	callback invoked ecdh parameters required
format	comment available verbatim format requiring section rubygems/installer_test_case
dest_directory	index location install
specification_version	:specification version gem gemspec
temporary_section	use added constant attribute section next method
preference	preference mx
cert_store	:store certificate x509 verify openssl used :x509 verification sets peer
base	locked @return graph dependencygraph dependency base dependencies
name	xpath referenced @return domainname aliased attribute constant’s set file loaded gem’s #external_id given git would dependency unknown top namespace created locale method/attribute valid main function method’s string form object vertex regular cookie module included data class gem search task name excluding level could required doctype dtd thing part found expression specification
59	:dsa.public_key :dsa.public? openssl :pkey
58	bignum.bit_length fixnum.bit_length
61	:anymethod.call_seq= rdoc :anymethod.name :anymethod.arglists
55	index array.pop array.unshift array.push array.shift array.ary
54	psych.parse_stream psych.parse_file psych.parse psych.load
57	erb.set_eoutvar erb.result erb.run
56	tracepoint.event tracepoint.new
51	array.keep_if array.select!
greeting	returns initial greeting server response
53	:gzipwriter.new zlib :deflate.params :deflate.set_dictionary
tag_directives	directives tag list document
63	:store.classes_hash :store.modules_hash rdoc :classmodule.update_aliases
verify_mode	certification ssl/tls server session flags verification sets beginning mode
irb_name	irb either name
prompt_mode	default irb copy
output	indent string object < write implementing integer output class
73	:blt :barchart.extents tk :stripchart.extents :graph.extents
httponly	cookie false true httponly otherwise
local_host	establish host used local connection
reason_phrase	phrase reason response “ok”)
root_dir	gems git installation cache set directory root gem
methods	displayed methods generator
back_trace_limit	backtrace top lines n tail limit displayed
output_decoration	output decorations? heading
load_modules	default irb copy
list_width	widths list stack indentation
115	queue.close sizedqueue.close
platforms	platforms lockfile mismatched
117	irb :outputmethod.parse_printf_format :outputmethod.printf
elements	accessing creation mechanisms element instance elements child attributes
111	:specfetcher.new gem.sources= :installer.install gem :bestset.new :resolver :specfetcher.available_specs :dependencyinstaller.new
required_ruby_version	version ruby gem required
113	:testcase.util_setup_spec_fetcher gem :testcase.util_setup_fake_fetcher
paragraphs	count found paragraphs
home	gems default deprecated system managing install path
72	:emitter.start_sequence :handler.start_sequence psych :sequence.new :nodes
5	prime.prime_division integer.prime_division
119	:extendcommandbundle.install_alias_method irb :extendcommandbundle.extend_object
118	:compositehandler.new fiddle :importer.dlload
retry	retry often seconds refresh server failure secondary check name
rubyforge_project	project lives rubyforge gem
loaded_from	path loaded gemspec
comments	section comments
irb_path	::new surrounded input_method either passed parenthesis irb_name
pre_reset_hooks	hooks run :specification list gem
210	bigdecimal.save_exception_mode rational.to_d bigdecimal.save_rounding_mode bigdecimal.mult bigdecimal.round bigdecimal.modulo bigdecimal.div bigdecimal.quo bigdecimal.limit bigdecimal.divmod bigdecimal.sub bigdecimal.add
ignore_sigint?	whether ignored control-c ^c
constant_aliases	module class constants aliases
expires	expires cookie time
repository	sourced git gem repository
mname	name resides host master file zone
row_sep	encoded writing :row_sep used parsing
34	tsort.tsort_each tsort.tsort
host	returns component host uri
last_modified	files last hash modified times
json_index	index json darkfish generator
offset	index use defined codeobject file offset starting
regexp	hash uri also see :parser regexp
update_sources	false sourceinfocache update every want time true otherwise
src	generated code ruby erb
to_s	reference format text markup rdoc content
lastresp	code last server’s response
comment_location	comment location came
asset_rel_path	relative path style javascript sheets
http	client returns object net :http
dependency	:dependency unsatisfiable could object activated dependency conflict wrapped found gem @return
74	:engine.load_public_key :engine.ctrl_cmd openssl :engine.load_private_key :engine.cipher :engine.finish :engine.digest
stdout_mutex	used trace lock mutex output displaying tracer
transitive	ignored ie_hack
os	resource operating system
path_info	info path cgi variable
datetime_format	passing suitable string strftime
safe_level	safe server level
facility	used logging facility argument program message type specify
gem_spec	containing package :specification ruby gem metadata
force_output	even like create rdoc directory output look
schemes	specific schemes limit uri matching
references	entry extracted locations po
errs	stream error
cert_chain	signing used certificate chain sign including certificates gem
display_c_call	false calls trace c-routine defaults output display
msgstr	content msgstr
rows	instance creations
181	float.to_int float.truncate float.to_i numeric.truncate
altitude	whose wgs84 reference raw 100km altitude unsigned surface sphere spheroid 32bit integer centimeters sits loc
missing_dependencies	c missing registered due parsing class classes file enclosing found yet
client_thread	receive exceptions thread
long	map style actual option long switches switch objects
use_readline?	whether readline enabled
width	defaults @summary_width side summary width option characters output part page left
disable_default_gem_server	force specification pushing server want true gem
request_method	get request response etc put post method
162	gem.post_uninstall gem.pre_uninstall
display_process_id?	false trace process id defaults output display
files	uploaded files pairs hash generator get displayed name=>values package list processed
c_singleton_class_variables	c variables singleton parsed maps names file class
known_classes	c singleton maps classes names variable ruby
pwd	current directory returns working
229	:cipher.key :cipher.iv :cipher.reset :cipher.final openssl :cipher.update :rsa.export :ec.export :cipher.authenticated? :cipher.encrypt :cipher.auth_tag :cipher.auth_data :cipher.auth_tag([ :pkey :cipher.decrypt
old_name	aliasee method’s name
227	:dns.each_address :dns.getresources :mdns.each_address :dns.each_resource :dns.getaddress :dns.each_name resolv :ipv6.to_name :dns.getresource :dns.getaddresses :dns.getnames :dns.getname :ipv4.to_name
226	string.to_c kernel.complex
line	last defined text consumed number encountered codeobject file error line
224	:cparser.parse_ctype :importer.sizeof fiddle
buf	buffer unknown contained object marshalled
gem_home	repository gem installed
221	:drbsslsocket.open_server drb :drbsslsocket.open :drbsslsocket.new
220	file.fnmatch file.fnmatch?
count	count updated silent reporter far items never number progress counted
rc?	default irb copy
114	rexml :document.entity_expansion_limit :document.entity_expansion_limit=
143	hash.include? hash.member? hash.has_key? hash.key?
use_tracer?	used statements evaluating whether context tracer
69	:ftp.connect net :ftp.close
limit	written bytes maximum number
need_submodules	need too? checked repository submodules
rubygems_version	create version rubygems gem used
extracted_comment	comment content source file extracted
110	webrick :formdata.new :formdata.<< :httputils :formdata.append_data
151	bigdecimal.** bigdecimal.power
150	gem.ruby_version gem.rubygems_version
session_id_context	reused session context sets
152	:state.depth= :state.max_nesting= :generator :state.max_nesting json :ext
request_line	complete get request / line http/1
scanner	session irb lexer used
157	sym thread.thr thread.thread_variable? thread.thread_variable_set thread.thread_variables thread.thread_variable_get
156	:baselistener.install_class_name :baselistener.class_name rss
159	basicsocket.recvmsg_nonblock socket socket.getnameinfo ipsocket.peeraddr basicsocket.recvmsg addrinfo.new :ancillarydata.unix_rights basicsocket.sendmsg
matching_word_pairs	end bold start delimiters tt maps words occur around
parser	used parser json returns processed file class
command	command name
ins	input stream
client_cert_cb	requested invoked set certificate server callback client
group_queue	groups prettyprint :groupqueue printed pretty stack
generate_ri	data? generate ri
character_limit	many cut characters input
file	comment :toplevel code name extension created defined object rdoc filename without file included found document saved
83	:dh.compute_key :dh.new :dh.generate_key! :dh.public_key openssl :dh.to_der :pkey
read_timeout	via seconds number one 1 read 2 reading call) block wait
ssize	spherical loc scientific notation integers 2 meters using xey size
48	uri.decode_www_form_component uri.encode_www_form
49	kernel.exit process.exit
46	:command.add_option :command.new gem
47	:specification.normalize :specification.extra_rdoc_files= gem
44	basicsocket.getsockopt basicsocket.setsockopt
45	logger.info logger.unknown logger.warn logger.debug syslog logger.fatal logger.error :logger.add
42	:ldap.new :http.new uri
43	net :pop3.verify :pop3.certs :pop3.use_ssl?
40	:classmodule.each_ancestor rdoc :codeobject.each_parent
41	net :httpheader.add_field :httpheader.get_fields
verbose?	information false additional defaults debug display
other	object parent must
block_params	used parameters called next methodattr params context yielded parsed block
element_name	got this?
quote_char	encoded writing used :quote_char parsing
files_so_far	count files parsed parsing
node	node < write implementing output class
ssl_ca_cert	used remote name certificate ca openssl connection file directory path https
op_dir	directory output name
dest_latest_specs_index	index location specs install latest
p_user	opt hash p_pass user pass optional proxy
welcome	message welcome server’s
includes	modules context includes
file_stat	:stat struct file toplevel’s
outs	output stream
ctype	closure return c type ffi
requester	dependency request
force_documentation	codeobject documentation force
tab_width	tab number columns
170	etc.getpwnam etc.endpwent etc.passwd etc.getpwuid etc.setpwent etc.getpwent
remote	gems updated used remote network repository cache resolving disable access staticset ignores sets false set fixed true
algorithm	authentication algorithm digest
field_size_limit	field limit size
atype	map pairs converter pattern acceptable argument types
session_id	session id
cpu	resource cpu architecture
keep_alive_timeout	seconds connection request reuse previous
directory	directory index build
12	:security.trusted_certificates gem :security.trust_dir
requires	files gems containing hash require names context requires gem
math_mode	whether returns enabled mode bc
169	:packagetask.new gem :packagetask.define
