fileno	fileno
registry	registry
float	float
hidden	hidden
standardaboutpanel	standardaboutpanel
label_width	label_width
encoding=	encoding=
RDoc::RI::Task	RDoc::RI::Task
XMLRPC::BasicServer	XMLRPC::BasicServer
banner	banner
nsec	nsec
preheaders	preheaders
StringScanner	StringScanner
gid	gid
cn	cn
getgm	getgm
utf7	utf7
IPSocket	IPSocket
sax2parser	sax2parser
JSON	JSON
baselistener	baselistener
groups	groups
first	first
Sync_m	Sync_m
methodextender	methodextender
GDBM	GDBM
Gem::Text	Gem::Text
listenermixin	listenermixin
soc	soc
basis	basis
YAML::DBM	YAML::DBM
Racc::Parser	Racc::Parser
WIN32OLE_TYPELIB	WIN32OLE_TYPELIB
theme	theme
authors=	authors=
recvmsg	recvmsg
setregid	setregid
printf	printf
downto	downto
dns	dns
generate	generate
create	create
consoleui	consoleui
unescape	unescape
broadaddr	broadaddr
text	text
Gem::Security::TrustDir	Gem::Security::TrustDir
gzipreader	gzipreader
Psych::Coder	Psych::Coder
submit	submit
parent	parent
Tracer	Tracer
job	job
WIN32OLE_RECORD	WIN32OLE_RECORD
mlsxentry	mlsxentry
Gem::Commands::UnpackCommand	Gem::Commands::UnpackCommand
output_method	output_method
falseclass	falseclass
sockets	sockets
identity	identity
format	format
comment	comment
labels	labels
Exception2MessageMapper	Exception2MessageMapper
seq	seq
lstrip	lstrip
tomarkdown	tomarkdown
during	during
cgiserver	cgiserver
map_name	map_name
fetch	fetch
nlink	nlink
validate	validate
modulo	modulo
param_count	param_count
real_pathname	real_pathname
RDoc::Generator::POT::POEntry	RDoc::Generator::POT::POEntry
sync=	sync=
expansion	expansion
top	top
how	how
unit	unit
initgroups	initgroups
recvfrom	recvfrom
param	param
udpsource	udpsource
RSS::ListenerMixin	RSS::ListenerMixin
nmake	nmake
safelevel	safelevel
mkpath	mkpath
Gem::Ext::Builder	Gem::Ext::Builder
crc	crc
document	document
true,_false,	true,_false,
afamily	afamily
XMLRPC::XMLParser	XMLRPC::XMLParser
ifnone	ifnone
rate	rate
CSV	CSV
allocations	allocations
usec	usec
signo	signo
verify	verify
guid	guid
advice	advice
int	int
CSV::Table	CSV::Table
remove	remove
dependent	dependent
quit	quit
mount_path	mount_path
nullstore	nullstore
irb	irb
simplerenewer	simplerenewer
list	list
baseparser	baseparser
repeated	repeated
escapehtml	escapehtml
matrices	matrices
upcase	upcase
tracepoint	tracepoint
mode=	mode=
complete	complete
singleforwardable	singleforwardable
pop3	pop3
latest	latest
Random	Random
WEBrick::HTTPProxyServer	WEBrick::HTTPProxyServer
parserwriterchoosemixin	parserwriterchoosemixin
Gem::InstallerTestCase	Gem::InstallerTestCase
state	state
reporter	reporter
Syslog::Macros	Syslog::Macros
oflush	oflush
httpservlet	httpservlet
renamable	renamable
ringserver	ringserver
submission	submission
obj_or_signature	obj_or_signature
JSON::Ext::Generator::State	JSON::Ext::Generator::State
sourceline	sourceline
erfc	erfc
Gem::StreamUI::VerboseDownloadReporter	Gem::StreamUI::VerboseDownloadReporter
bitlen	bitlen
dep	dep
count=	count=
target	target
ole_class	ole_class
tosjis	tosjis
documented	documented
with	with
tokenize	tokenize
open_obj	open_obj
asciicompat	asciicompat
started	started
connection	connection
minute	minute
others_possible	others_possible
Gem::Source	Gem::Source
unixsocket	unixsocket
util	util
nlst	nlst
rescue	rescue
all=	all=
TclTkIp	TclTkIp
WEBrick::HTTPUtils	WEBrick::HTTPUtils
transpose	transpose
mail	mail
pass	pass
storlines	storlines
birthtime	birthtime
relative_name	relative_name
members	members
object	object
from_version	from_version
RDoc::Parser::Ruby	RDoc::Parser::Ruby
defaultfilehandler	defaultfilehandler
vars	vars
getlogin	getlogin
Tk::BLT::Graph	Tk::BLT::Graph
digestio	digestio
cweek	cweek
protocol_name	protocol_name
Gem::Resolver::RequirementList	Gem::Resolver::RequirementList
grep	grep
OptionParser::Switch::PlacedArgument	OptionParser::Switch::PlacedArgument
notifytemplateentry	notifytemplateentry
Gem::Dependency	Gem::Dependency
ext	ext
REXML::Comment	REXML::Comment
REXML::DocType	REXML::DocType
strict	strict
0.0	0.0
decode64	decode64
euid	euid
binary	binary
PStore	PStore
tanh	tanh
given	given
DRb::DRbObject	DRb::DRbObject
convpath	convpath
out	out
raw_content	raw_content
mixin	mixin
udpsocket	udpsocket
or	or
fsync	fsync
fraction	fraction
event	event
decimal	decimal
progname	progname
crc1	crc1
locked	locked
size=	size=
child1	child1
flock	flock
i	i
resume	resume
0	0
tarheader	tarheader
asin	asin
RDoc::Parser::ChangeLog	RDoc::Parser::ChangeLog
str	str
source_name	source_name
max_limit	max_limit
squeeze	squeeze
invoke	invoke
ungetbyte	ungetbyte
chomp	chomp
REXML::Attributes	REXML::Attributes
Matrix	Matrix
hostname	hostname
Base64	Base64
addincrentryfield	addincrentryfield
Struct	Struct
localjumperror	localjumperror
short_name	short_name
gc	gc
match	match
blank_line	blank_line
compact	compact
rdoclink	rdoclink
getobj	getobj
others	others
lockspecification	lockspecification
undef	undef
hinfo	hinfo
dest_sockaddr	dest_sockaddr
name_string	name_string
indexer	indexer
timeout=	timeout=
atanh	atanh
OptionParser::Switch::RequiredArgument	OptionParser::Switch::RequiredArgument
getpwnam	getpwnam
Gem::Resolver::DependencyRequest	Gem::Resolver::DependencyRequest
Resolv::DNS::Resource::DomainName	Resolv::DNS::Resource::DomainName
ACL::ACLList	ACL::ACLList
version	version
udp	udp
merged	merged
lcm	lcm
null	null
Queue	Queue
declaration	declaration
trust	trust
maxgroups	maxgroups
WEBrick::HTTPAuth::DigestAuth	WEBrick::HTTPAuth::DigestAuth
fix	fix
popen	popen
timeouthandler	timeouthandler
height	height
specfetcher	specfetcher
rubytools	rubytools
jsonindex	jsonindex
min:	min:
next_update	next_update
serv	serv
if	if
bmbm	bmbm
extend_method	extend_method
reader	reader
2	2
digests	digests
formattertestcase	formattertestcase
gzip	gzip
trueclass	trueclass
skip	skip
nomethoderror	nomethoderror
ruby=	ruby=
load	load
readlink	readlink
locale	locale
cos	cos
files=	files=
Gem::RequestSet::GemDependencyAPI	Gem::RequestSet::GemDependencyAPI
XMLRPC::Create	XMLRPC::Create
nesting=	nesting=
build_args	build_args
short	short
by:	by:
services	services
rjust	rjust
row_or_array	row_or_array
show	show
cooked	cooked
mem_level	mem_level
negative	negative
co	co
dateconstruct	dateconstruct
canceled	canceled
listitem	listitem
ldap	ldap
getresource	getresource
readlineinputmethod	readlineinputmethod
rand	rand
RSS::Parser	RSS::Parser
Gem::Resolver::Set	Gem::Resolver::Set
tohtmlsnippet	tohtmlsnippet
ask	ask
REXML::AttlistDecl	REXML::AttlistDecl
Rinda::DRbObjectTemplate	Rinda::DRbObjectTemplate
destination_dir	destination_dir
drbremoteerror	drbremoteerror
class_type	class_type
RDoc::RD	RDoc::RD
dclone	dclone
Gem::DependencyInstaller	Gem::DependencyInstaller
htdigest	htdigest
double	double
fastmode	fastmode
iv	iv
class_mod	class_mod
autoload	autoload
library	library
tktimer	tktimer
template	template
each	each
call_seq	call_seq
rights	rights
popen2	popen2
global	global
ancestor	ancestor
Gem::Validator	Gem::Validator
prefix	prefix
iseuc	iseuc
Tk::Tcllib::Tablelist_Tile	Tk::Tcllib::Tablelist_Tile
extensionfactory	extensionfactory
grant	grant
cstruct	cstruct
sep	sep
Gem::RequestSet::Lockfile::ParseError	Gem::RequestSet::Lockfile::ParseError
(0+0i	(0+0i
MatchData	MatchData
record_separator	record_separator
bump	bump
container	container
cget	cget
OpenSSL::OCSP::CertificateId	OpenSSL::OCSP::CertificateId
auth	auth
uris	uris
contents	contents
DRb::DRbArray	DRb::DRbArray
namespace	namespace
httpauth	httpauth
genericserver	genericserver
done	done
TclTk	TclTk
other_ary	other_ary
member	member
nowait	nowait
NKF	NKF
sunday	sunday
ctypes	ctypes
filtered	filtered
XMLRPC::WEBrickServlet	XMLRPC::WEBrickServlet
i18n	i18n
mjd	mjd
satisfies	satisfies
isatty	isatty
buffering	buffering
bsearch	bsearch
Rinda::SimpleRenewer	Rinda::SimpleRenewer
tkoption	tkoption
any	any
URI::RFC2396_Parser	URI::RFC2396_Parser
make	make
perm	perm
have	have
index_or_header	index_or_header
pkcs5	pkcs5
OptParse	OptParse
scalar	scalar
secret	secret
mode:	mode:
getch	getch
internal	internal
replicate	replicate
conjugate	conjugate
nameerror	nameerror
priority	priority
readable	readable
type=	type=
a_lazy_enumerator	a_lazy_enumerator
macro	macro
getbinaryfile	getbinaryfile
note	note
keylen	keylen
activex	activex
until	until
spawn	spawn
not	not
dbm	dbm
dequote	dequote
levelednotifier	levelednotifier
unused	unused
package	package
gcd	gcd
DateTime	DateTime
stores	stores
eval	eval
tkspace	tkspace
Net::HTTPHeader	Net::HTTPHeader
array_nl	array_nl
Gem::Resolver::Conflict	Gem::Resolver::Conflict
nl=	nl=
a_proc	a_proc
obj)	obj)
ok	ok
visibility	visibility
clock_id	clock_id
Object	Object
shuffle	shuffle
recursive	recursive
renewer	renewer
other	other
square	square
meth_name	meth_name
NilClass	NilClass
inspect_proc	inspect_proc
setsid	setsid
into	into
standalone	standalone
download	download
REXML::Parsers::PullEvent	REXML::Parsers::PullEvent
REXML::Light::Node	REXML::Light::Node
capture	capture
Thread::Backtrace::Location	Thread::Backtrace::Location
bignum	bignum
templateentry	templateentry
false	false
Psych::Nodes::Sequence	Psych::Nodes::Sequence
document_self	document_self
extend	extend
ended	ended
m	m
ipv4	ipv4
'property'	'property'
stop	stop
enumerable	enumerable
tarreader	tarreader
Gem::Resolver::SpecSpecification	Gem::Resolver::SpecSpecification
raise	raise
uninstaller	uninstaller
scalarscanner	scalarscanner
random	random
store	store
textformattertestcase	textformattertestcase
chunked	chunked
incomplete	incomplete
invalid	invalid
conflict	conflict
rubybin	rubybin
modules	modules
Gem::SourceFetchProblem	Gem::SourceFetchProblem
RDoc::RI::Driver	RDoc::RI::Driver
msg_id	msg_id
asinh	asinh
a_hash	a_hash
sprintf	sprintf
specfetchersetup	specfetchersetup
emitter	emitter
hardbreak	hardbreak
commented	commented
cmath	cmath
argv	argv
IRB::Context	IRB::Context
conj	conj
disjoint	disjoint
resource	resource
tr	tr
place	place
disasm	disasm
codepoints	codepoints
arch	arch
RDoc::Markup::ToRdoc	RDoc::Markup::ToRdoc
description	description
stringio	stringio
Gem::Security	Gem::Security
params	params
key=	key=
rows	rows
notifier=	notifier=
oct	oct
last	last
enum	enum
win	win
WIN32OLE_METHOD	WIN32OLE_METHOD
REXML::SourceFactory	REXML::SourceFactory
algorithm	algorithm
commands	commands
tests	tests
untaint	untaint
suffix	suffix
dependencies	dependencies
shellwords	shellwords
tuple	tuple
word	word
secure=	secure=
other_string	other_string
format_string	format_string
sort	sort
casefold	casefold
ringfinger	ringfinger
capture3	capture3
recurse	recurse
RDoc::Markup::ToTableOfContents	RDoc::Markup::ToTableOfContents
IRB::ExtendCommandBundle	IRB::ExtendCommandBundle
acos	acos
take	take
Gem::StreamUI	Gem::StreamUI
RDoc::Generator::JsonIndex	RDoc::Generator::JsonIndex
tracer	tracer
cause	cause
RDoc::Markup::ListItem	RDoc::Markup::ListItem
op_dir	op_dir
abs2	abs2
prompt	prompt
webrick	webrick
resolution	resolution
enc	enc
pos	pos
keys	keys
redirect	redirect
CGI::Util	CGI::Util
missing	missing
one	one
RDoc::Generator::POT::MessageExtractor	RDoc::Generator::POT::MessageExtractor
field	field
solve	solve
cls	cls
hsh	hsh
file	file
dlopen	dlopen
forwardable	forwardable
installer	installer
fragment=	fragment=
verbosedownloadreporter	verbosedownloadreporter
inherit	inherit
detail	detail
tcltk	tcltk
capture2e	capture2e
attr	attr
Zlib::GzipReader	Zlib::GzipReader
this_update	this_update
erb	erb
initial_options	initial_options
reachable	reachable
isequal	isequal
loc	loc
comments	comments
token	token
nomsgnotifier	nomsgnotifier
JSON::Ext::Parser	JSON::Ext::Parser
dependency	dependency
implicit	implicit
activated	activated
Array	Array
tag	tag
setrlimit	setrlimit
fold	fold
Gem::GemcutterUtilities	Gem::GemcutterUtilities
tolabel	tolabel
itk	itk
win32ole_type	win32ole_type
thread	thread
count	count
repository	repository
IRB::WorkSpace	IRB::WorkSpace
certificate	certificate
nl	nl
sec_or_renewer	sec_or_renewer
ident	ident
adjugate	adjugate
rubygemshook	rubygemshook
input_file_name	input_file_name
throw	throw
thread_safe	thread_safe
new_set	new_set
main=	main=
handle	handle
lazy_enumerator	lazy_enumerator
inflate	inflate
OpenSSL::Digest	OpenSSL::Digest
protected	protected
jd	jd
disconnect	disconnect
text=	text=
RSS::Atom::Feed	RSS::Atom::Feed
engine	engine
hour	hour
none	none
tkoptiondb	tkoptiondb
adler2	adler2
date	date
mult	mult
safe_level	safe_level
pop	pop
tile	tile
adler32	adler32
RSS::Utils	RSS::Utils
ignored	ignored
xlist	xlist
mdns	mdns
Fiddle::Importer	Fiddle::Importer
map=	map=
size	size
TkResourceDB	TkResourceDB
thgrp	thgrp
gemdependencyapi	gemdependencyapi
hsh_or_hash	hsh_or_hash
Vector	Vector
unescapehtml	unescapehtml
toplevel	toplevel
expect	expect
tcltkip	tcltkip
other_hash	other_hash
parse	parse
charset	charset
chroot	chroot
OpenSSL::HMAC	OpenSSL::HMAC
Variable	Variable
OpenSSL::X509::Name	OpenSSL::X509::Name
tag_maker	tag_maker
ali	ali
arity	arity
entries	entries
Gem::Source::SpecificFile	Gem::Source::SpecificFile
Gem::TestCase::SpecFetcherSetup	Gem::TestCase::SpecFetcherSetup
aliases	aliases
arg_check	arg_check
authors	authors
stack	stack
Rinda::TupleEntry	Rinda::TupleEntry
getsockopt	getsockopt
hypot	hypot
npn	npn
curselection	curselection
documenting=	documenting=
memberwise	memberwise
Rinda::NotifyTemplateEntry	Rinda::NotifyTemplateEntry
rinda	rinda
tail	tail
CGI::Cookie	CGI::Cookie
XMLRPC::Base64	XMLRPC::Base64
REXML::Document	REXML::Document
ios	ios
cd	cd
Addrinfo	Addrinfo
tottonly	tottonly
clear	clear
Date	Date
WEBrick::HTTPAuth::Htpasswd	WEBrick::HTTPAuth::Htpasswd
WIN32OLE_TYPE	WIN32OLE_TYPE
title	title
installerset	installerset
finalizer	finalizer
require	require
api_data	api_data
RDoc::I18n::Locale	RDoc::I18n::Locale
cookie2	cookie2
allowed_push_host	allowed_push_host
second	second
port	port
currentcontext	currentcontext
&blok;	&blok;
unknown	unknown
drbref	drbref
OpenSSL::X509::Store	OpenSSL::X509::Store
waitall	waitall
in	in
comment=	comment=
ydbm	ydbm
inline	inline
taint	taint
deduplicate	deduplicate
kind	kind
fd	fd
apopsession	apopsession
angle	angle
eql	eql
INTERP	INTERP
<	<
terminate	terminate
ignore_unknown_element	ignore_unknown_element
platform	platform
acl	acl
symbols	symbols
display	display
XMLRPC::ParserWriterChooseMixin	XMLRPC::ParserWriterChooseMixin
requester	requester
julian	julian
total_bytes	total_bytes
node_set	node_set
net	net
REXML::Child	REXML::Child
-1,_0,_1,_	-1,_0,_1,_
setruid	setruid
Gem::Package::TarReader	Gem::Package::TarReader
Gem::DependencyList	Gem::DependencyList
tags	tags
subsec	subsec
paranoid	paranoid
irbloader	irbloader
ret	ret
sec	sec
indices	indices
checked	checked
receiver	receiver
length	length
klass_name	klass_name
blockcaller	blockcaller
slice	slice
iwidgets	iwidgets
renew	renew
generate_ri	generate_ri
Exception	Exception
choose	choose
base_notifier	base_notifier
RDoc::Markup::TextFormatterTestCase	RDoc::Markup::TextFormatterTestCase
pointer	pointer
OpenSSL::PKCS12	OpenSSL::PKCS12
endpwent	endpwent
RSS::Atom::TextConstruct	RSS::Atom::TextConstruct
print	print
new_sources	new_sources
object_id	object_id
dlload	dlload
inc	inc
newlines	newlines
index:	index:
Float	Float
shellsplit	shellsplit
hash	hash
patch	patch
mutex	mutex
new	new
error	error
sourcefetchproblem	sourcefetchproblem
dependencylist	dependencylist
byteslice	byteslice
log10	log10
maxwidth	maxwidth
generic	generic
RDoc	RDoc
freeze	freeze
public	public
deletable	deletable
redisplay	redisplay
Gem::Security::Signer	Gem::Security::Signer
md5	md5
blocksize	blocksize
Benchmark::Tms	Benchmark::Tms
address_family	address_family
Gem::Resolver::Molinillo::SpecificationProvider	Gem::Resolver::Molinillo::SpecificationProvider
OpenSSL::Cipher	OpenSSL::Cipher
htpasswd	htpasswd
freefunc	freefunc
switch	switch
Abbrev	Abbrev
pot	pot
digest_obj	digest_obj
WEBrick::Utils::TimeoutHandler	WEBrick::Utils::TimeoutHandler
WEBrick::HTTPServlet::AbstractServlet	WEBrick::HTTPServlet::AbstractServlet
align	align
extra	extra
expires	expires
Gem::Specification	Gem::Specification
installed	installed
logdev	logdev
pattern	pattern
poentry	poentry
BigDecimal	BigDecimal
unbind	unbind
ripper	ripper
abi	abi
dummy	dummy
refine	refine
Signal	Signal
file=	file=
class_loader	class_loader
int_or_rat	int_or_rat
alpn	alpn
process	process
vertex	vertex
other_spec	other_spec
confstr	confstr
DRb::DRbUnknown	DRb::DRbUnknown
dh	dh
var	var
smtp	smtp
Fiddle	Fiddle
errors	errors
sha2	sha2
vstack	vstack
private	private
mode_int	mode_int
et	et
even	even
addresses	addresses
gather	gather
argv0	argv0
predicate	predicate
arguments...	arguments...
cwyear	cwyear
packagetask	packagetask
Gem::StreamUI::VerboseProgressReporter	Gem::StreamUI::VerboseProgressReporter
Gem::Package::Old	Gem::Package::Old
age	age
hyperlink	hyperlink
RDoc::Mixin	RDoc::Mixin
pending	pending
verbose=	verbose=
iseq	iseq
introspection	introspection
transfer	transfer
methodresponse	methodresponse
true,_false	true,_false
itself	itself
owner	owner
prettyprint	prettyprint
waiting	waiting
makefile	makefile
compositehandler	compositehandler
Gem::LocalRemoteOptions	Gem::LocalRemoteOptions
klasses	klasses
module	module
stubs	stubs
input	input
caption	caption
syswrite	syswrite
toansi	toansi
stringinputmethod	stringinputmethod
locations	locations
Set	Set
beginning	beginning
underscore	underscore
ppmethods	ppmethods
hexdigest	hexdigest
inspect	inspect
getservername	getservername
pkey	pkey
binmode:	binmode:
stringscanner	stringscanner
digest	digest
hermitian	hermitian
dependencygraph	dependencygraph
integer_cmd	integer_cmd
remote_host	remote_host
UncaughtThrowError	UncaughtThrowError
previous	previous
3	3
rationalize	rationalize
padding	padding
&block;	&block;
p_pass	p_pass
signer_cert	signer_cert
from_str	from_str
minmax	minmax
RDoc::Context	RDoc::Context
srcdir	srcdir
alias	alias
c	c
tk	tk
ipaddr	ipaddr
Shell	Shell
set	set
children	children
textconstruct	textconstruct
writer	writer
serial	serial
peg	peg
queryextension	queryextension
win32ole_method	win32ole_method
wrap	wrap
clone	clone
restrictedstream	restrictedstream
statement	statement
handles	handles
dependencystate	dependencystate
&callback;	&callback;
GC::Profiler	GC::Profiler
button	button
DRb::DRbRemoteError	DRb::DRbRemoteError
day=	day=
Net::FTP	Net::FTP
RDoc::Markup::IndentedParagraph	RDoc::Markup::IndentedParagraph
failed_dep	failed_dep
&response;_handler	&response;_handler
Rinda::RingFinger	Rinda::RingFinger
child	child
also_in	also_in
full_name	full_name
format_args	format_args
sslcontext	sslcontext
subdirectories	subdirectories
report	report
setegid	setegid
checkbox	checkbox
ttl	ttl
paths	paths
tag_class	tag_class
after	after
autoclose	autoclose
power	power
list_item	list_item
jobmanager	jobmanager
grpowned	grpowned
Psych::ScalarScanner	Psych::ScalarScanner
rect	rect
signer	signer
body_file	body_file
constructive	constructive
directive	directive
store=	store=
win32ole_typelib	win32ole_typelib
verbose	verbose
&proc;	&proc;
WIN32OLE_EVENT	WIN32OLE_EVENT
exchangeable	exchangeable
git	git
pullevent	pullevent
editing	editing
certificate_file	certificate_file
installedspecification	installedspecification
RDoc::Markup::ToHtml	RDoc::Markup::ToHtml
stdin	stdin
meth_obj	meth_obj
more	more
symlink	symlink
entities	entities
**	**
op	op
tcltkvariable	tcltkvariable
heading	heading
kconv	kconv
generic_readable	generic_readable
element_name	element_name
engines	engines
sslserver	sslserver
consider	consider
undefined	undefined
>>	>>
new_timeout	new_timeout
scheme=	scheme=
Gem::UriFormatter	Gem::UriFormatter
TracePoint	TracePoint
httpheader	httpheader
inlineparser	inlineparser
infinity	infinity
section	section
asset	asset
enter	enter
selector	selector
tkresourcedb	tkresourcedb
predecessors	predecessors
s	s
Fiddle::CStructEntity	Fiddle::CStructEntity
static	static
cofactor	cofactor
enums	enums
stats	stats
parsers	parsers
request_class	request_class
MonitorMixin	MonitorMixin
basiclog	basiclog
rdoctask	rdoctask
gmt	gmt
RDoc::Markup::ToTtOnly	RDoc::Markup::ToTtOnly
indent	indent
der	der
to_append	to_append
certid	certid
run	run
REXML::XMLDecl	REXML::XMLDecl
DRb::DRbSSLSocket	DRb::DRbSSLSocket
XMLRPC::Convert	XMLRPC::Convert
open3	open3
tcllib	tcllib
full	full
matchdata	matchdata
0_or_float	0_or_float
invkind	invkind
quick	quick
XMLRPC::CGIServer	XMLRPC::CGIServer
#	#
pktinfo	pktinfo
to_str	to_str
getpgrp	getpgrp
alien	alien
TCPServer	TCPServer
tojoinedparagraph	tojoinedparagraph
advise	advise
loader	loader
RubyVM::InstructionSequence	RubyVM::InstructionSequence
archetype	archetype
Gem::SilentUI	Gem::SilentUI
schemes	schemes
RDoc::Stats::Normal	RDoc::Stats::Normal
:file	:file
<<	<<
sanitize	sanitize
progids	progids
io,_true	io,_true
tv	tv
SOCKSSocket	SOCKSSocket
private_key	private_key
arg_list	arg_list
enctype	enctype
tablelist_tile	tablelist_tile
other_meth	other_meth
uncaughtthrowerror	uncaughtthrowerror
arguments	arguments
nkf	nkf
JSON::Ext::Generator::GeneratorMethods::String::Extend	JSON::Ext::Generator::GeneratorMethods::String::Extend
getaddrinfo	getaddrinfo
JSON::Ext::Generator::GeneratorMethods::Float	JSON::Ext::Generator::GeneratorMethods::Float
install_dir	install_dir
readpartial	readpartial
RDoc::Options	RDoc::Options
uid=	uid=
locking_constant	locking_constant
groups=	groups=
handler	handler
SDBM	SDBM
levenshtein	levenshtein
resolv	resolv
Gem::Package::TarWriter	Gem::Package::TarWriter
filter=	filter=
proc	proc
headers=	headers=
v4mapped	v4mapped
cross	cross
minor	minor
PhotoImage	PhotoImage
cgi	cgi
lineno	lineno
broadcast_list	broadcast_list
inspector	inspector
WEBrick::GenericServer	WEBrick::GenericServer
reverse_lookup	reverse_lookup
mac_iter	mac_iter
validation	validation
caller	caller
stdout=	stdout=
security	security
calculate	calculate
parseable	parseable
TSort	TSort
sys	sys
classmodule	classmodule
Tk::Itk::Archetype	Tk::Itk::Archetype
conv	conv
OpenSSL::PKCS5	OpenSSL::PKCS5
dirs	dirs
tuesday	tuesday
nilclass	nilclass
error_prefix	error_prefix
versionoption	versionoption
union	union
value	value
rfc2396_parser	rfc2396_parser
TkcGroup	TkcGroup
Gem::NoAliasYAMLTree	Gem::NoAliasYAMLTree
connect	connect
Gem::Package::DigestIO	Gem::Package::DigestIO
listener	listener
nread	nread
quoted	quoted
program	program
avail	avail
OpenSSL::PKCS7	OpenSSL::PKCS7
output=	output=
XMLRPC::ModRubyServer	XMLRPC::ModRubyServer
flush	flush
indexspecification	indexspecification
pp	pp
trap	trap
policy	policy
only	only
OpenSSL::PKey::DH	OpenSSL::PKey::DH
RDoc::Generator::POT::PO	RDoc::Generator::POT::PO
sum	sum
elements	elements
directories	directories
needed	needed
top_level	top_level
program_name	program_name
WEBrick::HTTPStatus	WEBrick::HTTPStatus
REXML::Node	REXML::Node
completion	completion
translate	translate
tcp	tcp
converter	converter
platformmismatch	platformmismatch
pub_sys	pub_sys
charset=	charset=
Gem::Resolver::Molinillo::Resolver	Gem::Resolver::Molinillo::Resolver
)	)
cmsg_type	cmsg_type
syslog=	syslog=
space	space
Socket::UDPSource	Socket::UDPSource
RDoc::RI::Paths	RDoc::RI::Paths
clobber	clobber
&hook;	&hook;
facility	facility
WEBrick::HTTPVersion	WEBrick::HTTPVersion
cert_chain	cert_chain
origin	origin
suspend	suspend
ostruct	ostruct
REXML::Functions	REXML::Functions
messageextractor	messageextractor
IRB::Notifier::CompositeNotifier	IRB::Notifier::CompositeNotifier
matching	matching
gzipwriter	gzipwriter
tdata	tdata
IRB::OutputMethod	IRB::OutputMethod
[]	[]
URI	URI
Gem::TestCase::StaticSet	Gem::TestCase::StaticSet
page_name	page_name
localremoteoptions	localremoteoptions
TkMsgCatalog	TkMsgCatalog
messages	messages
coder	coder
warning	warning
OpenSSL::SSL::SSLContext	OpenSSL::SSL::SSLContext
matches	matches
isutf8	isutf8
fcntl	fcntl
connected	connected
WEBrick::HTTPResponse	WEBrick::HTTPResponse
gem_home	gem_home
Gem::Package::TarReader::Entry	Gem::Package::TarReader::Entry
setter	setter
paging	paging
rectangular	rectangular
case	case
installation	installation
part	part
tcpsocket	tcpsocket
cosh	cosh
Zlib::Deflate	Zlib::Deflate
configfile	configfile
tymap	tymap
notation	notation
password=	password=
include_path	include_path
sender	sender
coding	coding
typecode=	typecode=
CGI::Session::NullStore	CGI::Session::NullStore
quote	quote
div	div
undoc	undoc
mails	mails
temp	temp
decrypt	decrypt
RDoc::RubygemsHook	RDoc::RubygemsHook
IRB	IRB
rid	rid
abbrev	abbrev
prerelease	prerelease
integer	integer
class_name	class_name
adding	adding
put	put
Tk::Menu::TkInternalFunction	Tk::Menu::TkInternalFunction
tuplebag	tuplebag
sequences	sequences
superset	superset
name	name
,_-1,_+1	,_-1,_+1
WeakRef	WeakRef
socket	socket
slave	slave
mlsd	mlsd
cipher	cipher
object_nl	object_nl
q	q
row_count	row_count
cmd	cmd
[]=	[]=
gems	gems
Rinda::RingServer	Rinda::RingServer
JSON::Ext::Generator::GeneratorMethods::Object	JSON::Ext::Generator::GeneratorMethods::Object
Enumerable	Enumerable
snippet	snippet
00:00:00	00:00:00
native	native
userdb	userdb
prefixes	prefixes
digits	digits
initheader	initheader
result	result
Gem::Resolver::InstalledSpecification	Gem::Resolver::InstalledSpecification
RDoc::Stats::Quiet	RDoc::Stats::Quiet
detach	detach
Gem::ConfigFile	Gem::ConfigFile
getpriority	getpriority
dlunwrap	dlunwrap
dep_name	dep_name
CSV::Row	CSV::Row
reload_db	reload_db
callee	callee
BasicSocket	BasicSocket
o	o
sysopen	sysopen
OpenSSL::SSL::SSLSocket	OpenSSL::SSL::SSLSocket
link	link
UnboundMethod	UnboundMethod
rubyvm	rubyvm
sin	sin
NoMethodError	NoMethodError
ev	ev
out=	out=
singleton	singleton
echo	echo
objectspace	objectspace
formatter	formatter
dirname	dirname
addrinfo	addrinfo
gem_deps_file	gem_deps_file
Net::HTTP	Net::HTTP
parent_generator	parent_generator
peeraddr	peeraddr
multi	multi
convert	convert
new_name	new_name
crossref	crossref
home	home
plus	plus
Gem::Source::Lock	Gem::Source::Lock
WEBrick::HTTPAuth	WEBrick::HTTPAuth
expiration	expiration
getsockname	getsockname
readchar	readchar
priority_mask	priority_mask
streamui	streamui
floor	floor
fatal	fatal
maxcontrollen	maxcontrollen
prng	prng
split	split
htmlextension	htmlextension
untrust	untrust
other_entry	other_entry
Time	Time
typeclass	typeclass
filename	filename
comment_location	comment_location
generation	generation
finished	finished
OpenSSL::SSL::Session	OpenSSL::SSL::Session
fixnum	fixnum
RDoc::Markup::ToHtmlCrossref	RDoc::Markup::ToHtmlCrossref
ie_hack	ie_hack
insert	insert
SingleForwardable	SingleForwardable
rd	rd
JSON::Ext::Generator::GeneratorMethods::Fixnum	JSON::Ext::Generator::GeneratorMethods::Fixnum
sock	sock
detect	detect
IRB::Notifier::LeveledNotifier	IRB::Notifier::LeveledNotifier
family	family
source_encoding	source_encoding
sclass_var	sclass_var
line	line
attributemanager	attributemanager
WEBrick::Cookie	WEBrick::Cookie
CGI::Session	CGI::Session
canonical	canonical
close_obj	close_obj
xpath	xpath
http	http
priority_level	priority_level
shebang	shebang
array_of_rows	array_of_rows
gregorian	gregorian
strings	strings
voidcmd	voidcmd
nonce	nonce
unadvise	unadvise
Gem::Resolver::VendorSpecification	Gem::Resolver::VendorSpecification
RDoc::Markup::PreProcess	RDoc::Markup::PreProcess
product	product
ip	ip
output	output
resolve	resolve
limit=	limit=
element	element
time:	time:
Gem::AvailableSet	Gem::AvailableSet
pack	pack
saturday	saturday
Open3	Open3
system_call_error	system_call_error
resolver	resolver
Gem::Resolver::APISet	Gem::Resolver::APISet
io	io
|(args	|(args
auto	auto
cutime	cutime
dig	dig
created	created
x509	x509
msgstr	msgstr
profiler__	profiler__
indexset	indexset
bin	bin
flag	flag
"env	"env
syslog	syslog
title=	title=
progress	progress
info	info
wednesday	wednesday
html	html
add_hist	add_hist
benchmark	benchmark
Gem::Resolver::IndexSet	Gem::Resolver::IndexSet
popmail	popmail
ordinal	ordinal
uptodate	uptodate
unsatisfied	unsatisfied
prefix_suffix	prefix_suffix
num_files	num_files
skip_nl	skip_nl
canonname	canonname
hmac	hmac
direct	direct
friendly	friendly
extension	extension
lupdecomposition	lupdecomposition
file_content	file_content
CGI::Session::MemoryStore	CGI::Session::MemoryStore
addr	addr
ap_path	ap_path
ary_or_hash	ary_or_hash
availableset	availableset
Gem::Package::TarWriter::BoundedStream	Gem::Package::TarWriter::BoundedStream
Module	Module
realpath	realpath
WEBrick::HTTPServlet::ERBHandler	WEBrick::HTTPServlet::ERBHandler
Gem::Resolver::Molinillo::ResolutionState	Gem::Resolver::Molinillo::ResolutionState
Zlib::Inflate	Zlib::Inflate
listeners	listeners
frozen	frozen
Jacobian	Jacobian
Zlib::GzipFile::Error	Zlib::GzipFile::Error
sdbm	sdbm
page	page
basicauth	basicauth
command_name	command_name
res	res
sub	sub
normalize	normalize
index	index
distance	distance
constants	constants
allocation	allocation
other_rxp	other_rxp
ifdefs	ifdefs
argtype	argtype
quiet	quiet
template_file	template_file
uri	uri
untrace	untrace
trace	trace
tomdoc	tomdoc
mask	mask
RDoc::Context::Section	RDoc::Context::Section
accesslog	accesslog
mainloop	mainloop
fnmatch	fnmatch
getnameinfo	getnameinfo
blank	blank
optparse	optparse
loop	loop
realdirpath	realdirpath
rm	rm
before=	before=
tobs	tobs
combination	combination
RDoc::RubyLex	RDoc::RubyLex
exclusive	exclusive
Readline	Readline
on	on
ctrl	ctrl
tar	tar
ENV	ENV
:string	:string
RDoc::Markup::Include	RDoc::Markup::Include
explain	explain
is	is
"false	"false
gethostname	gethostname
makers	makers
need	need
notifier	notifier
result_hash	result_hash
simple	simple
numbytes_sent	numbytes_sent
queue	queue
mesg	mesg
mid	mid
ubound	ubound
utils	utils
fixed	fixed
inverse	inverse
apop	apop
staticset	staticset
words	words
friday	friday
OpenSSL::PKey::PKey	OpenSSL::PKey::PKey
also	also
REXML::StreamListener	REXML::StreamListener
gettablelistpath	gettablelistpath
setgid	setgid
sec=	sec=
file2	file2
-	-
label	label
...	...
RDoc::Markup::ToBs	RDoc::Markup::ToBs
magnitude	magnitude
extensions=	extensions=
mod	mod
chdir	chdir
eigenvalues	eigenvalues
drburi	drburi
elementdecl	elementdecl
win32ole_record	win32ole_record
debug	debug
api_key	api_key
normal	normal
duration	duration
RDoc::Generator::RI	RDoc::Generator::RI
doctor	doctor
Gem::Installer	Gem::Installer
instruction	instruction
flow	flow
internalobjectwrapper	internalobjectwrapper
Find	Find
subject	subject
ascend	ascend
drbidconv	drbidconv
classes	classes
requirementlist	requirementlist
StringIO	StringIO
passwd	passwd
rfc3339	rfc3339
boolean	boolean
nested	nested
dn	dn
key	key
p	p
requestset	requestset
attribute	attribute
codeobject	codeobject
OpenSSL::ASN1	OpenSSL::ASN1
off	off
an_object	an_object
ld	ld
mime	mime
Digest::Class	Digest::Class
mkcol	mkcol
fullpath	fullpath
getname	getname
Psych::Emitter	Psych::Emitter
BigMath	BigMath
tuplespaceproxy	tuplespaceproxy
descend	descend
size:	size:
cur_limit	cur_limit
unpackcommand	unpackcommand
Net::IMAP::NumValidator	Net::IMAP::NumValidator
toeuc	toeuc
bodytypetext	bodytypetext
newname	newname
long_name	long_name
mac	mac
handler=	handler=
parts	parts
DRb::DRbServer	DRb::DRbServer
chardev	chardev
syncenumerator	syncenumerator
cond	cond
target_path	target_path
capable	capable
authenticator	authenticator
rmtree	rmtree
gemspecs	gemspecs
open_args	open_args
post	post
encrypt	encrypt
runtime	runtime
base64	base64
WIN32OLE_VARIABLE	WIN32OLE_VARIABLE
ro	ro
config	config
original	original
rehash	rehash
integer_or_float	integer_or_float
ifindex	ifindex
include_super	include_super
Process	Process
optionparser	optionparser
Resolv::IPv6	Resolv::IPv6
wday	wday
WEBrick::Daemon	WEBrick::Daemon
ns	ns
key_pbe	key_pbe
OpenSSL::PKey::EC	OpenSSL::PKey::EC
Gem::Requirement	Gem::Requirement
umask	umask
xmlparser	xmlparser
change	change
getifaddrs	getifaddrs
atan	atan
c_parser	c_parser
RDoc::Markup::List	RDoc::Markup::List
error_array	error_array
streamlistener	streamlistener
setbyte	setbyte
each_child	each_child
activate	activate
TkComm	TkComm
see	see
map	map
weakmap	weakmap
authenticated	authenticated
asctime	asctime
WEBrick::HTTPStatus::Status	WEBrick::HTTPStatus::Status
definition	definition
un	un
begin	begin
Gem::CommandManager	Gem::CommandManager
sax2listener	sax2listener
iter	iter
to	to
method_name	method_name
RDoc::Markup::ToHtmlSnippet	RDoc::Markup::ToHtmlSnippet
URI::LDAP	URI::LDAP
''	''
refname	refname
chain	chain
Kconv	Kconv
y	y
format=	format=
OpenSSL::PKey::RSA	OpenSSL::PKey::RSA
push	push
prepended	prepended
attrspan	attrspan
k	k
Gem::SystemExitException	Gem::SystemExitException
silent	silent
RDoc::I18n::Text	RDoc::I18n::Text
PTY	PTY
ui=	ui=
context	context
Tk::Iwidgets::Hierarchy	Tk::Iwidgets::Hierarchy
disassemble	disassemble
cvs	cvs
setpwent	setpwent
TkPhotoImage	TkPhotoImage
TrueClass	TrueClass
replacement	replacement
&b;	&b;
(true	(true
unregister	unregister
accept	accept
allowed	allowed
pipeline	pipeline
REXML::Formatters::Default	REXML::Formatters::Default
memorystore	memorystore
str2	str2
output:	output:
orglocal	orglocal
gemdeps	gemdeps
installupdateoptions	installupdateoptions
close	close
sorted	sorted
Gem::Version	Gem::Version
add	add
big	big
reason	reason
emacs	emacs
compare	compare
isindex:	isindex:
Prime::TrialDivision	Prime::TrialDivision
legacy	legacy
b	b
XMLRPC::Client::Proxy	XMLRPC::Client::Proxy
TclTkCallback	TclTkCallback
rng	rng
address	address
subscribe	subscribe
url	url
remote_addr_args	remote_addr_args
parens	parens
Shellwords	Shellwords
unspecified	unspecified
newmode	newmode
n	n
tee	tee
protocol	protocol
inner	inner
external	external
roots	roots
command	command
substring	substring
enumerator	enumerator
scan	scan
isdst	isdst
makemakefile	makemakefile
unsatisfiabledependencyerror	unsatisfiabledependencyerror
Gem::NameTuple	Gem::NameTuple
linklocal	linklocal
IO	IO
children=	children=
bigmath	bigmath
modifiers	modifiers
nodoc	nodoc
setresuid	setresuid
signature	signature
getservbyname	getservbyname
Psych::Nodes::Mapping	Psych::Nodes::Mapping
stdout	stdout
tkmsgcatalog	tkmsgcatalog
p_addr	p_addr
RDoc::Constant	RDoc::Constant
revocation_time	revocation_time
RSS::Atom::Entry	RSS::Atom::Entry
history	history
classify	classify
"	"
Syslog::Logger	Syslog::Logger
httpdate	httpdate
zone	zone
mon	mon
star	star
remote	remote
file1	file1
bindir	bindir
bin_file_name	bin_file_name
outputmethod	outputmethod
gsub	gsub
fileutils	fileutils
entity_filter	entity_filter
OptionParser::ParseError	OptionParser::ParseError
permitted	permitted
authenticate	authenticate
specials	specials
obj...	obj...
from	from
reduce	reduce
v	v
domainname	domainname
current=	current=
readbyte	readbyte
sqrt	sqrt
day	day
ACL	ACL
Etc	Etc
parser=	parser=
Resolv::DNS::Resource::HINFO	Resolv::DNS::Resource::HINFO
ignore_error:	ignore_error:
register	register
absolute_name	absolute_name
teardown	teardown
socketoption	socketoption
contextextender	contextextender
cm	cm
the_type_library_name	the_type_library_name
conflicts	conflicts
ungetc	ungetc
include	include
singleline	singleline
abs_file_name	abs_file_name
fragment	fragment
call	call
cmsg_level	cmsg_level
MonitorMixin::ConditionVariable	MonitorMixin::ConditionVariable
RDoc::Markup::HardBreak	RDoc::Markup::HardBreak
chunk	chunk
email	email
pre	pre
ongoing	ongoing
WEBrick::HTTPUtils::FormData	WEBrick::HTTPUtils::FormData
block_parser	block_parser
path=	path=
opts	opts
bigdecimal	bigdecimal
space_before	space_before
pem	pem
before	before
Ripper::Filter	Ripper::Filter
setpgrp	setpgrp
CGI::Session::PStore	CGI::Session::PStore
utc	utc
vtbl	vtbl
each2	each2
all_hash	all_hash
OptionParser::Arguable	OptionParser::Arguable
nonblock	nonblock
REXML::SAX2Listener	REXML::SAX2Listener
getacl	getacl
RDoc::SingleClass	RDoc::SingleClass
ipsocket	ipsocket
combobox	combobox
installertestcase	installertestcase
gets	gets
Complex	Complex
OpenSSL::BN	OpenSSL::BN
allow	allow
drbobjecttemplate	drbobjecttemplate
dup	dup
ssl	ssl
correct	correct
const_name	const_name
/	/
cmp	cmp
exclude_pattern	exclude_pattern
return_value_of_method.	return_value_of_method.
plain	plain
t	t
erbio	erbio
sort_keys	sort_keys
pid	pid
ndigits	ndigits
content	content
IPAddr	IPAddr
apispecification	apispecification
DRb::DRbProtocol	DRb::DRbProtocol
tokenizer	tokenizer
user	user
placedargument	placedargument
rest_offset	rest_offset
sendcmd	sendcmd
element=	element=
based	based
DRb	DRb
MultiTkIp	MultiTkIp
RDoc::Servlet	RDoc::Servlet
xmp	xmp
salt	salt
xmlrpc	xmlrpc
nonzero	nonzero
h	h
Tk::Iwidgets::Selectiondialog	Tk::Iwidgets::Selectiondialog
varkind	varkind
stat	stat
RDoc::Attr	RDoc::Attr
ioflush	ioflush
RDoc::TestCase	RDoc::TestCase
Gem::Resolver::Molinillo::DependencyState	Gem::Resolver::Molinillo::DependencyState
changed	changed
cstructentity	cstructentity
length=	length=
rf	rf
cstime	cstime
sessions	sessions
helpcontext	helpcontext
Resolv::IPv4	Resolv::IPv4
sync_m	sync_m
Bignum	Bignum
request_set	request_set
DRb::TimerIdConv	DRb::TimerIdConv
profile	profile
dtd	dtd
Comparable	Comparable
ljust	ljust
self=	self=
matching_platform	matching_platform
updatecommand	updatecommand
symbol	symbol
indentedparagraph	indentedparagraph
ascii	ascii
dev	dev
image	image
ord	ord
IRB::IrbLoader	IRB::IrbLoader
Gem::InstallUpdateOptions	Gem::InstallUpdateOptions
RDoc::AnyMethod	RDoc::AnyMethod
iconv	iconv
converters	converters
closed	closed
Gem::ConsoleUI	Gem::ConsoleUI
Numeric	Numeric
rsa	rsa
numvalidator	numvalidator
clock	clock
phrase	phrase
sslsocket	sslsocket
_values	_values
iter_method	iter_method
rem	rem
genspace	genspace
Regexp	Regexp
base_name	base_name
status	status
shift_size	shift_size
denominator	denominator
Digest::Instance	Digest::Instance
plugins	plugins
OpenSSL::Buffering	OpenSSL::Buffering
img	img
extra_doc_dirs	extra_doc_dirs
terminal_message	terminal_message
Gem::FakeFetcher	Gem::FakeFetcher
alive	alive
initial	initial
doc	doc
RDoc::NormalClass	RDoc::NormalClass
ancdata	ancdata
ifaddr	ifaddr
boundedstream	boundedstream
attr_name	attr_name
expunge	expunge
chop	chop
ca	ca
ObjectSpace::InternalObjectWrapper	ObjectSpace::InternalObjectWrapper
login	login
Hash	Hash
gem_path	gem_path
Fiddle::CStructBuilder	Fiddle::CStructBuilder
RDoc::Store	RDoc::Store
from_addr	from_addr
enable	enable
argc	argc
severity	severity
ObjectSpace	ObjectSpace
compiler	compiler
args	args
ERB::DefMethod	ERB::DefMethod
mv	mv
ready	ready
Gem::Command	Gem::Command
deprecate	deprecate
username	username
server	server
userinteraction	userinteraction
delta	delta
ntop	ntop
nil	nil
outbuf	outbuf
LUSolve	LUSolve
sockopt	sockopt
extensions	extensions
lookup	lookup
tcltkcallback	tcltkcallback
Tk::Mac	Tk::Mac
mark	mark
documentation	documentation
dispid	dispid
member_name+>	member_name+>
ole_type	ole_type
provide	provide
compat	compat
ACL::ACLEntry	ACL::ACLEntry
Fixnum	Fixnum
sign	sign
signing_cert	signing_cert
characters	characters
abbreviate	abbreviate
fork	fork
value=	value=
tty	tty
Socket::AncillaryData	Socket::AncillaryData
RDoc::ClassModule	RDoc::ClassModule
signaled	signaled
light	light
token_type	token_type
inactive	inactive
json	json
edge	edge
RDoc::Markup	RDoc::Markup
'&'	'&'
kill	kill
column_count	column_count
val	val
Zlib::GzipWriter	Zlib::GzipWriter
named	named
regexp	regexp
Socket	Socket
XMLRPC::Client	XMLRPC::Client
endpoint	endpoint
element_ary	element_ary
su	su
unicode	unicode
percent	percent
uriformatter	uriformatter
Pathname	Pathname
httpversion	httpversion
WEBrick::HTTPRequest	WEBrick::HTTPRequest
by	by
invert	invert
group	group
time	time
history=	history=
verboseprogressreporter	verboseprogressreporter
Gem::BasicSpecification	Gem::BasicSpecification
Rinda::TupleSpace	Rinda::TupleSpace
SimpleDelegator	SimpleDelegator
possible	possible
src	src
www	www
lists	lists
XMP	XMP
divmod	divmod
ignore_constants	ignore_constants
signer_key	signer_key
accept_charset	accept_charset
certificate_id	certificate_id
validator	validator
release	release
REXML::Security	REXML::Security
RDoc::Markup::Attributes	RDoc::Markup::Attributes
attributes	attributes
list_type	list_type
declare	declare
raw_cookie	raw_cookie
basicobject	basicobject
popen2e	popen2e
destination_encoding	destination_encoding
testcase	testcase
wordy	wordy
trustdir	trustdir
cycle	cycle
unix	unix
annotate	annotate
dir	dir
*	*
datadir	datadir
pseudoprimegenerator	pseudoprimegenerator
Gem::Source::Vendor	Gem::Source::Vendor
issuer	issuer
try	try
toc	toc
as	as
XMLRPC::DateTime	XMLRPC::DateTime
retrlines	retrlines
int_enc	int_enc
seq=	seq=
thing	thing
win32ole_event	win32ole_event
rb	rb
normalclass	normalclass
z	z
source_buffer	source_buffer
find	find
inv	inv
added	added
libs	libs
Gem::Resolver	Gem::Resolver
xmlschema	xmlschema
Rinda::TemplateEntry	Rinda::TemplateEntry
defaultuserinteraction	defaultuserinteraction
paragraph	paragraph
defined	defined
erf	erf
const	const
setsockopt	setsockopt
Shell::CommandProcessor	Shell::CommandProcessor
OpenStruct	OpenStruct
cdata	cdata
absolute	absolute
REXML::DTD::EntityDecl	REXML::DTD::EntityDecl
doctype	doctype
form	form
matrix	matrix
unnormalized	unnormalized
Net::SMTP	Net::SMTP
configuration	configuration
local_path	local_path
WEBrick::HTTPAuth::BasicAuth	WEBrick::HTTPAuth::BasicAuth
Resolv::DNS::Name	Resolv::DNS::Name
req	req
comparable	comparable
attlistdecl	attlistdecl
option	option
check_parent	check_parent
blocks	blocks
current	current
to_enc	to_enc
WEBrick::Utils	WEBrick::Utils
r	r
author=	author=
expand	expand
other_str+	other_str+
importer	importer
REXML::Namespace	REXML::Namespace
URI::MailTo	URI::MailTo
unalias	unalias
peek	peek
tknamedfont	tknamedfont
extra_dirs	extra_dirs
flatten	flatten
aproc	aproc
hist	hist
escape8bit	escape8bit
success	success
Net::FTP::MLSxEntry	Net::FTP::MLSxEntry
IRB::FileInputMethod	IRB::FileInputMethod
entry	entry
&error;	&error;
Process::Status	Process::Status
month=	month=
tkinternalfunction	tkinternalfunction
separator:	separator:
rootwidget	rootwidget
variable	variable
unresolved	unresolved
+	+
Gem::Resolver::Molinillo::DependencyGraph	Gem::Resolver::Molinillo::DependencyGraph
true	true
source_file	source_file
bm	bm
restore	restore
atime	atime
rsa_instance	rsa_instance
tagging	tagging
REXML::Parsers::SAX2Parser	REXML::Parsers::SAX2Parser
ThreadsWait	ThreadsWait
client	client
passive=	passive=
issjis	issjis
stream	stream
changelog	changelog
commercial	commercial
encoding	encoding
memsize	memsize
psych	psych
Forwardable	Forwardable
multicall	multicall
exec	exec
httpresponse	httpresponse
extends	extends
record	record
tuplespace	tuplespace
modified	modified
col	col
imaginary	imaginary
drbunknown	drbunknown
default	default
imag	imag
getgrent	getgrent
write_array	write_array
signatures	signatures
month	month
backtrace	backtrace
RDoc::Markdown	RDoc::Markdown
map2	map2
now	now
send	send
userinfo	userinfo
from_enc	from_enc
selectiondialog	selectiondialog
p_port	p_port
WEBrick::CGI	WEBrick::CGI
mount	mount
eps	eps
service	service
recover	recover
version1	version1
both	both
tordoc	tordoc
pstore	pstore
p1	p1
conf	conf
sig	sig
of	of
script	script
codepage	codepage
multicast	multicast
ri	ri
extendcommandbundle	extendcommandbundle
exit=	exit=
openuri	openuri
arg2	arg2
generator_name	generator_name
statements	statements
Gem::Resolver::ComposedSet	Gem::Resolver::ComposedSet
privilege	privilege
BasicObject	BasicObject
running	running
paths=	paths=
mtch2	mtch2
getutc	getutc
pkcs12	pkcs12
odd	odd
covector	covector
development	development
cunionentity	cunionentity
gethostbyname	gethostbyname
systemcommand	systemcommand
indented	indented
mask=	mask=
non	non
buffer	buffer
stdlog	stdlog
fiber	fiber
transparency	transparency
body=	body=
bit	bit
silentui	silentui
drbarray	drbarray
author	author
signalexception	signalexception
search_keys	search_keys
a	a
waitpid2	waitpid2
undefinedconversionerror	undefinedconversionerror
convertible	convertible
credentials	credentials
response	response
coord	coord
space=	space=
deps	deps
sockssocket	sockssocket
old_list	old_list
equal	equal
uninstall	uninstall
orig	orig
async	async
requirable	requirable
usage	usage
packaging	packaging
OpenSSL::PKey	OpenSSL::PKey
return	return
with_directory	with_directory
drbprotocol	drbprotocol
total	total
prepend	prepend
init_proc	init_proc
number	number
SizedQueue	SizedQueue
normalized	normalized
desc	desc
CGI::HtmlExtension	CGI::HtmlExtension
Rinda::Template	Rinda::Template
sets	sets
sticky	sticky
relaxng	relaxng
Prime::PseudoPrimeGenerator	Prime::PseudoPrimeGenerator
dictionary	dictionary
unbound_method	unbound_method
specificfile	specificfile
sibling=	sibling=
DRb::GW	DRb::GW
Class	Class
rewind	rewind
decoded	decoded
block	block
rule	rule
WEBrick::HTTPServlet::DefaultFileHandler	WEBrick::HTTPServlet::DefaultFileHandler
reset	reset
Gem	Gem
compile	compile
allocate	allocate
github	github
select	select
strftime	strftime
RDoc::Generator::Markup	RDoc::Generator::Markup
signing_key	signing_key
methodattr	methodattr
rpartition	rpartition
gemcutterutilities	gemcutterutilities
Gem::Indexer	Gem::Indexer
generatormethods	generatormethods
RDoc::Markup::ToLabel	RDoc::Markup::ToLabel
s3	s3
TCPSocket	TCPSocket
Resolv::LOC::Size	Resolv::LOC::Size
cwday	cwday
Net::HTTPResponse	Net::HTTPResponse
ocsp	ocsp
exps	exps
define	define
a_rational	a_rational
configuration=	configuration=
stress	stress
requirement	requirement
gunzip	gunzip
file_descriptor	file_descriptor
pemmable	pemmable
RDoc::Text	RDoc::Text
sleep	sleep
delegate	delegate
kcode	kcode
swapcase	swapcase
limit	limit
getpeereid	getpeereid
Gem::Resolver::LockSpecification	Gem::Resolver::LockSpecification
executable	executable
pat1	pat1
cache	cache
Gem::UnsatisfiableDependencyError	Gem::UnsatisfiableDependencyError
%	%
"true	"true
OpenSSL::X509::Certificate	OpenSSL::X509::Certificate
serve	serve
ludecomp	ludecomp
strip	strip
RDoc::Generator::POT	RDoc::Generator::POT
type	type
character	character
htgroup	htgroup
phase	phase
fields	fields
emphasis	emphasis
end	end
independent	independent
bullet	bullet
opt	opt
min=	min=
Rinda::TupleBag	Rinda::TupleBag
=~	=~
combine	combine
eoutvar	eoutvar
REXML::NotationDecl	REXML::NotationDecl
catch	catch
Process::Sys	Process::Sys
othermod	othermod
euid=	euid=
tmpdir	tmpdir
check	check
anchor	anchor
Dir	Dir
specific	specific
stdin_data:	stdin_data:
gid=	gid=
tidylink	tidylink
jacobian	jacobian
anio	anio
unget	unget
dest	dest
simpledelegator	simpledelegator
proxy	proxy
1	1
RDoc::RD::BlockParser	RDoc::RD::BlockParser
Encoding::InvalidByteSequenceError	Encoding::InvalidByteSequenceError
structclass	structclass
mc	mc
writable	writable
columncget	columncget
cleanup	cleanup
regist	regist
new_value	new_value
offset	offset
idx	idx
write	write
PP	PP
deflate	deflate
realm	realm
uniq	uniq
maxdatalen	maxdatalen
egid	egid
&handler;	&handler;
padstr	padstr
molinillo	molinillo
order	order
arg...	arg...
Gem::Source::Local	Gem::Source::Local
message	message
WEBrick::HTTPServer	WEBrick::HTTPServer
sources	sources
is_ret	is_ret
device	device
OpenSSL::OCSP::BasicResponse	OpenSSL::OCSP::BasicResponse
range	range
chr	chr
os	os
command_line	command_line
guard	guard
OpenSSL::ASN1::Constructive	OpenSSL::ASN1::Constructive
wait2	wait2
prune	prune
directives	directives
tcltkcommand	tcltkcommand
next5	next5
document_children	document_children
system_exit	system_exit
Net::POPMail	Net::POPMail
RDoc::Markup::ToMarkdown	RDoc::Markup::ToMarkdown
p3	p3
query=	query=
GetoptLong	GetoptLong
Coverage	Coverage
RDoc::Alias	RDoc::Alias
socktype	socktype
profiler	profiler
reverse	reverse
getsid	getsid
fail	fail
truncate	truncate
config_or_acl	config_or_acl
trialdivision	trialdivision
permissions	permissions
fstr	fstr
dir_string	dir_string
permute	permute
objects	objects
nodes	nodes
gettime	gettime
anymethod	anymethod
rmdir	rmdir
optional	optional
getproperty	getproperty
window_bits	window_bits
rotate	rotate
formatters	formatters
Gem::StreamUI::SimpleProgressReporter	Gem::StreamUI::SimpleProgressReporter
starttls	starttls
base64digest	base64digest
mountpoint	mountpoint
RSS::Maker	RSS::Maker
href	href
WEBrick::HTTPAuth::Htgroup	WEBrick::HTTPAuth::Htgroup
intern	intern
drb	drb
xmldecl	xmldecl
lchmod	lchmod
maxlength	maxlength
fiddle_cptr	fiddle_cptr
Gem::Deprecate	Gem::Deprecate
parser	parser
?	?
darkfish	darkfish
lazy	lazy
represent	represent
tell	tell
Fiber	Fiber
year	year
flags	flags
subdomain	subdomain
lazy_enum	lazy_enum
crl	crl
strptime	strptime
path	path
required	required
RDoc::Encoding	RDoc::Encoding
Gem::PlatformMismatch	Gem::PlatformMismatch
RDoc::Markup::Raw	RDoc::Markup::Raw
summary	summary
casecmp	casecmp
abs	abs
ipv6only	ipv6only
using	using
verbatim	verbatim
photoimage	photoimage
arg	arg
JSON::Ext::Generator::GeneratorMethods::Hash	JSON::Ext::Generator::GeneratorMethods::Hash
httponly=	httponly=
apiset	apiset
WIN32OLE	WIN32OLE
ver	ver
permutation	permutation
synchronize	synchronize
radio	radio
license=	license=
fetcher	fetcher
pwd	pwd
IRB::Notifier::NoMsgNotifier	IRB::Notifier::NoMsgNotifier
getservbyport	getservbyport
extract	extract
continue	continue
adler1	adler1
abstractnotifier	abstractnotifier
ordering	ordering
rdoc	rdoc
sslconfig	sslconfig
gcdlcm	gcdlcm
the_type_library_file_path	the_type_library_file_path
item	item
rename	rename
usecompatibilitymetrics	usecompatibilitymetrics
menu	menu
processcontroller	processcontroller
ole	ole
RDoc::RD::Inline	RDoc::RD::Inline
port=	port=
specification	specification
foreach	foreach
vc	vc
setuid	setuid
markup	markup
OpenSSL::Config	OpenSSL::Config
old	old
no_method_error	no_method_error
procs	procs
waitpid	waitpid
read	read
domain	domain
base_directory	base_directory
subtype	subtype
an_enumerator	an_enumerator
conflicting	conflicting
shift_age	shift_age
delim	delim
quo	quo
char	char
resolvers	resolvers
sysverify	sysverify
version2	version2
-@	-@
macros	macros
bn	bn
build	build
certificateid	certificateid
Net::IMAP::BodyTypeText	Net::IMAP::BodyTypeText
include_all	include_all
sizedqueue	sizedqueue
version=	version=
fully	fully
civil	civil
Tk::Iwidgets::Entryfield	Tk::Iwidgets::Entryfield
descendant	descendant
start	start
app	app
child2	child2
refresh	refresh
subclass	subclass
terminated	terminated
class	class
failure	failure
vs	vs
helpstring	helpstring
servlet	servlet
export	export
optname	optname
ceil	ceil
cancel	cancel
===	===
Gem::Uninstaller	Gem::Uninstaller
xmlwriter	xmlwriter
stime	stime
'.')	'.')
fallback	fallback
csv	csv
method_body	method_body
OpenSSL::SSL::SSLServer	OpenSSL::SSL::SSLServer
blt	blt
new_password	new_password
metadata	metadata
localfile	localfile
siginfo	siginfo
Gem::Request	Gem::Request
getquotaroot	getquotaroot
base_method	base_method
matched	matched
Benchmark	Benchmark
Fiddle::Closure::BlockCaller	Fiddle::Closure::BlockCaller
unlink	unlink
aref	aref
pager	pager
repl	repl
RDoc::Comment	RDoc::Comment
RDoc::Markup::Document	RDoc::Markup::Document
to_addrs	to_addrs
readagain	readagain
TclTkVariable	TclTkVariable
row	row
Fiddle::Function	Fiddle::Function
silentprogressreporter	silentprogressreporter
Singleton	Singleton
timeout	timeout
sn	sn
scanf	scanf
delete	delete
simpleprogressreporter	simpleprogressreporter
hierarchy	hierarchy
numeric	numeric
delegator	delegator
Binding	Binding
maker	maker
suppressed	suppressed
abstractservlet	abstractservlet
upgrade	upgrade
UNIXServer	UNIXServer
IRB::Notifier::AbstractNotifier	IRB::Notifier::AbstractNotifier
DRb::DRbSSLSocket::SSLConfig	DRb::DRbSSLSocket::SSLConfig
dns.new	dns.new
sections	sections
CMath	CMath
Integer	Integer
feed	feed
media	media
subtract	subtract
FileTest	FileTest
suggest	suggest
reference	reference
force	force
challenge	challenge
OpenSSL::Engine	OpenSSL::Engine
Gem::Resolver::LocalSpecification	Gem::Resolver::LocalSpecification
platforms	platforms
Resolv::MDNS	Resolv::MDNS
binary=	binary=
marshal	marshal
includes	includes
readline	readline
ThreadGroup	ThreadGroup
signame	signame
footnote	footnote
fileinputmethod	fileinputmethod
string,_false	string,_false
coverage	coverage
maxlen	maxlen
coredump	coredump
auth_type	auth_type
getbyte	getbyte
unpack	unpack
ConditionVariable	ConditionVariable
Gem::DefaultUserInteraction	Gem::DefaultUserInteraction
port_number	port_number
RSS::BaseListener	RSS::BaseListener
bubblebabble	bubblebabble
versions	versions
commandprocessor	commandprocessor
peer	peer
formdata	formdata
Gem::Resolver::InstallerSet	Gem::Resolver::InstallerSet
rxp	rxp
passphrase	passphrase
indent=	indent=
sdone	sdone
location	location
DEBUGGER__	DEBUGGER__
IRB::StdioInputMethod	IRB::StdioInputMethod
safe	safe
CGI::Session::FileStore	CGI::Session::FileStore
tkstring	tkstring
Rational	Rational
win32ole_event_object.	win32ole_event_object.
OptionParser::CompletingHash	OptionParser::CompletingHash
Rinda::Tuple	Rinda::Tuple
OpenSSL::Netscape::SPKI	OpenSSL::Netscape::SPKI
string	string
reopen	reopen
threadswait	threadswait
collect2	collect2
<=	<=
pi	pi
local_addr_args	local_addr_args
po	po
extname	extname
arg1	arg1
Method	Method
svr	svr
ext_enc	ext_enc
tracer=	tracer=
unmount	unmount
noecho	noecho
ref	ref
RDoc::Parser::Simple	RDoc::Parser::Simple
WEBrick::HTTPServlet::FileHandler	WEBrick::HTTPServlet::FileHandler
num	num
Matrix::LUPDecomposition	Matrix::LUPDecomposition
help	help
other_str	other_str
exited	exited
unicodenormalize	unicodenormalize
-4712	-4712
printn	printn
found	found
Delegator	Delegator
crc32	crc32
line_no	line_no
REXML::Parent	REXML::Parent
tupleentry	tupleentry
timeouts=	timeouts=
width	width
bind	bind
nan	nan
processors	processors
superclass	superclass
svninfo	svninfo
use	use
parameters	parameters
zstream	zstream
IRB::Inspector	IRB::Inspector
atan2	atan2
ty	ty
Socket::Option	Socket::Option
sources=	sources=
config_info	config_info
sym	sym
tempfile	tempfile
ip6	ip6
RSS::Atom::DateConstruct	RSS::Atom::DateConstruct
netscape	netscape
scope=	scope=
eof	eof
notationdecl	notationdecl
conditionvariable	conditionvariable
Gem::SourceList	Gem::SourceList
remainder	remainder
shellescape	shellescape
erbhandler	erbhandler
alt	alt
msg	msg
rank	rank
unconverted	unconverted
Tk::Iwidgets::Promptdialog	Tk::Iwidgets::Promptdialog
date_time	date_time
stripchart	stripchart
eigenvectors	eigenvectors
OpenSSL::OCSP::Response	OpenSSL::OCSP::Response
dep_uri	dep_uri
win32ole_method_object	win32ole_method_object
klass	klass
sequence	sequence
special	special
srcprefix	srcprefix
keep	keep
self_hash	self_hash
totableofcontents	totableofcontents
typecode	typecode
byte	byte
RDoc::RD::InlineParser	RDoc::RD::InlineParser
SignalException	SignalException
given_name	given_name
remote_port	remote_port
Gem::Resolver::BestSet	Gem::Resolver::BestSet
numeric_result	numeric_result
nothing	nothing
strio	strio
objs	objs
cmds	cmds
out_stream	out_stream
replace	replace
respond	respond
rest	rest
commandmanager	commandmanager
Math	Math
command...	command...
checksums	checksums
mday	mday
entryfield	entryfield
data	data
save	save
Zlib::ZStream	Zlib::ZStream
password	password
markup_item	markup_item
reply	reply
{|(args	{|(args
Gem::Resolver::Specification	Gem::Resolver::Specification
tohtmlcrossref	tohtmlcrossref
do	do
REXML::Parsers::BaseParser	REXML::Parsers::BaseParser
creatable	creatable
showpreferences	showpreferences
escape	escape
RDoc::Parser::C	RDoc::Parser::C
merge	merge
typelib	typelib
REXML::SyncEnumerator	REXML::SyncEnumerator
free	free
escapeelement	escapeelement
eigensystem	eigensystem
accessor	accessor
initial_message	initial_message
Shell::Filter	Shell::Filter
meth	meth
OpenURI::Meta	OpenURI::Meta
can	can
comp	comp
anarray	anarray
oth	oth
readlines	readlines
captures	captures
Psych::Nodes::Node	Psych::Nodes::Node
CGI	CGI
notations	notations
tkafter	tkafter
sourcelist	sourcelist
completer	completer
secure	secure
succ	succ
defaults	defaults
screen	screen
WEBrick::HTTPAuth::UserDB	WEBrick::HTTPAuth::UserDB
host	host
inst	inst
PrettyPrint::SingleLine	PrettyPrint::SingleLine
RDoc::Markup::Rule	RDoc::Markup::Rule
racc	racc
key_iter	key_iter
obj1	obj1
RDoc::Parser::RubyTools	RDoc::Parser::RubyTools
division	division
dependencyrequest	dependencyrequest
garbage	garbage
jan	jan
free=	free=
OptionParser	OptionParser
Net::POP3	Net::POP3
WEBrick::HTMLUtils	WEBrick::HTMLUtils
block_quote	block_quote
getaddress	getaddress
URI::Generic	URI::Generic
obj	obj
idle	idle
getresources	getresources
RDoc::Markup::Parser	RDoc::Markup::Parser
collection	collection
scrolledcanvas	scrolledcanvas
class_var	class_var
exponent	exponent
struct	struct
backlog	backlog
self	self
idconv	idconv
syncmode	syncmode
unmask	unmask
max	max
is_established	is_established
table	table
listable	listable
sysaccept	sysaccept
owned	owned
lup	lup
call_type	call_type
open_tag	open_tag
possibility	possibility
Ripper	Ripper
ancillarydata	ancillarydata
callback=	callback=
visitor	visitor
unitary	unitary
p2	p2
Fiddle::CParser	Fiddle::CParser
charmap	charmap
observer	observer
markdown	markdown
exclude	exclude
bool	bool
exclude_end	exclude_end
consistency	consistency
max=	max=
function	function
instructionsequence	instructionsequence
RDoc::Markup::Special	RDoc::Markup::Special
getnames	getnames
unsubscribe	unsubscribe
RDoc::CrossReference	RDoc::CrossReference
yyerrok	yyerrok
Gem::Resolver::APISpecification	Gem::Resolver::APISpecification
an_array	an_array
yield	yield
mu	mu
Matrix::EigenvalueDecomposition	Matrix::EigenvalueDecomposition
Logger	Logger
httprequest	httprequest
files	files
tcltkinterpreter	tcltkinterpreter
security_policy	security_policy
specspecification	specspecification
storbinary	storbinary
>	>
optval	optval
requirements	requirements
driver	driver
hook	hook
REXML::Element	REXML::Element
id_map	id_map
tsort	tsort
long	long
basicserver	basicserver
level	level
partition	partition
visibility=	visibility=
sitelocal	sitelocal
anarray_or_obj	anarray_or_obj
Gem::TestCase	Gem::TestCase
prefetch	prefetch
substitution	substitution
priv	priv
boundary	boundary
OpenSSL::PKey::DSA	OpenSSL::PKey::DSA
setacl	setacl
resolutionstate	resolutionstate
join	join
variables	variables
blockdev	blockdev
Encoding::Converter	Encoding::Converter
rexml	rexml
ruby	ruby
utime	utime
WEBrick::HTTPAuth::Htdigest	WEBrick::HTTPAuth::Htdigest
hard_break	hard_break
fig	fig
toutf32	toutf32
URI::FTP	URI::FTP
Rinda::RingProvider	Rinda::RingProvider
header_row	header_row
ip_addr	ip_addr
OpenSSL::X509::Extension	OpenSSL::X509::Extension
Resolv::LOC::Coord	Resolv::LOC::Coord
destination_buffer	destination_buffer
0_or_false	0_or_false
mktmpdir	mktmpdir
ualpha	ualpha
super	super
REXML::Source	REXML::Source
fakefetcher	fakefetcher
RDoc::NormalModule	RDoc::NormalModule
Shell::ProcessController	Shell::ProcessController
descriptions	descriptions
termsig	termsig
_main	_main
token_stream	token_stream
gmtime	gmtime
fasttest	fasttest
here	here
code	code
must	must
tkphotoimage	tkphotoimage
point	point
RDocTask	RDocTask
JSON::Ext::Generator::GeneratorMethods::String	JSON::Ext::Generator::GeneratorMethods::String
each_node	each_node
mlst	mlst
superclass=	superclass=
WEBrick::BasicLog	WEBrick::BasicLog
getpwent	getpwent
installable	installable
service_name	service_name
REXML::Elements	REXML::Elements
fdatasync	fdatasync
nodename	nodename
tag_name	tag_name
locale_id	locale_id
File::Stat	File::Stat
parent=	parent=
new_ui	new_ui
rational	rational
dry_run	dry_run
console	console
OptionParser::List	OptionParser::List
padding:	padding:
ssl=	ssl=
request	request
sysread	sysread
always	always
modern	modern
RDoc::Require	RDoc::Require
append	append
tempio	tempio
+0000'	+0000'
allow_prerelease	allow_prerelease
content_type_string	content_type_string
gem_repository	gem_repository
task	task
seed	seed
Resolv	Resolv
threads	threads
get	get
filter	filter
puttextfile	puttextfile
logging	logging
audit	audit
callback	callback
recv	recv
Gem::Package::TarWriter::RestrictedStream	Gem::Package::TarWriter::RestrictedStream
enclosing	enclosing
lambda	lambda
windows	windows
Tk::Iwidgets::Combobox	Tk::Iwidgets::Combobox
&blk;	&blk;
NameError	NameError
non_block	non_block
pipe	pipe
ret_type	ret_type
eigenvector	eigenvector
Resolv::DNS	Resolv::DNS
headers_and_or_indices	headers_and_or_indices
collect	collect
disconnected	disconnected
win32	win32
REXML::QuickPath	REXML::QuickPath
dstaddr	dstaddr
Gem::StreamUI::SilentProgressReporter	Gem::StreamUI::SilentProgressReporter
OpenSSL::OCSP::Request	OpenSSL::OCSP::Request
query	query
compatible	compatible
noaliasyamltree	noaliasyamltree
hard	hard
TkAfter	TkAfter
dst	dst
array	array
Profiler__	Profiler__
TkOption	TkOption
trim_mode	trim_mode
ptr	ptr
rubylex	rubylex
pop3s	pop3s
functions	functions
force_doc	force_doc
threadgroup	threadgroup
tabs	tabs
interaction	interaction
vendor	vendor
<=>	<=>
eol	eol
ex	ex
RDoc::Generator::Darkfish	RDoc::Generator::Darkfish
OptionParser::Switch	OptionParser::Switch
xview	xview
quirks	quirks
bytes	bytes
Gem::UserInteraction	Gem::UserInteraction
File	File
RDoc::Markup::AttrSpan	RDoc::Markup::AttrSpan
PrettyPrint	PrettyPrint
certificates	certificates
Gem::PackageTask	Gem::PackageTask
the_win32ole_typelib_object	the_win32ole_typelib_object
gem	gem
IRB::MethodExtender	IRB::MethodExtender
asn1data	asn1data
Psych::Handler	Psych::Handler
leap	leap
cbrt	cbrt
win32ole_type_object	win32ole_type_object
unboundmethod	unboundmethod
exchange	exchange
cunion	cunion
&genspace;	&genspace;
seplist	seplist
other_stat	other_stat
composedset	composedset
empty	empty
TempIO	TempIO
Thread::Mutex	Thread::Mutex
requiredargument	requiredargument
Gem::Resolver::Molinillo::UI	Gem::Resolver::Molinillo::UI
dsa	dsa
httputils	httputils
Digest::SHA2	Digest::SHA2
intersect	intersect
math	math
fw	fw
close_width	close_width
code_object	code_object
dependencyinstaller	dependencyinstaller
basicsocket	basicsocket
$_	$_
node	node
interactive	interactive
seconds	seconds
-1,_0,_+1	-1,_0,_+1
stubbed	stubbed
fixnum,_bool	fixnum,_bool
objectid	objectid
https	https
Gem::RequestSet::Lockfile	Gem::RequestSet::Lockfile
RSS::Atom::Feed::Entry	RSS::Atom::Feed::Entry
keytype	keytype
basic	basic
gem_name	gem_name
acllist	acllist
gm	gm
deleted	deleted
filehandler	filehandler
contains	contains
tok	tok
typelibs	typelibs
observers	observers
and	and
break	break
nesting	nesting
IRB::Irb	IRB::Irb
jisx0301	jisx0301
crossreference	crossreference
rounding	rounding
singular	singular
opaque	opaque
concat	concat
pr	pr
end_pos	end_pos
typename	typename
exception	exception
newline	newline
RDoc::TopLevel	RDoc::TopLevel
say	say
options	options
TkOptionDB	TkOptionDB
explanation	explanation
repo	repo
out_file	out_file
binmode	binmode
qtrue_#_first_time	qtrue_#_first_time
xml	xml
use__charset_:	use__charset_:
chown	chown
implemented	implemented
hour=	hour=
datetime	datetime
unlink_now	unlink_now
RubyVM	RubyVM
gw	gw
exception:	exception:
remotefetcher	remotefetcher
openssl	openssl
local_sockaddr	local_sockaddr
bottom	bottom
exist	exist
lines	lines
Tempfile	Tempfile
builder	builder
blockparser	blockparser
component	component
getoptlong	getoptlong
pass_phrase	pass_phrase
→	→
level=	level=
ERB	ERB
getgrnam	getgrnam
atom	atom
indices_or_headers	indices_or_headers
RDoc::ERBPartial	RDoc::ERBPartial
cert	cert
userinfo=	userinfo=
begins	begins
ftp	ftp
signed	signed
satisfied	satisfied
modeline	modeline
ciphers	ciphers
uri_or_host	uri_or_host
arglists	arglists
exists	exists
lalpha	lalpha
win32ole_param	win32ole_param
enterable	enterable
inputmethod	inputmethod
Gem::SpecFetcher	Gem::SpecFetcher
Gem::Platform	Gem::Platform
uid	uid
read_array	read_array
erbpartial	erbpartial
action	action
name_error	name_error
URI::HTTP	URI::HTTP
XMLRPC::XMLWriter	XMLRPC::XMLWriter
FileUtils	FileUtils
ldexp	ldexp
helpfile	helpfile
Gem::Commands::UpdateCommand	Gem::Commands::UpdateCommand
tohtml	tohtml
sockaddr	sockaddr
Psych	Psych
LocalJumpError	LocalJumpError
fiddle	fiddle
iterator	iterator
activationrequest	activationrequest
IRB::Frame	IRB::Frame
pages	pages
depth	depth
no	no
separator	separator
shell	shell
vendorspecification	vendorspecification
infinite	infinite
filetest	filetest
triangular	triangular
yaml	yaml
world	world
spki	spki
Net::SMTP::Response	Net::SMTP::Response
included	included
digest_subclass	digest_subclass
ntoh	ntoh
mapped	mapped
mailbox	mailbox
from_name	from_name
gdbm	gdbm
files_so_far	files_so_far
rset	rset
sz	sz
ctime	ctime
FalseClass	FalseClass
cons	cons
tls	tls
sync	sync
daemon	daemon
assoc	assoc
rassoc	rassoc
enclose	enclose
funcs	funcs
between	between
rubygems	rubygems
drbobject	drbobject
min	min
win32ole_variable	win32ole_variable
events	events
sid	sid
unlock	unlock
email_address	email_address
len2	len2
tokenstream	tokenstream
win32ole	win32ole
str1	str1
class_module	class_module
primitive	primitive
digestauth	digestauth
name=	name=
last_modified	last_modified
OpenSSL::ASN1::ObjectId	OpenSSL::ASN1::ObjectId
the_type_library_major_version	the_type_library_major_version
instructions	instructions
Range	Range
ensure	ensure
tcpserver	tcpserver
TkNamedFont	TkNamedFont
shutdown	shutdown
logger	logger
search	search
silentdownloadreporter	silentdownloadreporter
has	has
ftype	ftype
RDoc::RDoc	RDoc::RDoc
OpenSSL::X509::Request	OpenSSL::X509::Request
strongly	strongly
workspace	workspace
Net::IMAP	Net::IMAP
observable	observable
drbserver	drbserver
margin	margin
codepoint	codepoint
registered	registered
relative	relative
vi	vi
zlib	zlib
Gem::VersionOption	Gem::VersionOption
local	local
OpenSSL	OpenSSL
RDoc::ERBIO	RDoc::ERBIO
values	values
RDoc::CodeObject	RDoc::CodeObject
rdev	rdev
allocated	allocated
mailto	mailto
constant	constant
Proc	Proc
Enumerator	Enumerator
vectors	vectors
maxconnections	maxconnections
pd	pd
prev	prev
interrupt	interrupt
log2	log2
upto	upto
specs	specs
header_name	header_name
rfc2822	rfc2822
encode64	encode64
style	style
TclTkInterpreter	TclTkInterpreter
nz	nz
Gem::Resolver::Molinillo::Resolver::Resolution	Gem::Resolver::Molinillo::Resolver::Resolution
jruby	jruby
pairs	pairs
getlocal	getlocal
Observable	Observable
RDoc::Markup::FormatterTestCase	RDoc::Markup::FormatterTestCase
Prime	Prime
REXML::Entity	REXML::Entity
readline=	readline=
cstructbuilder	cstructbuilder
RDoc::Markup::Paragraph	RDoc::Markup::Paragraph
namespaces	namespaces
pred	pred
enabled	enabled
requested	requested
msgid	msgid
oid	oid
id	id
single	single
nest	nest
signal	signal
erb_or_fname	erb_or_fname
evaluate	evaluate
loader=	loader=
bitmap	bitmap
ln	ln
check_load_path	check_load_path
guess	guess
cram	cram
link_name	link_name
licenses	licenses
ERB::Util	ERB::Util
ino	ino
complex	complex
mime_tab	mime_tab
getquota	getquota
filestore	filestore
shift	shift
explicit	explicit
environment	environment
log	log
rfc822	rfc822
locale_directory	locale_directory
rat	rat
lockfile	lockfile
final	final
ThWait	ThWait
spec	spec
helo	helo
waits	waits
Psych::Nodes::Scalar	Psych::Nodes::Scalar
tagorid	tagorid
column	column
chmod	chmod
Gem::Package	Gem::Package
completinghash	completinghash
inherited	inherited
major	major
rw	rw
main	main
preprocess	preprocess
Gem::RemoteFetcher	Gem::RemoteFetcher
other_symbol	other_symbol
DRb::DRbIdConv	DRb::DRbIdConv
expired_certificate	expired_certificate
TclTkImage	TclTkImage
|	|
PP::PPMethods	PP::PPMethods
String	String
source_uri	source_uri
local_port	local_port
RDoc::Stats	RDoc::Stats
rss	rss
tt	tt
errno	errno
IRB::ReadlineInputMethod	IRB::ReadlineInputMethod
win32ole_record_object	win32ole_record_object
raw	raw
tkmsgcat	tkmsgcat
root	root
base	base
decode	decode
pseudo	pseudo
logout	logout
rindex	rindex
deep	deep
win32ole_typelib_object	win32ole_typelib_object
dn=	dn=
strategy	strategy
parseerror	parseerror
env	env
move	move
TclTkCommand	TclTkCommand
re	re
status=	status=
Gem::Util	Gem::Util
ts	ts
x	x
interp	interp
bundled	bundled
head	head
RDoc::Parser::Markdown	RDoc::Parser::Markdown
len	len
cmsg	cmsg
isapop	isapop
prefixes+	prefixes+
coerce	coerce
pty	pty
urlsafe	urlsafe
def	def
realtime	realtime
httpstatus	httpstatus
new3	new3
source	source
SystemCallError	SystemCallError
Enumerator::Lazy	Enumerator::Lazy
{	{
hdr	hdr
which	which
glob	glob
getres	getres
reload	reload
from_path	from_path
account	account
thr	thr
real	real
==	==
io_variable	io_variable
next	next
Gem::Package::TarHeader	Gem::Package::TarHeader
Marshal	Marshal
site	site
methodname	methodname
notify	notify
gen	gen
Syslog	Syslog
api	api
IRB::ContextExtender	IRB::ContextExtender
ancestors	ancestors
Psych::Nodes::Document	Psych::Nodes::Document
min_visibility	min_visibility
method	method
initialize	initialize
error=	error=
hierarchical	hierarchical
compress	compress
lv	lv
systemexitexception	systemexitexception
IRB::StdioOutputMethod	IRB::StdioOutputMethod
curry	curry
capitalized	capitalized
round	round
SystemExit	SystemExit
summarize	summarize
england	england
params=	params=
key_name	key_name
IO::generic_readable	IO::generic_readable
Fiddle::Closure	Fiddle::Closure
open	open
malloc	malloc
test	test
bbox	bbox
Symbol	Symbol
instance	instance
look	look
bestset	bestset
interface	interface
tcltkimage	tcltkimage
added_container	added_container
types	types
yday	yday
acct	acct
assemble	assemble
childexited	childexited
nprocessors	nprocessors
scanner	scanner
Gem::Resolver::ActivationRequest	Gem::Resolver::ActivationRequest
zero	zero
configure	configure
frame	frame
REXML::XPath	REXML::XPath
!	!
mtime	mtime
precs	precs
RSS::Atom::PersonConstruct	RSS::Atom::PersonConstruct
pushdir	pushdir
opened	opened
amjd	amjd
header	header
expanded	expanded
setproperty	setproperty
systemexit	systemexit
arguable	arguable
syscall	syscall
finish	finish
DBM	DBM
Rinda::TupleSpaceProxy	Rinda::TupleSpaceProxy
font	font
ObjectSpace::WeakMap	ObjectSpace::WeakMap
XMLRPC::Marshal	XMLRPC::Marshal
Thread	Thread
init	init
date=	date=
defmethod	defmethod
points	points
verify_or_params	verify_or_params
start_pos	start_pos
finite	finite
stringorreadable	stringorreadable
IRB::JobManager	IRB::JobManager
RDoc::Markup::Formatter	RDoc::Markup::Formatter
pull	pull
sheet	sheet
MakeMakefile	MakeMakefile
valid	valid
Gem::Server	Gem::Server
when	when
accepting	accepting
setobj	setobj
JSON::Ext::Generator::GeneratorMethods::FalseClass	JSON::Ext::Generator::GeneratorMethods::FalseClass
verbosity	verbosity
specificationprovider	specificationprovider
tms	tms
pathname	pathname
front	front
input_method	input_method
compositenotifier	compositenotifier
OpenSSL::ASN1::ASN1Data	OpenSSL::ASN1::ASN1Data
data_path	data_path
result_of_the_block	result_of_the_block
sha1	sha1
seteuid	seteuid
singleclass	singleclass
ignore	ignore
gem_data	gem_data
var_name	var_name
Tk::BLT::Stripchart	Tk::BLT::Stripchart
stdiooutputmethod	stdiooutputmethod
Fiddle::CUnionEntity	Fiddle::CUnionEntity
force_transcode	force_transcode
fdiv	fdiv
authtype	authtype
relative_files	relative_files
examine	examine
PTY::ChildExited	PTY::ChildExited
system	system
features	features
d	d
prime	prime
update	update
hosts	hosts
unless	unless
IRB::InputMethod	IRB::InputMethod
Fiddle::CStruct	Fiddle::CStruct
encoded	encoded
include_private	include_private
XMLRPC::Server	XMLRPC::Server
directory	directory
nametuple	nametuple
ajd	ajd
f	f
buf	buf
loadable	loadable
superklass	superklass
headers	headers
Gem::RequestSet	Gem::RequestSet
mapping	mapping
UnicodeNormalize	UnicodeNormalize
generator	generator
loopback	loopback
tkcomm	tkcomm
drop	drop
attributes=	attributes=
lex	lex
RDoc::TokenStream	RDoc::TokenStream
ldone	ldone
etc	etc
Fiddle::Pointer	Fiddle::Pointer
Process::UID	Process::UID
entity	entity
multitkip	multitkip
ctx	ctx
deletecallbackkey	deletecallbackkey
Resolv::DNS::Resource::IN::A	Resolv::DNS::Resource::IN::A
setresgid	setresgid
args...	args...
fiddle_pointer_instance	fiddle_pointer_instance
uname	uname
Tk::Tile::TreeviewConfig	Tk::Tile::TreeviewConfig
sfork	sfork
listen	listen
locale_name	locale_name
old_name	old_name
func	func
meta	meta
diagonal	diagonal
pbkdf2	pbkdf2
openstruct	openstruct
crc2	crc2
cert_pbe	cert_pbe
modrubyserver	modrubyserver
scheme	scheme
TkMsgCat	TkMsgCat
whitespace	whitespace
to:	to:
RDoc::Stats::Verbose	RDoc::Stats::Verbose
httpserver	httpserver
extents	extents
disable	disable
graph	graph
JSON::Ext::Generator::GeneratorMethods::NilClass	JSON::Ext::Generator::GeneratorMethods::NilClass
sample	sample
invalidbytesequenceerror	invalidbytesequenceerror
ringprovider	ringprovider
question	question
texts	texts
localspecification	localspecification
platform=	platform=
basicspecification	basicspecification
(0/1	(0/1
abort	abort
vector	vector
makable	makable
CGI::QueryExtension	CGI::QueryExtension
alert	alert
left	left
removed	removed
unixserver	unixserver
Gem::Resolver::Molinillo::DependencyGraph::Vertex	Gem::Resolver::Molinillo::DependencyGraph::Vertex
ipv6	ipv6
sinh	sinh
warn	warn
upper	upper
install	install
det	det
lib	lib
getc	getc
bodytypemessage	bodytypemessage
closure	closure
normalmodule	normalmodule
attrs	attrs
pair	pair
thwait	thwait
getaddresses	getaddresses
for	for
debugger__	debugger__
OpenSSL::X509::CRL	OpenSSL::X509::CRL
remotefile	remotefile
imap	imap
e	e
lock	lock
RDoc::Parser	RDoc::Parser
certs	certs
gzipfile	gzipfile
ring	ring
Gem::RequestSet::Lockfile::Parser	Gem::RequestSet::Lockfile::Parser
WIN32OLE_PARAM	WIN32OLE_PARAM
ec	ec
array_of_asn1data	array_of_asn1data
scope	scope
Process::GID	Process::GID
RDoc::Task	RDoc::Task
ary	ary
transtive	transtive
Gem::Security::Policy	Gem::Security::Policy
exception2messagemapper	exception2messagemapper
signedness	signedness
encode	encode
assign	assign
available	available
getwd	getwd
import	import
executables	executables
Net::IMAP::BodyTypeMessage	Net::IMAP::BodyTypeMessage
socketpair	socketpair
quickpath	quickpath
dump	dump
tkfont	tkfont
setup	setup
puts	puts
step	step
tokens	tokens
multipart	multipart
RDoc::Markup::ToJoinedParagraph	RDoc::Markup::ToJoinedParagraph
chars	chars
lusolve	lusolve
REXML::CData	REXML::CData
exit	exit
RDoc::MethodAttr	RDoc::MethodAttr
systemcallerror	systemcallerror
Zlib::GzipFile	Zlib::GzipFile
local_host	local_host
all	all
XMP::StringInputMethod	XMP::StringInputMethod
promptdialog	promptdialog
iso8601	iso8601
timeridconv	timeridconv
Fiddle::Handle	Fiddle::Handle
RDoc::Markup::Verbatim	RDoc::Markup::Verbatim
thursday	thursday
basename	basename
WEBrick::AccessLog	WEBrick::AccessLog
tarwriter	tarwriter
RDoc::Markup::ToAnsi	RDoc::Markup::ToAnsi
framework	framework
other_time	other_time
generate_rdoc	generate_rdoc
stdioinputmethod	stdioinputmethod
ui	ui
cookie	cookie
asn1	asn1
fast	fast
Gem::StreamUI::SilentDownloadReporter	Gem::StreamUI::SilentDownloadReporter
binread	binread
cparser	cparser
options=	options=
sourcefactory	sourcefactory
UDPSocket	UDPSocket
mtime=	mtime=
Psych::Parser	Psych::Parser
mode	mode
jobs	jobs
binding	binding
TkFont	TkFont
OpenSSL::Random	OpenSSL::Random
awin32ole	awin32ole
file_name	file_name
basic_response	basic_response
anobject	anobject
ioctl	ioctl
at	at
names	names
quiet=	quiet=
source_string	source_string
Net::APOPSession	Net::APOPSession
bits	bits
an_alias	an_alias
REXML::Validation::RelaxNG	REXML::Validation::RelaxNG
monitormixin	monitormixin
numerator	numerator
basicresponse	basicresponse
exit_code	exit_code
tkcgroup	tkcgroup
columns	columns
cpu	cpu
vtype	vtype
Fiddle::CUnion	Fiddle::CUnion
UNIXSocket	UNIXSocket
fill	fill
yes	yes
ctype	ctype
pat2	pat2
center	center
wait	wait
Gem::Resolver::IndexSpecification	Gem::Resolver::IndexSpecification
aclentry	aclentry
tree	tree
isjis	isjis
kernel	kernel
Tk::Iwidgets::Scrolledcanvas	Tk::Iwidgets::Scrolledcanvas
Fiddle::CompositeHandler	Fiddle::CompositeHandler
JSON::Ext::Generator::GeneratorMethods::TrueClass	JSON::Ext::Generator::GeneratorMethods::TrueClass
weakref	weakref
httpproxyserver	httpproxyserver
pretty	pretty
cert_name	cert_name
toutf8	toutf8
unshift	unshift
rsqrt	rsqrt
personconstruct	personconstruct
p_user	p_user
fn	fn
destination	destination
Encoding::UndefinedConversionError	Encoding::UndefinedConversionError
license	license
assert	assert
>=	>=
err	err
precision	precision
OpenSSL::X509::ExtensionFactory	OpenSSL::X509::ExtensionFactory
Encoding	Encoding
mkdir	mkdir
session	session
obj2	obj2
opaque=	opaque=
body	body
Socket::Ifaddr	Socket::Ifaddr
Gem::Doctor	Gem::Doctor
items	items
updated	updated
iflush	iflush
reject	reject
class_or_module	class_or_module
dat	dat
entitydecl	entitydecl
Kernel	Kernel
int2	int2
lsub	lsub
webrickservlet	webrickservlet
while	while
TkTimer	TkTimer
GC	GC
REXML::Text	REXML::Text
Resolv::Hosts	Resolv::Hosts
proppatch	proppatch
drbsslsocket	drbsslsocket
render	render
Zlib	Zlib
treeviewconfig	treeviewconfig
true/false	true/false
current_set	current_set
open_width	open_width
pkcs7	pkcs7
qvalues	qvalues
RDoc::TomDoc	RDoc::TomDoc
RDoc::Markup::AttributeManager	RDoc::Markup::AttributeManager
unique	unique
toutf16	toutf16
REXML::Attribute	REXML::Attribute
eid	eid
an_exception	an_exception
htmlutils	htmlutils
tag_directives	tag_directives
reqs	reqs
prefixlen	prefixlen
current_method	current_method
eigenvaluedecomposition	eigenvaluedecomposition
copy	copy
methods	methods
