$values	значения массив типа данными значений обычный integer содержащий
$max_depth	глубина вложенности максимально допустимая
simplexmlelement	объект addchild simplexmlelement узлу представляющий добавленного метод xml потомка возвращает
$priority	установки - priority это комбинация параметр уровня
$hostname	www которыми поиск ip узла допустимое параметр например должен hostname вестись 2 dns соединение хоста проверяется получены openldap ip-адрес используете адрес данные которому котором должны принимать имя
$read_write	прикреплять цепочке умолчанию чтения функция stream_filter_prepend() т фильтров фильтр открыт файл
$micro_seconds	исполнения время микросекундах откладываемого
$array_result	возвращаются false документов array_result ключей идентификаторами веса качестве остальной ассоциативного виде массива значений установлен информацией результаты атрибуты
$restrict	xpath параметр включения возможности xslt вызывать выражений аргумент некоторые определенные функции хотите используйте
$callbacks	обратных массив вызовов
$errstr	ошибке системной описание соединение строки смотрите сообщение содержит установить параметра виде errstr аргумент удалось errno второй присвоено
scalar	текущий является случае элемента противном ключ действительным текущего null
$filtername	название регистрируемого фильтра потока
$train_data	resource данных обучающих нейронной ресурс сети
dateinterval	объект класса dateinterval возвращает новый
$output	массив программы указан заполнен output вывода параметр строками
$object	которого возвращаемый вызвать стиля: метод datetime идентификатор изменить свойство необходимо тестируемый проверяемый нестатическое передать которым экземпляр вычислить объект tidy требуется object объекта date_create() класса добавляемый чей удаляемый процедурного проверки данные котором нужно искомый имя связать
$signal	необязательный системах полезен операционных стандарт posix поддерживающих параметр
$database	переключение которую произойдет числом целым определяется тип данных integer базы имя
$dither	true задано сглаживаться изображение
number	абсолютное десятичное основание exp binary_string float number тип возведенное произведение степень base integer возвращает значение
iterator	объект переданный внутренний итератор объект-итератор norewinditerator::__construct() конструктору элемента класса текущего filteriterator recursivecachingiterator ссылка limititerator::__construct()
$length	максимальный считываемое конца результат достижении передан удалены первым возвращаемый получения содержит 1 заканчивается используется bzread() прочитать возвращаемая случится ziparchive string скопировать зависимости содержимого символов записываемых включать сжатия данные размер записаны длина возвращаемое дескриптора возвращаемой копирования меньшее поиск файла заменяемой максимальное типа байтов чтения которая параметр производится собой строка запись будут определено строки массива которые прочитанных байт задан части несжатых offset конец значение чтение socket распаковки параметром параметра встретилась равное представляет опущен положительный участка подстроки начиная байта lob смещения длиннее data указанного включается необходим элементы максимальная будущего встретилось указывает указан позиции 1024 указанной функцию закончатся которой аргумент зависит которое раньше длину длины диапазона записано необходимо данных - length сравнения достигнут экспортируемой следует количество число start строке остановится положителен элементов обрезается считывать последовательность развития определяет новая байтах возвращаемых
$frompath	текущему рабочей копии путь репозиторию
$image2	палитрового размер ссылка имеющего изображения ресурс image1
$outputgamma	гаммы настройка выходная
$image1	ссылка ресурс truecolor-изображения
$option	stream_set_blocking() вызова ldap_opt_matched_dn конфигурации указания stream_meta_owner ldap_opt_server_controls ldap_opt_error_number результате одним опции опций tidy журналирования устанавливаемый задать ldap_opt_sizelimit поиска название одно array параметр необходимо string stream_set_timeout() вызывается значений: stream_meta_access журнала stream_meta_group_name используется stream_option_write_buffer chgrp() из: ldap_opt_network_timeout тип строковым ldap_opt_error_string bool chmod() chown() настройку которые ldap_opt_referrals создании ldap_opt_timelimit аргумент убрать настройки stream_set_write_buffer() option вызван метод настройка ldap_opt_protocol_version stream_meta_group stream_option_read_timeout touch() функции ldap_opt_restart записи конвертации добавляемые integer curlopt_xxx используемых stream_meta_owner_name ldap_opt_client_controls аргументом какую ldap_opt_deref stream_meta_touch ldap_opt_host_name получить имя stream_option_blocking опция
$agent	вызова полученная udm_alloc_agent() ссылка идентификатор агента
$addtl	передается ссылке
$attrlat	название хранящего атрибута широту
$statement	допустимый возвращаемый оператора допустимого oci-выражения идентификатор точки запроса запустить зрения необходимо полученный oci_execute() oci должен запрос это oci_parse() выражение исполненный ref выражения целевой текст sql подготовить функцией выполнения подготовки cursor субд корректный которое oci8
$enclosure	обрамления полей устанавливает ограничителя ограничитель enclosure поля параметр дополнительный символ
$content	узла содержимое
$buf	отправляемые которые взяты переменную указанную буфера переданы данные полученные буфер параметре отправлены хост удалённый содержащий buf будут
$value2	сравниваемого поддающееся узла сравнению второго любое значение
$value1	сравниваемого первого поддающееся узла добавления сравнению массива любое первое array конец добавляемое значение
intldateformatter	case false created of failure in intldateformatter the or
string	иначе code метки записи достижении множественном метка возвращаются описатель отформатированную файла название вставленными произошедшей связанными uuencode родительской присвоено -заголовок атрибутов значения короткое преобразованное буфер вывод этому 0 большого текущего дескриптор сконвертированная хоста атрибута шестнадцатеричного система string содержимого аргумента префикс charset корнем arrayiterator разметки используемую типа item mb_substr() вырезанными службы текущий error_code текущим закодированное прочитанный соответствии данная описание удаленными одна задан функции imagetype_tiff_mm категории буквы операция подключенного префиксом существует; который ; содержимое memcached декодированный найдены слагаемых прочитанные среды декодированные запущена завершающего address время path приведенная пустая reflectionclass сериализованный ошибка распаковки описанием команда параметра значений параметре информации конфигурации запятыми исполняемой атрибут ссылке boolean результатом никакого url-кодированную указанным локальным указанного символами call заданным кода &nbsp; type значения: расширения закодированную базе последнюю допустимое предоставил последней последнее файловой imagetype_gif номер режимом преобразованная f указанной needle зону указанном экземпляра соединения результирующую ресурс код сериализованные временная запрашиваемая объявлен соли локали dn вычисления errno возвращать недопустимое imagetype_tiff_ii заменами spl_autoload() котором читабельное таблицы целевой порядок объекта должен необходимые x-shockwave-flash tidy-разметку imagetype_swf imagetype_swc 1 сжатая числе полученное безопасно числа закодированная число подходящую преобразования описывающее кодировку французской повторяющуюся отрицателен хэшированную интернет элементов data исходный иудейскому разобранную точек запятую tobase слеша идентификатора сериализованная управляющего результат файлов информацию указанная ключу jpeg передан каждым длиной iso-8859-1 уведомление phpe9568f34-d428-11d2-a769-00aa001acf42 выполняющейся заданного неправильно форму поле переведённую прочтённые экспортируемый msgid1 хэш исключения экспорт image цвет прочтенную return imagetype_bmp timestamp порядке расширение класса обрезанная удобочитаемая вывела разность форматированной полный удобное расширений arrayobject дополнительную name переданной определенную переданное идентификатор историческим метку iff неэкранированными mode путём расшифрованный содержащая ранее eio_get_last_error() возможного регистре domain прочтенные прочтенным изменения запросе раскодированную отформатированное двоеточий неудачи просто operand которая параметр возвращает текст строка сокета req строки взломостойкости кодированные массива революции узел описания идентифицируемых alter кодированный дескриптора причинам представление старый теоретически ошибок набора mime ключа кроме некие используя использоваться фрагмент выполнения регулярное проверка isp использованием проверке закрыл length iso unknown та token элементом примеру использовать encoding возвращается number возможными сериализованное последний закодированные array месяц значений: php канонизированный start формату равен очищенную imagetype_psd заканчивает statement кодировки континента кодировке ipv4 локального соответствующей коду неизмененный сумма элемента текущее указанному позиции вывода png 13 адрес double измененную выполнена связанную str кодировка угодно логические поддерживает false временной указана установленной 32-символьного null 3166-1 установку option согласно сериализованную - систему выражение системы modulus описании соединение объект версии vnd object уведомления пароля задания directoryiterator отправленной часть определить библиотеки подстроку url верхнему локаль обратными организации имя возвращаемых короче счисления работы уникальный text результата поддиректории ниже игнорируя домен например xml произошла двоичное ошибке цифробуквенные предупреждений ошибки произошло исходную времени исходной класс отличающуюся лексемы handle модифицированную датой структура имен экранируемую теле ресурсу подробно imagetype_png имеет поля сообщения базовое значениями resource суфиксом исполнении данные синтаксически пробелами длине текстовым преобразованную терминала ошибках других узла нижнему -_ регистр in_addr регистру содержит заданном могут заданной флагами doc-блок заданное документации базы перевод набор байт imagemagick принадлежит шрифт последняя строку len key символа библиотекой директории c аргументом varname ответ пути connection найден soundex адреса последнего успешного возвращаемые передано корень экранированную пустую именами localname подстрока прошел экранированная прошла гарантированно octet-stream следующих версия элемент индексу перевода количества помещения указывает возвращен содержащую пользователя bmp формата измененная формате note_name reflectionmethod суффиксом plain успеха функция value успехе бинарное установлен константы mnogosearch распакованные значениях ip абсолютный gzeof() видоизмененный включая imagetype_iff gearmanclient::setcontext() возникновения пустое imagetype_wbmp hostname типов: msgid2 календарю rot13 html родительского эта установленного страны параметрам отображения список deflate полное строкой сервера удалось jp2 неэкранированную переведенные спецсимволами одного именем разделенными изображения корректную визуальной gzip логин the представлено установленные imagickpixel копирайт объектом клиентской первый которого mysql glue удалённый imagetype длинное старое путь успешно символ n blob haystack ссылки utf-8 real настройки format указателем psd отображенного ошибку символом григорианскому integer символов udm_error() противном motorola intel содержащих начала задачи таблице soap возвращаемое api t произведенными imagetype_jpeg шрифта файл возвращаемой созданной которую кодом оператора команды begin вновь хост magickwand уникальное socket_read() итератора экранированы переноса верхнем ob_start() soap-ответ распакованная вызывается дополнительной quoted-printable буфера буферизацию / найдено день возможные год найдена комментарий объекту soap-запроса указанную очищенный представляющую запроса виде offset клиентская значение размером файлу имени каталога создает заголовки параметром которому комментариев формат ключ дня фильтр является потоковое дата региона итерации соединении tiff домена float сохранена следующего начиная подпись подписанный поддерево символической перечисленных json gif страна ipv6 xpath decoded пространства перевернутую пространстве переменную переменной бинарную совпадать слешами параметрами временную являются: зашифрованный тип true строковое версию namespaceuri неверный данного токен которой либо приведены gearmanclient::setdata() самая найденного описанных операции которое отличие предупреждением умолчанию абсолютное int одним t61 нахождении посмотреть phpe9568f35-d428-11d2-a769-00aa001acf42 кадра существует данных сообщений soap-запрос imagetype_jp2 сообщение application одновременно экземпляр 5 обработчика контейнера строковые контекста извлеченную прочитанную reflectionextension базового символы следующую imagetype_jb2 sql случай imagetype_jpx eof примечание случае связанное нижеследующих квадратный символьное imagetype_jpc обработчик
$handle(resource)	потока помощи ресурс fopen() функции полученный например
$sigma	отклонение гаусса стандартное пикселях
$replace_by	совпадении которая строка смайл заменяет
$y1	control левая точки point координата - угол левый y-coordinate 0 изображения первой y-координата of y верхняя верхний first
$y2	control точки point координата правая of y-coordinate second y-координата у-координата y нижняя второй
$use_keys	итератора использовать следует индексы элементов ключи
domattr	объект false старый случае ошибки атрибут класса domattr либо заменен новый возникновения узел null возвращает атрибута
$item	константой итерации соответствующей числом целым item содержит текущей значение
$on_off	включения вывод установлено включает отладочной информации отключения false true
$classname	реализует c php_user_filter функций-членов protocol реализовать который целым протокол расширение класса рядом определить название фильтр нужно класс
arrayiterator	итератор arrayobject
$dbhandle	sqlite sqlite_open() данных случае подхода использования ресурс базы функции полученный процедурного
$needle	приводится состоит поиск первый производится подстрока строке параметр строка используется искомое обработан haystack string needle строкой трактуется символа искомая символ значение одного преобразован которой осуществляется код целому является
$signature	подпись
$event	тип логический имеет
$gmtoffset	задается часах
reflectionproperty	объект класса reflectionproperty
$autoload	__autoload() значения умолчанию подгружать описание зависимости определяет магическим оригинальный вызывать загрузить класса использовать автоматически переданного методом функция найден __autoload нужно класс
$handle	сохранения fclose() закрытым указатель получить функциями файла название функции popen() допустимый должен помощью успешно действующим дескриптор открытый вызовом локального данных получен указателем сокет файловый указывать fsockopen() функцией поток resource успешным которого создаваемый обычно fopen() файл нужно корректным
$ascii	ascii-код
$source	xml исходному сжимаемая строка путь разбора распаковываемая rng поток исходного схему html ресурс код файлу relaxng содержащая php исходный изображения
domnode	domnodelist false скопированный узла null возвращает результирующий копия index объекта скопирован недопустим ошибки дочерний узел domnode индекс добавленный позиции удаляемый находящийся удален функция случае
$luminosity	установленном черный нормализованное значении 1 0 яркости hs белый шкале значение
$storage	остаться которые текущем требуется удалить элементы контейнере контейнер должны содержащий
$src_y	изображения y-координата исходного
$src_x	изображения исходного x-координата
$bson	преобразуемый объект bson
$longitude	умолчанию указания отрицательная восточная радианах передается долготы долгота величина западной якоря
$src_w	ширина изображения исходного
$fieldcode	pgsql_diag_message_primary значения pgsql_diag_internal_position postgresql pgsql_diag_sqlstate pgsql_diag_message_detail версий pgsql_diag_message_hint pgsql_diag_severity 8 возможные fieldcode : pgsql_diag_statement_position аргумента
$src_h	изображения исходного высота
$input	строка массив буфер обрабатываемая повторяемая входной
$retval	установлен опции значение
$matches	порядок возвращаемом результатами указан регулирует matches случае совпадений массиве flags многомерном заполнен поиска вывода параметр дополнительный
$ranker	ранжирования режим
$revision	списка содержимого целочисленный получения ревизии номер
$newscope	сохранения класса ассоциируется замыкание области которой static видимости область текущей
$entry	определяет информацию записи массив который
$charlist	дополнительных будут список экранируемых слово рассматриваться которые символов
$bordercolor	объект строка imagickpixel рамки содержащая цвет
$fontfile	truetype url шрифта имя файла
$second	минуты указанной количество начала прошедших параметром секунд строка вторая minute
$full_status	вернет буферов true активных уровни
$pathname	директории объекта файлу fifo путь контур системе обозначенный трассировки файловой клиентской большого данных записи файла чтения полный создаваемого имя журнала
$identifier	идентификатор полученный gnupg gnupg_init()
$dest_width	ширина изображения wbmp-изображения результирующего
$bytes_max	заполнен параметр доступно bytes_max
$sorting_order	алфавитном умолчанию порядке возрастанию сортировка производится
$height	эллипса обрезания области рамки обрезаемой соседей дуги высоте изображения высота область
$channel	константа режима передайте канала константу корректную любую вашего channeltype
$bz	файл указатель
$topath	чистой путь экспорта папке
$encoded_header	заголовок строки закодированный виде
$version1	старший версии номер
$div	делитель используется искривления результата нормализации
reflectionclass	объект reflectionclass которого отображенный метод частью класса является
$dir	директории файлы путь извлечь необходимо
$hebrew_text	иврите строка входная
$definition	аргументы определяющий массив
$encoding_mode	force_deflate сжатия force_gzip умолчанию режим
$tdo	регистре должен именем типа верхнем корректным
$extr_prefix_all	добавить именам всем ко prefix переменных префикс
$id	функцией возвращаемый ресурса соединения идентификатор дескриптор yaz_connect()
$flags	include_path необязательного документов какие флага: out-of-band допустимые stream_is_url задать режим флаг protocol содержащий добавляет битовая файлов записей значения полных массив поле указать preg_pattern_order применять статуса 0 обращаться настроечных маски: исходной создания буфером далее новое обрабатывать некоторых двоичного управления обработки констант: бессмысленно класса способ установлена работать применены bbcode_container arrayobject получения arrayiterator вернет соединённых самой операции установки кавычками поведение данные качестве api первой xattr_dontfollow любая найденной ранее файл возвращаемой | коллизий svn_all помощи shm_rdonly) оператора памяти установлено пункты добавлены флагов объединенных которая параметр флаги строке используемый сокета документа маской будут поведением ссылкой / содержит тип доступа вернёт вне возможные которые preg_set_order набор настройкам stream_oob ищет схемы var_dump протоколом доступе любую виде preg_split() значение директории понимать доступные какие-либо хранит нижеуказанных кавычек неправильных установить параметра символические элемент последовательностей результаты является or игнорирование разыменовывать $matches валидации старыми должно preg_offset_capture атрибут свойства подстроки методов следующего константам свойств констант определяющих указывают имеют битовой дополнительные etc позиция xattr-флаги использования следующих записям : комбинации следующие использование oob упорядочивает непустые правками побитового вывода нормальные управляет одну функция установленные подмаски поддерживаемые соединения url xattr_create внеполосные битовые шаблона которое зарезервированный настроечные кодовых указана состоящая libxml каждой типы комбинацией существует необходимо объекта функции ключей помощью маски glob_mark svn:ignore - новых маска предопределенным 1 зависимости одновременно preg_split_no_empty флаги: foreach следует svn_non_recursive = svn_show_updates участок svn_no_ignore модификации разделяемой указан устанавливает комбинацию комбинация использовать ссылки некорректных трактования согласно a совершать списка следующего: слеш одного определяет file_use_include_path случае ошибку принимать любой сканировании flags нескольких svn_ignore_externals кавычки потоков вхождений операциями свои числовых
$config	настроек массив
$pieces	строк объединяемых массив
$metric	this of metric list to type constants refer
$tobase	счисления основание number числа системы преобразования
$disable	также false dom true xmlwriter загрузки отключение xmlreader включение libxml сущностей внешних расширений
$seed	параметра переинициализации необязательное значение
$class_method	разделенные класса метода :: имена
$substrchar	пример: entity одной юникода сущность long следующих кодировке : строк string задает числа jis+7e7e виде выходной символа integer вывода конечного значение ȁ) none u+3000 код
$rows	строк массив количество области масштабе 0 выборки изображения table_name высота предварительной array копирования = рядов данных >
$errfile	произошла ошибка необязательный строки файла errfile виде котором аргумент третий содержит имя
$authns	передается ссылке
imagick	объект объекта возвращена копия успеха случае изображений последовательности imagick экземпляр новый возвращает текущей
$errmsg	пустая ошибке строка которой переменную сообщение ссылка ошибки ldap присваивается
domprocessinginstruction	объект false случае ошибки класса либо новый domprocessinginstruction
$severity	stream_notify_severity_* констант оповещения одна
domdocumentfragment	объект false случае ошибки класса либо новый domdocumentfragment
$arg	экранирован радианах степень вычисления данные вводимые возведения входное аргумент который функции значение
$ftp_stream	соединения ftp идентификатор сервером ftp-сервером
$level	level сжатия используется котором уровень указывает параметр протокола опция
$importednode	узел импортируемый
$use_include_path	include_path поиск установите также установлено время пути файла начиная параметр необходимо директориях директивы искать равен filename 1 необязательный 5 хотите просматривать осуществлялся include ищется версии попытаться проверялось требуется найти использовать поиска аргумента php true второй используя значение : file_use_include_path замечание можете стандартные установить use_include_path константу аргумент path файл имя наличие
$name	объект инструкции которого указания конце проверяемой обработчик объектом определяется свойства проводиться название функции содержит обработчика содержимое вызывается короткое & name сущность reflection-функции замыкания array($someobject добавляемого экспортируемый расширения заданным протокола ; расширенного атрибута аргумент проверяемого пространства именем reflection например: xslt доступа переменной вызываемого имен элемента создаваемого строковой группы параметра модуля службы помощью methodname удаляемого тэг пользователя тэга константы второй win32_create_service() которому начале ссылка дочернего cookie добавлении уровень локальное ссылки метода поиск имя
$row_number	ряда результата дескрипторе желаемый полученном номер
$scanner_mode	умолчанию следующие ini_scanner_normal значения: ini_scanner_raw принимать
$index	которого удалить узла названий коллекции название удаляется проверяемый необходимо значения смещение множество позиция бит проверяемое который атрибута индекс устанавливаемого элемента очищаемого индекса палитре бита значение названия получить проверить
$streams_context	функцией созданный stream_context_create() контекста ресурс потока
$file_skip_empty_lines	пустые пропускать строки
$args	передачи вызова принимает call_user_func() array функции аргументы массив затем подобно массива который число которые конструктор произвольное обратного класса виде передаются функцию аргументов передаётся передаваемые
$filtertype	цвета следующих: одним filtertype изображения img_filter_negate : инвертирует
$text_domain	сообщений домен значения изменения текущего новый null получения
$start	сканирования считая угол замена начальная нуля подстрока смещение используется строки позиция дуги сравнения start бит возвращаемая будущего параметр string неотрицателен экспорта положителен начинается символа позиции необходим выделяется развития номером начала ziparchive которой градусах str порядковым
$directory	директории путь сканируемый раздел сервере создаваемой диска открытия директория целевая новый каталог текущий имя
$tile	использования изображения мозаике ресурс
$timelimit	процесс ограничивающее устанавливает секунд число поиска
$matrix	точкой значения аффинная массив массивов матрица 3x3: 3 трех каждом плавающей
$ctor_args	класса будут переданы элементы массива конструктор
$newvalue	новое настройки значение
$offset(integer)	смещению перейти указанному чтением
$resumepos	удаленном начала файле позиция загрузки
$cache_cb	вызова обратного функция кэшируемого чтения null callback-функция
$convmap	кодов массив задает convmap - который задающий array символов диапазон
$encodingfile	описан формат документации библиотеке файла t1lib
$return_float	точкой вместо возвращается установлено массива число плавающей true
$param_arr	индексированного параметры передаваемые виде массива функцию
$nonrecursive	директории рекурсивно обработать следует
$imageinfo	сведения извлечь необязательный некоторые позволяет изображения аргумент расширенные файла
$to_parse	разобрать которую строка необходимо
recursivefilteriterator	итератора элемента элементы внутреннего recursivefilteriterator дочерние текущего содержащий возвращает
recursivearrayiterator	является object массивом итератор элемента объектом текущего array элемент
$arg4	img_filter_colorize альфа 0 канал 127 : значение
$arg1	stream_option_blocking блокировать принимает option значение: 0 запрошен блокировки 1 img_filter_brightness яркости уровень режим :
$arg3	синего цвета компонента img_filter_colorize : значение
$arg2	stream_option_blocking влияет зеленого img_filter_colorize цвета компонента это принимает option : занчение: значение
$return	вернет print_r() отличие return возвращала подсвеченный перехватить установите функция вывод установка поведения хотите код экспортируемое опущен параметр true значение используйте
$character_mask	также символы помощью параметра указать удаляемые character_mask
$escape_char	escape_char задает необязательный экранирующий параметр символ
$public_id	соответствии объявления идентификатор внешнего public_id xml внешней такового представлен будут - спецификации требованиями пробелы нормализованы виде строка сущности нет; пустая обозначения общедоступный идентификаторе объявлении либо аргумент пятый
$namespaceuri	пространства xslt имен передается пространством пространство uri элемента параметра имён отдельным создания атрибута
$pid	идентификатор текущего процесса
reflectionmethod	объект конструктора класса отражающий reflectionmethod null конструктор
$param	переменной которой столбец привязать php требуется имя
$preg_offset_capture	строке подстроки случае указан позиция указана флаг исходной каждой найденной
$max	id максимальное значение
$addr	удалённого ip-адрес хоста
domcomment	объект false случае ошибки класса либо новый domcomment
$new_location	url новый
$msgs_in_queue	оставшихся количество сообщений очереди
$large_object	lob функцией объекта возвращаемый pg_lo_open() большого ресурс postgresql
$stylesheet	объекта simplexmlelement domdocument таблица импортируемая виде стилей
$additional_headers(необязательный)	конец строка заголовка письма вставляемая
$what	умолчанию ini ниже constants одной функции битовую вывод констант assert_active механизма передавая настройки описание настройка assert приведенных маску значение проверки настраивать утверждений установка
$message	иначе вместо imap переводимое обращении добавляемое \r\n текст события письма операция строки сообщение cyrus неудачна следует доступно серверу описывающее завершающий виде использовать символ передаётся \n
$year	разрешенное 9999 цифрами calendar выбранном год календаря значения 2000-2069 будут 1970-2000 - 2037 причем числа четырьмя число значение 0-69 -4714 -4713 указан календаре виде 70-100 двумя номер года положительное 1970 зависит трактованы
$pri	eio_pri_min eio_pri_max eio_pri_default приоритет запросов: null
$username	oracle пользователя буквенно-цифровое имя
$jd	календаря число целое день юлианского
$version2	версии номер младший
$code	функцией php строка исполняемая ошибки xml_get_error_code() код кода возвращаемый функции
$color	imagecolorallocate() функцией которого созданный цвета эллипса imagick заливки заданный получается идентификатор констант линии одной созданных значение цвет
$type	типов all умолчанию необязательного являются: сокетом одним stream_sock_rdm одной заданный допустимые взаимодействия: boolean stream_sock_seqpacket dns_get_record() начиная параметр допустимыми которая данных константа: stream_sock_stream значения используемый искать datetime используется input_post - oci_dtype_file тип констант это pdo::param_* oci_dtype_lob коммуникации recv() input_get input_env : type хоста 4 версии заданному необязательный указывает input_encoding список php_binary_read input_cookie oci_dtype_rowid использоваться base64 приведенных ресурсов записи возможные php stream_sock_dgram смотрите значение output_encoding значениями имени internal_encoding ниже: функция or параметра stream_sock_raw системная именованная соответствующие hostname input_server возвращаемых
$remote_socket	соединения удалённого сокета адрес
$out_charset	требуемая кодировка выходе
$query	точкой должен строка несколько sql запятой подготовку запрос параметризованный выражений запроса mysql одно sql-запрос заканчиваться запускаемый разделенных
$internal_date	internaldate указан установит сообщении добавляемом параметр
$cost_del	определяет удаления стоимость
$action_name	задаваемая 32 пользователем строка байт
$token	разделитель лексемы строки str значение
$newthis	объект объекта функции функция переданная которому текущего привязана null отсоединения
$tag	ассоциативный значений ключей массив тега
$y3	y-coordinate of control third point
splfixedarray	объект содержащий данные класса импортированного массива splfixedarray возвращает
$attribs	attribs массив элемента ассоциативный аргумент третий содержит атрибутами
$result_type	возвращаемый массив необязательный каким указывающий аргумент array проиндексирован образом
$contextnode	обрабатывать xpath указания использован contextnode запросы относительные параметр дополнительный
$proper_address	заданный адрес
$action	soap-действие
$body	фрейма тело
$more_entropy	дополнительную добавит функция конгруэнтный линейный uniqid() равен генератор значения результата возвращаемого комбинированный увеличивает конце энтропию вероятность true используя уникальности
splfileinfo	объект представляющий путь splfileinfo директории класса файла родительской возвращает
$errline	произошла ошибка четвертый которой необязательный строки errline виде аргумент числа целого содержит номер
$field_value	поля значение
$search_value	указано будут данное содержащие возвращены ключи значение
$newparent	превосходящая новая родительская / запись
$machine	машины имя необязательное
$bbcode_container	функцией возвращаемый типа resource bbcode_container bbcode_create()
$preg_split_delim_capture	функцией также строки скобки возвращается указан флаг разделяющем заданной извлекается выражение шаблоне заключенное круглые
$class	объект проверки объекта строка проверка метод которому вестись класса экземпляр интерфейса содержащего экземпляра имя
$str	экранирование подстроки записана которая закодирован получения необходимо следующая разбиваемая декодирования преобразовать исходная строка сравниваемая записываемая который экранируемая токены преобразования убрать обрабатываемая string требуется кодировку изначальная должен определить хэшируемая входная url которую данные длина которой измеряется нужно заменяемая файл кодируемая
$return_var	unix-команды возврата содержать код параметра завершения присутствует переменная статус оба внешней аргумент заданы выходе output return_var помещён эта программы
$base	счисления основание основа системного разрешения внешней это идентификатора system_id системы сущности
$error_types	вызываться соответствии отчете маски какие отвечает будут показаны ошибки использоваться которой error_handler ini error_reporting задания которая аналогии настройкой
$hebrew	иудейском аргументом возвращена формате fl строки заданном виде дата hebrew установлен true аргумент
$replace_pairs	является from вместо использован массивом случае replace_pairs to array( имеет форму array параметр = >
$record	индексированный данных данными массив
$number	32-битных number величина машин положительный 1 числовое строка радианах десятичное 0 2 &nbsp; форматируемое число преобразования целое отрицательный угловая ввода значение 10 возвращаемое градусах область
$connect_type	константа новое подключение строке существующего функцию подключения идентична создаваться connection_string передана pgsql_connect_force_new
$max_chars_per_line	необязательный указывает максимально возвращаемое строку число параметр символов
$table_name	значения rows записи выбираются которую данные копируются которой имя обновляются название базы вставки таблицы опрашиваемой данных
$cas_token	существующей cas которую токен уникальное связанное записывается переменная записью значение
$tag_name	тегов добавляемый новый тег bbcode_container набор
$img_effect_alphablend	false цветов аналогично сопряжение передаче обычное использовать imagealphablending()
$interface	имя интерфейса
$jargon	двух дополнительную jargon language информацию параметры слов различных различения списков имеющих spelling параметр одинаковые содержит
$ip_address	формате стандартном адрес
$microseconds	тайм-ауте устанавливаемом микросекунды
float	арккосинус false диапазоне гамму arg корень number distortion гипотенузы / возникновения свободных косинус канала describing радианах возвращает тангенс nan imagickpixelexception ошибки синус 1 0 заданной числа вычисленная число десятичный степени channel байт точкой дробного отрицательных степень количество переменной нормализованного арктангенс вещественного виде a гиперболический минус операции the значение округленное исключение градусах e логарифм остаток деления успеха случае длина угла чисел изображения псевдослучайное квадратный double y x эквивалент плавающей возводится создано специальное
domdocument	domdocument false ошибке возвращает
$uid	пользователя идентификатор код устанавливаемый
$dbname	базы данных имя
$path1	первый путь
$numeric_prefix	используются элементов индексы числовые индекс указан числовой массиве базом базовом добавлен параметр
$grp	возвращённый запросов возвращенный ресурсов указатель группу eio_grp()
$cut	cut строка указанной ширине раньше установлен переноситься параметр true
$buffer	байт буфера число вывода буферизации содержимое
$sizelimit	выбранных количество записей ограничить позволяет
$fd2	поток resource socket нумерованный указатель сокет дескриптор файла целевой
$syntax	объекта должен задан точками oid идентификатор object 1 синтаксис разделенным identifier формате исходном например
$path2	аналогично файлу второй path1 путь
$dest_height	изображения wbmp-изображения результирующего высота
$precision	знаков количество округлять которых десятичных
$img_effect_replace	аналогично пикселов передаче использовать imagealphablending() true замену
$remote_file	удалённому модификации путь которого сервере время файлу получить файла файл имя
$suffix	оканчивается заканчивается suffix имени компонент отброшен также суффикс исключен файла базового дополнительный имя
$inside	последующие применяться установлено контуру операции true будут внутреннему
$str2	строк строка которых левенштейна одна расстояние вторая вычисляется
$result_identifier	ldap_list() ldap_search() возвращаемый результата функциями ресурс ldap
$thickness	толщина пикселах
$fdf_document	fdf_open() fdf_create() fdf-документа возвращенный функциями дескриптор fdf_open_string()
traversable	внутренний методу итератор передан который iteratoriterator::__construct()
$wbmpname	файлу путь результирующему wbmp-файла размещения wbmp
$raw	типов дополнительная получена вместо информация тех тип raw перебора режиме пор запрашиваются пока требуемый
$max_memory	максимальный умолчанию мб памяти равен временного байтах 2 объем файла
$revno	обновления svn_revision_head умолчанию ревизии номер
$ch	curl_init() curl дескриптор полученный
$stmtname	заготовки исполнению создаваемой подготовленного запроса имя
$binary_string	бинарная строка преобразования
$attr	узел атрибута
$gmpnumber	php resource 5 ресурс числа gmp
$cx	x-координата центра
$cy	y-координата центра
$handler	вызова parser анализатора строка должна которая отправки ошибок момент - подробностей установить handler xml_parse() клиентам содержащая функции true необходимо имя определена
$driver_options	ключ= объекта установки массив одну пар возвращен атрибутов pdostatement значений который метода значение содержит >
$file_name	файлу путь
$local_file	файлу путь локальному перезаписан существует файл
$error_msg	соответствующее ошибке сообщение
$record_number	целое функция записи количества записей количество базе индекс 1 диапазоне дынных числа вернула число dbase_numrecords() возвращает которое данных промежутке
$preferences	передачи preferences контролировать iconv_mime_encode() настройками качестве возможность массива поведение третьего функции посредством аргумента
$signed_text	подписанный текст
$s	учетом сортировка регистра символов
$zp	функцией успешного gzopen() возвращённый указатель открытия gz-файл
$array2	которого массив будут сравнение второй элементы которым значений идет замены взяты
$p	php resource 5 ресурс числа gmp
$array1	основной массив -функция применяется будут сливаемый которому callback первый которого элементы слияния заменены проверяемый первоначальный исходный
$green	компонента зеленого цвета значение
$parser	которого очищаемый ссылкой parser первый получения xml используемый строки номера анализатор задается настройку парсер устанавливается требуется ссылка получить аргумент вызывающий является обработчик
$blocksize	должен используемый ресурсоемкое диапазоне определяет числом блока наилучшее 1 даст сжатие 9 сжатии размера
$image	изображений возвращаемый содержащая imagecreatefromgif() создающих данные таких изображения ресурс функций строка одной imagecreatetruecolor() создания полученный например
$varname	функцией настройки конфигурации доступные изменять переменной ini_set() имя
$iterator	проверки recursiveiterator используемый объект-итератор копируемый требуется итератор элементы бесконечный отсоединяемый traversable которого перебора отфильтровать фильтруемый обходимый класс
$serialized	объект arrayiterator строка сериализованное контейнера предстоит десериализовать сериализованная который представление сериализованный arrayobject
$main_str	основная сравниваемая строка
$server_socket	сокет принятия серверный соединения
$effect	img_effect_normal сопряжение false img_effect_alphablend цветов аналогично пикселов одна констант: передаче img_effect_replace обычное использовать следующих imagealphablending() true замену
$day	1 конца предыдущего количество 31 прошедших разрешенное календаря день дней виде числа calendar зависит месяца значение
$version	xml версии версию содержать mp3-файл документа версия тега объявления id3 soap 1 mp3 часть позволяет теги определять id3-тега файл номер
$matcheddn	dn иначе которой переменную определяется запросе ссылка присваивается null найденный
$value	указано двух инструкции добавить комментария существующей должно опции tidy установлено противном выключена принимает сериализовать ini название array null необходимо обработчика числом новое значения параметр строка массив устанавливает типа добавляемая добавляемое xslt - должен переведён заполнения заданный : функции ignore_user_abort содержимое настройку которые атрибута состоящий сохраняемое настройки закодировано задан option touch() опция необязательный переменной элемента добавления строкой скалярные текст cookie включена записи variable коллекции конец допустимы значение stream_meta_touch начало установки добавлено заполняемое величины функция случае аргументов value параметра true дочернего аргумент константы которое нужно
$noise_type	тип шума
$servicename	название службы короткое
$params	таким псевдопеременных $arr время запроса началу первым указанными установлены должен массив $2 будут вызван т params которые parameter образом массивом параметрами значений замены операций формате $1 $value параметров списка потоковых = ассоциативным фильтр добавлен
$edition	командой create созданное выпуска edition имя sql oracle базы ранее данных
$request	xml soap запрос
domelement	объект элемент false domelement ошибок найден любых случае ошибки добавленный класса либо новый возникновения узел null возвращает
$mh	curl_multi_init() curl полученный мульти-дескриптор
int	конкретного иначе допустимый метки году буферизация директорий метка юлианскому файле gd режим файла наборах тип первого преобразованное файлового альфа umask splfileobject::setmaxlinelen() 0 большого текущего определения определен битовое string дальнейшем констант: функциям группы затронутых представляющее ip_address блоков проблема хэш-сумму типа простым -1 текущие текущий версией текущим момент двух соответствии удалось данная одна одно функции модификаторов ссылок хранения документе процессов произведено ноль который ; которые пикселях текущая колонкой указателя значения ошибки; форматам замены 100 используемой pgsql_errors_verbose параметра виде уровень исключение битовую потока таймаут владелец unix api результатом равны результатов кэширования смещения публичных указанного позицию позиция вызов заданный value2 value1 shmop_open() заданные константами ведет остальных tidy базе база последней относительно xinclude поддерживаются системный номер ходе хотя обработчиков соединения ресурс код другим отрицательное изображений десятичного возникли возвращать таблицу id3-тега fpassthru() объекта должен str2 str1 исчислении мегабайтах 1 отрицательное; числа число пользовательское описывающее ширина дескрипторов хост содержимого socket_recv() mnogosearch; новый новые элементов data неудачном маску a предыдущее соответствует помощью файлов mktime() высоту связанный определенной main_str eio_npending() отражающее заданного юлианском 21 отключен требуемый числовом запрос исключения < общее положения положению строк обработке компонента воскресеньем завершенных удалённый пасхи использованной выполнить определенную sphinxclient::runqueries размер сессии метку целочисленное совпадения памяти временную выполнении запроса неудачи year параметр возвращает строке строка сокета учёта другом строки фрагмента массиве выхода т массива узел описания дескриптора udm_api_version() неизвестен представление доступа модифицированы php_session_disabled поиска сжатие интервал конкретном выполнения ошибок левенштейна словарь ответа совпадающих зарезервированных необработанных возвращается метод последний начальной последним удался array ftp_finished pdo::exec() какие-либо вложенности preg_match() реальный win32_no_error завершении linkinfo() win32 содержащихся соответствующее needle элемента внутреннего указанному совпавшей позиции доступ буферизации текущей выводе b константах адрес корректная iteration установлено положительное предстоит аргумент str интерлейсинга аргументами false флагов временной типу действующему null #0 полей ftp_moredata - сравнения завершающегося = контрольную объект версии модификации ближайшего заданному битах переданному протокол зарезервированному directoryiterator странице определить палитре переданных pgsql_connection_ok соответствующую скопированных 0; рядов парсера вхождений максимальный генерирует коллекции работы результате результата вывода curlm_xxx точность произошла ошибке ошибка меньше указанный предупреждений вернёт ошибки произошло направления ldap записанных truecolor-изображений handle точно установлена объем поля поток resource миллисекундах сжатия изменения длина ftp_failed прочитанных ошибках большой ссылку других pgsql_connection_bad mysql слева удачи независимо предыдущий выбранное одной отказе флаги subject смещение найдены pattern права заданном базу заданной успешной успешном функции: набор байт целое lstat записей числовое gz-файла gz-файле символа crc32 летоисчислении действовавший директории юлианский c обязательных шаблона поле аргументов пути запросов совпадений текущую найденных стоит направо открыта последнего успешного вхождения индекс парсеру противном запуска inode 255 осуществлен следующих действительному жанра версию > старая запросом завершения количество xxx возвращен нового пользователя случаях формате gmp распаковки одну успеха функция value успехе константу значений пикселах установлен connection_xxx протокола mnogosearch прав блока настройки время возникновения пасхальным записи id возникла такого даты использован подобно календаря календарю бит timestamp эта разделяемой oid использовать текущему php согласно отметки сигнатура 32-битную eio_nreqs() переданными the сгенерированный критичности клиент выполнен пользователем механизм объектом месяце удалены первый масштаб дней найдено возвращаемый содержит записанной статуса успешно arrayobject длиннее haystack скрипта времени компрессии auto_increment сжатый ошибку григорианскому integer символов аргумента вернет выведенной начала которую imagick изображения байтов строками файл параметру обнаружена кодов импортированных команды максимальное статус сессий значением отдельной обработчика нуль нулю используемый gearman буфера участку сумму констант день лимит найдена нулем процесса st_dev ресурсов offset активирована двумя значение максимальную socket_send() файлу цветов марта индексного альфа-канала ссылка дня ссылки является трех кадров соединение image идентификатор начиная свойств новое прилинкованной сравнить errno перемещения строках изменилось ipv4 lob действительно гравитации итератора активна параметрами выбранного ресурса true eof count colorspace которой либо найденного описанных положительное; которое умолчанию длину parser измененных отправленных юлианского расстояние переменных сжатого пуста данных возврата целого ascii-код pgsql_errors_default pgsql_errors_terse структуры владельца 5 ширину реального stat базового дата sql возвращена бита ревизии равно полученных цвета возникновении создано случае байтах созданного mp3-файла метода gmpnumber
datetimeimmutable	объект false случае ошибки новый возникновения возвращает
$arrays	определяет виде разделы формировать массивов
$note_name	название уведомления
$language	страны параметр необязательного состоит language 639 двухбуквенного - тире 3166 подчеркивания это iso код который кода стандарту языка двубуквенного
$maxlen	максимальный предварительного переменную читаемых размер подсказка выделения памяти данных
$trimmarker	добавляемая конец строка обрезанной строки
$notation_name	name описано выше обозначения виде сущности см имя
$sort_flags	локали типов сортировки: sort() строки изменения сравниваются изменить типы параметр флаги используя функцию значений: элементов сравнивает помощью флагов: элементы см sort_flags - строковое поведения виды поведение следующих sort_locale_string sort_numeric следующие необязательный учетом числа сравнение можете числовое sort_string использовать сортировки второй текущей подробнее sort_regular дополнительный обычное значения: нормальное меняются смотри сортировок
$n	php resource делимое 5 ресурс числа gmp
$assoc_array	которого названиями колонок array таблицы необходимо значения массив - являются table_name которые вставить преобразования именам колонки записи ключи данные ассоциативный котором соответствуют
$extended_data	ntfs архиве информация системе добавлена такая acl дополнительная unix присутствовали владелец true файл извлекаемый
$timezone_identifier	europe utc зоны временной / идентификатор lisbon например
$i	сортировка регистра учета символов
$d	a делитель убыванию n сортировка модуль числа
$b	a php resource вычитаемое множитель 5 ресурс числа число gmp второй умножаемое
$c	символ рисования
$a	квадрат которого сканирования корень первый множитель умножаемое точный проводится возрастанию 5 проверяемое числа число gmp сортировка извлекается php значение b resource проверка изменяемое ресурс уменьшаемое
$radius	пикселя размытия радиус считая центрального гаусса пикселях
$mailbox	почтового ящика имя
$x	пиксела начало обрезания угла координата начала обрезаемой области x-координата длина делимое первой рисования x верхнего левого отчета оси стороны
$y	делитель пиксела начало обрезания угла координата начала обрезаемой области рисования длина отчета y-координата y верхнего левого второй оси стороны
$initial_value	записи устанавливаемое инициирующее установлено ключа переданного существует которое значение
array	возвращаются simplexmlelement записи допустимым иначе четыре файла название произошедшей связанными значения iterator массив этому 0 текущего хосте представляющих формате: string прочитанной системе encoded_headers отфильтрованный группы обработчиками записи: связанный битовая arrayiterator level индексированный php_output_handler_user фактором вызвана zlib идентификаторов каждого разрешено численно valiant рамки функций функции задано ключами: процентное расширенных заголовков определенных ticks следующее version который reflectionfunction которые следующей названиями настроек классов координата libxmlerror сокращенное apache загруженных reflectionclass первая параметра десериализованный значений параметре уровень cookie соответствующими пуле угол полученные модулем различия вторая результатов полученный публичных ними элементы handler 6 кода type статистику состоящий stat() правый остальных базе sphinxclient::query() ассоциативного последней ssl_version_number номер границам имени успехе данная обрамляющей соединения del потоков: локали вызова передаёт срез возвращать обёрток каждом reflectionmethod php_output_handler_end id3-тег sysname объекта файла; 1 пользовательской элементов: числа число серверу любом файле; (остаток определённых получаемый перевернутый элементов углах a частное пользовательских h:i совпадающие флаг callback объявленных соответствующего пустой элементами: файлов информация информацию серверов подробно каждый горизонтальным величину setlocale() момента url-rewriter числовой исключения опции строк сколько timestamp порядке тактов класса используемыми удалённые array_udiff_assoc() стека потоковыми прошедшее дополнительную name информацией: переменных файлов; размер сессии lifetime -- лексем расшифрованный module_name псевдонимами совпадения шаблону данные static запроса неудачи которая параметр возвращает очистки текст строка указанных строки т массива 7 описания перезагрузки ассоциативными задан которых зарегистрированных описанием глубины mime conflicts статусами ключи остаток ошибок openssl пронумерованный результаты деления ответа curl_version_xxx features возвращается метод notify array full_status месяц size интерфейсов [last_author] выполненной являются 2 кодировки завершении адресов hue элементе члена колонки полную вывода текущем http-заголовки текущей построчный version_number keyword индексный добавленными чисел -заголовков одна точки false plaintext двух доступных автор всеми ассоциативных установленной последующих ряду каком-либо описание - выборки модификаторов client отсутствующие системы subject = soap объект версии директив getdocnamespaces object странице часть объекты quantumrangelong переданных функцией присвоенный ssl_version uri простого рядов имя объектов работы релиза результате text текст: результата каждому reflectionproperty результат трассировку содержащий php_output_handler_cont произошла ошибка title меньше модулей ошибки &nbsp; модуля прототипов 8 localeconv() columns класс насколько ресурсами имен php_output_handler_start поля значениями кэша заполненный artist luminosity выполнении d] целая release x одному других вместе обратном вызывающая полями статистической запись типа pattern будут полученному ответ папки 3 quantumrangestring заданной разбита верхний котором успешном целое массивов записей операционной отражающих строку optional директории директорий возвращен бинарной серверах данного аргументов пути pdo аргументах подытераторов текущую репозитории: найден вертикальным форме разобранных числовыми последнего должна бд индекс противном описан текущих год спектра следующих подробными жанра элемент мета-тегов > встроенных хранящихся количества указывает c корня формате getnamespaces protocols gmp преобразованные системное успеха функция типами n статических распакованные адрес внутреннюю элементы: saturation включая время -функции существуют hsl-значение возникновения секундах возникла дату null ключей переменными массивах hostname [created_rev] левый зависимости эта status http nodename список полное различными заголовками возвращаемого найденных полей вложенности видимых данной подписи элементами нумерованный этим ассоциативный установленный y потоков 24-битный protocol месяца объектом первый которого велико сообщение высотой возвращенные содержит копией основанные группе присоединенного именами расширении включает 4 ключами 5 скрипта скрипте настройки например совпадений сервера данными integer находится вернет d imagick качестве соответствующий изображения соответствующим протоколов msgno сервер видимости автора php-массив соответствующие файл копию копия параметры поддерживаемых версий пару libz_version значением server пространств результирующий обработчика буфере нормальном / нестатических атрибутов констант день правки возможные представляющий присоединенных процесса следующими многомерный подстрок host виде output двумя значение параметров названия недели отсутствия см файлы параметром имена ключ дня информацией является такую элемент- жизни составленный bson свойств некорректно многомерного статистикой rows array1 * ревизии применения ipv4 [n следующие системного заголовкам следующий набором использовании запущенной ob_get_status() нижний отдельный действующего запросу свойству default изменения фиксированного либо шириной умолчанию содержать имеются m pid области ob_start() php_output_handler_internal linux) curl байтах данных сообщений столбцы групп маска простой собрана реального отношение ini-настроек контекста дате формат imageftbbox() дата второй слияния драйверов итератора списка age required случае __autoload столько time работающего cpu
$delimiter	разделитель значения rows полей экранироваться устанавливает элементе указан случае также символ необязательный delimiter массива каждом отделяющий поля параметр друг дополнительный друга
$bbcode_arg_parser	функцией resource типа возвращаемое bbcode_container bbcode_create() значение
$user_agent	agent user анализируется
$http_response_code	принудительно ответа http код задает
$ignore_transparent	равно иначе нулю игнорируются установлено сохраняется прозрачность
$contents	создания файла содержимое
$src_im	изображения ресурс исходного
$position	переместиться требуется которую позиция указатель которой переместить нужно
$extr_prefix_if_exists	данной переменной создать таблице префикс-версии префикса символьной версия переменных существует текущей
$start_index	возвращаемого массива первый индекс
$carry	итерации initial случае параметра результирующее предыдущей первой итерации; содержит значение
$frombase	счисления системы основание number числа
$jpeg_file_name	изображению путь jpeg
$preserve_keys	сбрасывает умолчанию будут установлено обратите array_slice() массива внимание true сохранены ключи
$dbase_identifier	функцией возвращаемый dbase_create() идентификатор dbase_open() базы данных
$cast_as	вызывается других stream_cast_as_stream вызывает stream_select() либо stream_cast_for_select целей stream_cast()
$opacity	объект содержащее прозрачности imagickpixel дробное число значение
$server_key	хранится сервер ключ котором идентифицирующий значение
$host	memcache сервера хоста имя
$dst_image	изображения ресурс целевого
$case_insensitivity	регистра учетом сравнение case_sensitivity выполняется имеет true значение
domtext	объект false случае типа domtext данные класса либо ошибки новый offset узел содержащий
$exception_handler	вызываться неперехватываемое каждый выбрасывается которая функции имя исключение
$in_fd	поток файла-источника сокета дескриптор входной ресурс
$rev1	первого файла ревизии номер
$rev2	аналогично второго файла rev1 ревизии номер
$extr_if_exists	противном случае переменные таблице перезаписать имеющиеся делать символов текущей
$get_as_float	указано string вместо описано float установлено разделе возвратит значений ниже true microtime() возвращаемых
$maxlifetime	удалены будут сессии обновлялись maxlifetime течении секунд которые
$deref	определяет псевдонимы время обработаны поиска должны
$newname	новое имя
$extr_prefix_same	таким имени именем параметром определённый её префикс prefix добавлен существует переменная
$function	вызова вызываться имени применяется обратного функция сервер получит работу каждому элементу которая функции зарегистрированного имя
$points	2 последовательных x1 массив y1 вершин 1 0 3 points многоугольника координаты y0 y x x0 содержащий = многоугольника:
$char_list	данный параметр чувствителен регистру
$julianday	юлианском летоисчислении дня номер
$value_compare_func	callback-функций должна пользователем возвращать большим функции нуля usort() примеров меньше сравнения равным целое меньшим используемая сортировки второй смотрите равно является предоставленных функция первый uksort() callback-функция аргумент соответственно которое
$errcontext	произошла ошибка массив точке необязательный активную указателей пятый errcontext таблицу аргумент содержит символов
$start_element_handler	xml parser resource string должна является $name именем функция ссылкой аргумента: первый start_element_handler анализатор вызывающий array $attribs обработчик принимать $parser аргумент
$dn	объекта отличительное уникальное записи ldap имя
$elementid	id элемента уникальный
$mtime	время последнего изменения
$bestfit	подгоняться рамки внутри изображение ограничительной
$plaintext	параметру текст plaintext шифрования подписания простой передаётся расшифрованный обычный
$target	инструкций target документа содержит применения аргумент ссылки pi цель второй обработчика
$deep	поддерево рекурсивно узла импортирует метод importednode указывает потомков установлен копировать true нужно
$keys	ключей ключами массив записей будут качестве запроса значений ключ использованы записи которые получения удаляемой
$req	ресурсом запрашиваемым указатель использоваться опциональным такими функциями ресурс который является eio_get_last_error() запроса
$vars	преобразовать vars которой переменную - ссылка необходимо содержимое
$operation	значений: чтения совместную установить блокировку следующих одно operation принимать lock_sh
$preg_set_order	$matches вхождений упорядочивает далее второй 1 0 первый результаты элемент содержит набор
$blendmode	включить сопряжения режим
$small	находится требуемая память распаковки использован районе альтернативный памяти максимально медленнее использующий вдвое меньше алгоритм работает true 2300k приблизительно
$session_mode	версии php доступен 1 5 oci8 начиная параметр pecl
$referrals	строк массив которой переменную отсылками пустой всеми ссылка виде присваивается referral возвращены array
$red	компонента цвета красного значение
$colorize	объект содержащая imagickpixel строка цвет
$assoc	возвращаемые будут преобразованы массивы объекты true ассоциативные
$is_dst	неизвестно данный умолчанию дате соответствует дату -1 dst случае противном действует 1 0 время заданной установлен летнее параметр заданную значение
$new_size	размер новый
$frameid	кадр id3v2
$wsdl	происходит uri не-wsdl режиме файла работа wsdl null
$extension	имя необязательное расширения
$process	proc_open() resource помощи типа закрыт дескриптор открытый который функции
$from_encoding	from_encoding запятой строки виде массива разделенными задается array кодировками string
$stream	проверки созданным поток файловый целевой stream pfsockopen() указатель любым потоком fopen() функций fsockopen() переменная помощи
$workload	вывести произвольные поток какие-либо обработке подлежащие сериализованные данные отклика выходной некоторые сериализированные которые получения
$base_group_id	password идентификатор базовой группы файла
$who	вызвана who rusage_children равен getrusage 1 аргумент
$decimals	знаков число запятой устанавливает
$additional_parameter	параметр командной mta строки значением является additional_parameter
$client_area	окна включает клиентскую часть приложения
$dev	специальных устройств файлов задает создании нумерации типа eio_s_ifchr eio_s_ifblk dev файла параметр границы нижнюю верхнюю
$var1	переменная
$...	локали -функцией другая которыми vars присвоены индекс (необязательные браться ссылке запятыми необязательные разделённые считанные сравнению значения аргументы попытки дополнительные будут строки сравнения элементы которым индексы первой = переменная > сливаемые строк настроек массивов массивы обработки которых сравнение виде замены успешной значение установки поддающееся определяет передаваемые переменные callback синтаксис осуществляется рекурсивно форматирования любое
object	объект итератор информацию указывает object класса экземпляр контейнера новый который содержащий возвращает колонке
$preg_flags	выражения настройки флаги регулярного
$interface_name	имя интерфейса
$output_callback	необязательный параметр output_callback задать
mixed	иначе случайного проблема файле файла название значения массив маленьким 0 позицией текущего дескриптор атрибута выражению string достигнут msec выбрасывается значительно arrayiterator типа собой указанной первой текущий успеха кеше cookies задана substchar флагов одно функций функции index глубина который которые следующей вызванной eio_get_event_stream() первая параметра представляет options которого unix наличие вторая select смещению указанного рекурсии вызов января заданный успехе; само результирующую запрашиваемого код возвращать недопустимое большим таблицы microtime() любого объекта e_warning 1 сжатая число солнца кодировку новый некорректных элементов неудачном предыдущее отличным любой соответствующего результат информация вернуть basename jpeg передан каждый заданного мажорную исключения return array_rand() значениями класса микросекунд равны; считается domnodelist win32 mode count_chars() ранее результирующего запроса просто dirname возвращает строке архива такового строки переданы массиве т массива -1 задан случает набора конец выполнения является ошибок примеру ответа encoding возвращается последний array захода значений: $this являются 2 завершении option needle элемента текущее позиции вывода возвращающих одного аргумент str типизированный false указателя указатель замененными типы null согласно - сравнения объект внутренний заданному object ключ различные секунд рядов нескольких вхождений работы show результата неудачного содержащий например предупреждение меньше explain ascii-коды ошибки исходное класс распознанные имеет поля столбца поток resource данные возможно url-адресов других узла simplexmliterator установлено pdoexception sec флага subject будут filename заданном могут успешном целое напечатано записей javascript строку символа массивом возвращен запросов pdo текущую найденных найден таких типов возвращаемый успешного индекс ссылается противном находящегося json следующих версия элемент самым parser завершения указывает содержащую возвращаться формате exception успешный преобразованные одну функцию функция столбцов потомков gmt константы второй; элементы: восхода время возникновения это mb_http_output() эта http предыдущий анализатор oid минорную php стандартным указывал expression 1970 ассоциативный браузера отображается прошедших объектом эпохи имеющих последнего содержит разборе mysql_query() недопустимый opt настройки format зависимости сервера integer символов аргумента вернет начала индексами сериализованы соответствующие соответствуют опущен переданное помещены значением распакованная запрошенных вызывается id; хранимое / тип preg_replace_callback() подсвеченный виде ассоциированные значение extension имена узлы пока float установленных обнаружена свойств приоритет пустого parse_url() максимальная xpath следующие version_compare() переменной json_encode() указан параметрами true spool-флаг версию либо которое умолчанию содержать describe выборе переменных иметь параметр ограничена 0:00:00 количество именам получившееся другое строка передаются случае фреймы имя правилам метода обработчик
$dst_im	изображения ресурс целевого
directoryiterator	элемент directoryiterator текущий
$country_code	страны двухбуквенный смотрите geoip_country_code_by_name() код
$note_value	уведомления значение
$process_sections	секции секций отдельных настроек названия массив process_sections получаете многомерный включает получить который название параметр true установив
$warning	вывода предупреждения сообщение предупреждение
$slant	наклона уровень
$driverdata	дополнительные драйвера параметры
$key_compare_func	равно целое соответственно ключей второй должна меньше меньшим функция нуля возвращать большим сравнения первый callback-функция аргумент является равным которое
$property	опций констант свойства анализатора парсера одна имя
$session_data	закодированные данные сессии
$angle	должен text поворота угол против часовой котором стрелки измерен градусах
$command	программы - команда фрейма выполнена прим которая имя аргументами
$bytes_transferred	заполнен параметр bytes_transferred доступно
$library	требуется содержит загрузить расширения файла которое имя аргумент
$from	заменена строка string oci-collection to экземпляр строку которая
$limiter	ограничитель
$criteria	принимающая строка устанавливает вид - флаг1 флаг2 атрибут первый т поле1 поле2 сортировки второй
$new_password	пароль новый
$field_name	поля имя
$flag	умолчанию false вместо какие замечание освобождаются противном oci_lob_buffer_free позволяет компоновать произвольно значения аргументы сброса since array_filter_use_both сделать информацию - это массива bool : принудительно array_filter_use_key использование flag отдельных группах включения аргумента определяющий true разработчиков используя значение неявного ресурсы случае можете флаг передавать callback 2 ключ аргумент
$string	преобразовать исходная строка входная которую переворачиваемая 8-битная оцениваемая символ длина которой измеряется заголовка конвертации исследуемая экранирования экранируемая записываемая string
$from_root	xml пространства вместо документа рекурсивно узла имен дочернего позволяет проверить корневого
pdostatement	объект выполнить false подготовила успешно запрос pdo::query() pdostatement субд удалось pdo::prepare() возвращает
$depth	максимальную указывает глубину рекурсии задает
datetime	класса экземпляр возвращает новый datetime
$object_id	объект попытается сервером функция задан использован создать случае object_id этим противном идентификатор свободный аргумент идентификатором назначенный
$ending	необязательный разделитель строки
$pct	совмещаться соответствии серого 0 зависимости будут варьироваться src_im pct параметра изображению изображения результирующее изображение который значением 100 преобразовано градациях
$field_offset	числовое смещение поля
$bgd_color	зоны поворота фона свободной цвет
$options	удалены режим вроде pgsql_dml_exec pathinfo_extension значения массив отдельный pgsql_conv_ignore_not_null дополнительные pgsql_dml_no_conv побитовое пар ожидания настройки libxml_* битовая pgsql_dml_string name json_force_object timeout json_hex_amp параметры параметров: pathinfo_filename одна json_numeric_check параметр pgsql_conv_opts array констант которые json_unescaped_slashes настроек массивом mailbox pgsql_dml_async значений pathinfo_basename $value элемент: состоящая pgsql_conv_force_null options pathinfo_dirname $arr опции опций stream_mkdir_recursive начиная определяющий устанавливает wrapper json следующих > также option задает требуется указан добавления pgsql_conv_ignore_default формате принудительно время value json_pretty_print либо json_hex_tag безопасный должны устанавливаемые libxml json_unescaped_unicode секундах декодирования возврата json_hex_apos 0x04 маска 5 = json_hex_quot составляемая записан версии должен комбинация php включить pgsql_dml_escape ассоциативный ассоциативным составленная
$shmid	функцией возвращаемый памяти блока участка идентификатор shmop_open()
$result	ответа sqlite результат возвращаемый работы большого результата возвращенный функциями result array содержащий текстовое содержит lob resource объекта символы внутренней запроса; массив зависящее возвращено прочих pg_query() числе это дескриптор обычно кодировке скрипта среди соответствующим представление ресурс pg_lo_open() object указан сервера декодированные результирующее вызовом поиска pg_execute() системным значение функцией ldap_search() postgresql прочими предыдущего данные типа large возвращаемое ссылке аргумент обрабатываемый сериализованные результаты pg_query_params() запроса
$setting	вида установка foo=bar
$in	объектов несколько - bucket данные указывающий содержащих фильтруемые ресурс in которая содержит brigade
$filesize	количество резервируемых байт
$return_array	вернет объекта функция вместо массив равен object array true
$part	какую определяет строки результата качестве часть вернуть haystack
$open_mode	файлом открытия работы режим файла
$dest	поток назначения целевому файлу путь
$calendar	cal_julian которого вычисления parsing cal_french calendar произведена дату преобразовать используемый for конвертация to календарь который use cal_jewish из: formatting cal_gregorian or нужно
$sections	разделенных массиве разделов список запятой array представлены должны которые результирующем
$servers	хост:порт отделенных запятой список серверов формате
$sortfilter	атрибут используемый сортировке ключа качестве
$startpos	загрузки загрузка удаленном которую позиция начинается файле начала
$initial	использован необязательный процесса initial случае результата начале окончательного массива качестве передан параметр пустого
$modify	даты времени строка /
$format(string)	используемый строки формат date функции strftime() например
$dictionary	идентификатор словарю словаря путь cracklib
$server	хост сервер ip-адрес mysql
$modifiers	значения числовые требуется имена которых получить модификаторов
$major	старший s_ifchr s_ifblk использовании констант устройства параметр обязательный номер
$open_entity_names	участвовать разделенных сущность имен список - могут open_entity_names включая разборе сущностей пробелами аргумент текущую которые сущности второй текущей
$message_code	события доступен передаётся код сообщения описывающего
$cost_ins	определяет вставки стоимость
closure	объект closure false случае ошибки новый возникновения возвращает
resource	ссылку иначе базой созданный нарушены zip_close() show обратиться лежащего eio_fallocate() stream_filter_remove() zip_entry_ ниже mysql потока eio_sendfile() xml ошибке уровнем explain fgetss() ошибки запрос дескриптор ldap распознаются номер eio_lstat() такими использован fwrite() результата eio_rmdir() вернет поток resource поддерживается eio_fchmod() eio_futime() данные типа вернуть изображения идентичный eio_grp() помощи экземпляру файла передает ресурса фильтра result неудачи доступных исключением параметр возвращает mysql_unbuffered_query() файловыми запись сокета filename тип могут большого который базы eio_write() успешном новое дальнейшего этому постоянного аналогичный поиска eio_read() возвращен postgresql выполнения анализатора запросов закрыт словаря принятого eio_dup2() ссылки положительный новый сокетом успешного возвращается zip_read() идентификатор подключиться результатов eio_busy() select pclose() считанные eio_ftruncate() подключения чтения выполнении возвращаемому использования открытый socket_create_listen() завершении повёрнутого eio_unlink() другими завершения fgets() записи файловый операции feof() файл тому функцию функция файлов успехе соединения функциями либо ресурс fopen() запроса вызова fclose() false eio_stat() describe указатель время bzopen() возникновения curl существует данных объекта должен односторонний eio_seek() новых загружены последующего eio_mkdir() выражение eio_chown() контекста eio_nop() eio_fstatvfs() eio_mknod() каталога удалось успеха функцией возникновении открытие случае созданного callback
$database_name	выбираемой имя базы опрашиваемой данных удаляемой
$weights	полей названия массив индексов весами ассоциативный названий integer весовых коэффициентов связывающий string
gearmantask	объект добавлена задача false gearmantask
$unescaped_string	строка экранируемая
oci-collection	a on ocicollection false object error new or
$dir_handle	функцией resource помощью предварительно каталога дескриптор открытый ранее opendir()
$percent	двух строк похожести степень третьего присваивает similar_text() передаче процентах ссылке аргумента
$old_password	старый пароль
$function_name	регистрацию рабочим зарегистрировать необходимо процессом функция требуется вызываемая зарегистрированная которой снять сервере функции которое имя
$encoding	документов объявления слова одна http параметр php xml ищутся клиентская документа encoding 4 / даны констант это mb_http_output() кодировка требуемая строк задан задает необязательный кодировку null ожидаемая ввода симоволов выбирается псевдонимы часть конвертации ожидается вывода определяющий символов входных устанавливает используемую выходных собой которой аргумент представляет набор zlib_encoding_* символьную
$oldnode	дочерний узел удаляемый атрибута
$attribute	строка происходит группировка которому атрибут констант название pdo::attr_* содержащая атрибута одни
$protocol	регистре domain protocol stream_ipproto_raw tcp связи обёртки название stream_ipproto_icmp параметр stream_ipproto_udp используемый устанавливает регистрируемой определённый протокол: stream_ipproto_tcp который нижнем udp протокол использоваться полученными указанном stream_ipproto_ip семействе протоколов or сокетами
$backlog	максимальную вырасти ожидающих длину соединений определяет которой очередь параметр backlog
$fingerprint	отпечаток ключа
$link_identifier	возвращаемый соединение mysql ldap_connect() возвращенный идентификатор ldap ссылки
$num_points	точек должно меньше вершин 3 число общее
$verbosity	pgsql_errors_default требуемый режим: pgsql_errors_verbose pgsql_errors_terse
$file_ignore_new_lines	добавлять элемента концу строку массива каждого новую
$val	округления проверяемое значение
$details	сведения значения детальные выводить текущие настройках
$data_type	тип параметра заданный явно данных
$date(string)	результат строка выполнения разбора строковый функции strftime() например
$consumed	должен читает consumed изменяет передаваться увеличиваться ссылке размер который фильтр которые данных
$extr_prefix_invalid	числовым некорректным именам / prefix добавить переменных префикс
$extr_refs	ссылки переменные извлечь
$isid	сделать name установите случае противном ставьте false идентифицирующим true требуется значение
$preg_pattern_order	$matches полных массив упорядочивает подмаски далее 1 0 первой результаты элемент шаблона содержит вхождений
$peername	оно транспорта адрес клиента подсоединился содержится присвоено который выбранного доступно имя
$var	любого проверяемая проверяется php скалярного указывает замечание поток типа преобразуемая тип которой ispell-данных 5 источник удаляемая проверки : переменная данных
$link	функцией возвращаемый ldap_connect() соединения идентификатор дескриптор ldap ссылки имя
$newrdn	новое rdn
$allow_string	false параметра object строки допускается качестве класса виде установлен параметр имя
$exception	исключения описание
$font	идентификаторов встроенных ваших значения помощью большему 1 3 2 5 4 число кодировке любому шрифту зарегистрированных шрифтов imageloadfont() latin2 соответствует высокое собственных принимать
$is_final	разборе задан считается data частью последней установлен true
$query_data	массивом свойства содержащим объектом
$threshold	черными которого ниже пиксели включительно станут 0 пороговое ограничение 8 значение 255
$round	приведено описание gmp_div_q() документации функции round аргумента
$null_as	значения rows определяет представлены каким массиве sql null образом
$thumbnail	прочитан true эскиз
$field	выбираемого получаемого значения смещение string имени номером индексом начинается 1 integer нумерация именем порядковый поля нуля задано начиная имя номер
$search	также искомое иголка needle известное значение
$lob_to	lob объект назначения
$delay	попытками записей миллисекундах аннулированием задержка задержки секундах величина
$num	вставляемых определяет выбираемых отсечения количество элементов
$reference	containing reference image object imagick the
$zip_entry	директории функцией возвращаемый zip_entry_open() дескриптор открытый zip_read() ранее
$minute	hour количество указанного прошедших параметром минут начала часа
$ident	каждому добавляется ident строка сообщению
$enabled	сглаживание включить
$pngname	файлу путь png
$servername	x сервера имя
libxmlerror	объект false буфере случае ошибки противном либо libxmlerror возвращает
$sandbox	обрабатывать которого вывод экземпляр необходимо runkit_sandbox
$параметрmessage	%m значению сообщения соответствующей исключая errno будут strerror сообщение строкой ошибке символа отсылаемое текущему заменены
$src_image	изображения ресурс исходного
bool	иначе исполняемым; допустимым строки непустое файла классу массив вывод 0 текущего замыканием определен выражению система достигнут требуемый регулярному типа собой текущий момент вызвана sqlite_has_more() статический соседние задана статическое доступных допустимым; index допустим; исполняемым недоступен клонировать который public объявлен apache чтение html-документа навигация параметре представляет локали собран потока class_name компиляции private boolean содержащей пройдена пробельных данному установлены пространством указанного позиция элементы заданный заданным нижнем неверный прекращения остальных какой-нибудь memcache записи рабочем атрибуте многопоточной хотя передачи возвращать переданный объекта должен частный method_name числе числа число защищенный a частное соответствует числом известно результат вернуть файлом передан каждый 1 невозможно запрос каталог interface_name заголовки расширение класса отправить php-кодом name комментарием буквой абстрактный именованная реализация регистре частью namespaceuri запроса неудачи деструктором параметр возвращает строке текст ссылкой массиве т транзакция узел наследующему asp задан чтения; позиционирование конец доступные выполнения проверка цифрой ваша константа error_type разрешенном a-fa-f неуспешном неверное метод $a array объявлено равен десятичной защищенное стандартное needle элемента внутреннего своих текущей завершении данной общедоступный protected аргумент поддерживает false диапазоне задание указатель видимый указанная null достигнут; описание - дочерние объект внутренний object пароль определить рядов работы конце результате text потомки мусора директорией подзапроса ошибке ошибка указанный ошибки обычным --enable-debug управляющим модуля предков класс вложенные пробелы имен содержимому объектом имеет closure данный успешном создать возможна узла обратном result работает filename доступна успешной использует доступно magic_quotes_gpc печатным принадлежит печатный массивом пример фактически обычно найден false; внутренняя должна успешного ссылается противном свойство файловая версия элемент загружено; завершения возвращается диапазона расширенные случаях скалярным успеха функция успехе ненулевое установлен неправильный конструктором элементы; включая время существуют возникновения возникла сборщик пустой бит это данных эта http анализатор занято строкой удалось php предыдущее именем выборки включен пользователем timezone_identifier конфигурации директория содержит путь успешно символов недопустимый выполнить итератор включена символом jste password запущен символ находится вернет выключен качестве возвращаемое файл полноцветное оно параметры статус наследника верхнем чтения вызывается определена gearman возвращено буферизация / записи; платформы процесса выполняется атрибуты значение файлу взломоустойчивый параметром ссылке создает является устарела соединение image float узлы lob val сессионного символической шестнадцатеричной var разрешения пространстве переменной допускается активна хранилища опцией true child_terminate доступен состоянии либо умолчанию пустым parser целым значением курсора существует очищает сильный целого nan противно field контейнере экземпляр отправлены устойчивое квадратом интерфейс итератора eof создано случае конечным метода отключена
$before_needle	первого strstr() исключая true вхождения needle строки включая часть stristr() установлен haystack возвращает
$client_info	задаваемая 64 пользователем строка байт
$right_operand	правый операнд строки показатель слагаемое виде вычитаемое множитель степени второй
$seconds	положительным тайм-ауте выполнения должно числом устанавливаемом целым секунды время максимальное секундах
$local_socket	стандартного target сокета использованием / определяется тип транспорту указанному transport: форматирования создаваемого url:
$schema	должна указана тип схема создан именованный данных
$decode_binary	функцией умолчанию данным бинарный декодировать закодированы decode_binary примененный код sqlite_escape_string() установлен параметр true php
$optname	сокета socket_get_option() опции самые те возможные функции
$class_name	регистре пространства которого путь splfileinfo описание требуется имен объекта создаваемого загрузить класса получить splfileinfo::openfile() используемого искомого метода нижнем имя
$font_index	функцией шрифта возвращаемый ресурс imagepsloadfont()
$row	полем получаемого выбираемой ряда строки результата запроса нужным номер
$dst_h	результирующая высота
$spool	возвращен строки jpeg 2 флага виде значение
$argument	объект экспортируемый reflection
$dst_w	результирующая ширина
$component	конкретный укажите php_url_scheme одну php_url_port строки компонент виде php_url_pass php_url_path php_url_fragment констант php_url_host получить url php_url_query php_url_user string
$regs	совпадения аргументом элементах найдены вызывается pattern будут функция regs подстрок массива скобках третьим сохранены
$salt	основано необязательный которой солью параметр хэширование
$observer	объект класса присоединения splobserver отсоединения
$dst_x	изображения результирующего x-координата
$dst_y	изображения y-координата результирующего
$location	url запроса
$password	username используется элемента пароль пользователя текущего проверяемый расшифровки
$encoded_string	url кодированные данные
$column	столбца 1 нуля массив будут результата данные колонки которой наборе запроса помещены начиная результирующем имя номер
$format	месяца результата название распознаются задается настройки разберет string format датой %d %a сервера ведущим аргумента выводимой возвращаемое sunfuncs_ret_string соответствии состоит get_headers() возвращаемого одной функции saturday строке символы строка sun строки ответ тип которым день массива ненулевое пробелом представление следующими форматирования шаблон значений sunfuncs_ret_double сокращенное результирующей ключи значение нулями ведущими недели опционального 31 параметра виде влияют дня константа float см описанный кодов %e следующие 01 описание необязательный указывает описании повторения формата смотрите пример 16 функцию документации str установлен strftime() локали --- интерпретирована sprintf() sat параметр даты двухзначное установит sunday цифры отличиями: полное 16:46 формат constants данной возвращаемых
$glue	равен умолчанию пустой строке
$count	извлекаемых замен произведенных повторных количество указана эта удаляемых замены передан установлен заполнена переменная символов попыток количеством
$socket	созданным созданный помощи предварительно функций параметр должен сокета будут функции действующий отправлены который socket_accept() сокет удалённый ресурсом data действительный socket данные ресурс socket_create()
$preg_split_no_empty	вернет функция указан непустые флаг подстроки preg_split()
$refnode	узел опорный
$gearman_return_t	gearman возвращаемое допустимое значение
$columns	ширина количество области масштабе столбцов изображения
$mask	новая umask
$new_link	новое функции соединение установлено вызов теми mysql_connect() произошёл второй аргументами
$add_empty	результат отсутствующие значением null добавляет ключи
$psdoc	resource returned of ps_new() postscript as file the identifier by
$is_associative	числовыми false массив возвращается передан обычный индексами установлен
$session_id	идентификатор сессии
$value_cb	null результат callback-функция возвращающая
$encoded_headers	виде строки раскодированные заголовки
$left_operand	основание операнд строки первый левый слагаемое виде множитель степени уменьшаемое
$save_indexes	возможности сохранить массиве оригинальном индексы заданные численные
$text	проверяемая текст строка расшифровки измеряемая расшифровываемый
$deleteoldrdn	значения удаляются старые иначе сохраняются записи неуникальные rdn true
$original	оригинальный класс
$to_encoding	string которую перекодировать строку необходимо кодировка
$how	запись значения чтение 0 следующих: how одним завершает сокета 1 параметра 2 сокет возможные значение
$whence	установить байт значениями смещение абсолютную следующих: устанавливает seek_set - значения одним параметра whence позицию являются: offset
$timetype	use short full none long to medium time type
$modulus	результат строки делится виде модуль
$method	1582 даты - календаре григорианском установить пасхальные расcчитать cal_easter_roman позволяет годов основываясь 1752
$brush	изображения ресурс
$qualifiedname	prefix:tagname элемента стандартизованное сформированное виде атрибута имя
$preg_split_offset_capture	строке подстроки указан позиция указана флаг исходной каждой найденной
$limit	часть максимальное каждой возможное возвращает подстроке subject строке возвращена группе строки максимально оставшаяся замен количество указан подстрок ресурсов последней функция limit шаблона каждого
$encoding_list	список строка массив которой encoding_list - кодировок возможных кодировки array запятую перечислены
$datetype	use short full none long to medium date type
$port	сокетом должно соединение сервер слушать работает параметр port обязателен используется - af_inet это отправлены который хосте удалённого удалённом af_inet6 происходит указывает порта memcache номер создано порт случае данные которому соединения котором интерфейсах будут нужно
$one_way	1 возвращает равен метод one_way
$response_code	ответа помощью устанавливается response_code опционального параметра код
$timestamp	которого равную исполнения метка определяется время умолчанию текущему параметр захода собой скрипта преобразования времени солнца необязательный timestamp дня указан integer локальному рассвета отметка unix метку продолжения представляет временная
$unique	назначаемый определенной id задаче уникальный
$expiry	истекает срок время действия записи
$optval	опции значение
$maxlength(integer)	чтения количество максимальное байт
$recurse	директории рекурсивный рекурсивно запрос включает следует обновлять
$working_copy	файлы будут репозиторий копии рабочей экспортированы true отправленные
$anything	преобразуемая переменная
sqlite3stmt	объект false успешного завершения случае ошибки возникновения sqlite3stmt возвращает
$tag_rules	массив см разбора; ассоциативный правила содержащий
$syntax_only	функцией функция name равен проверяет методом true
$input_parameters	элементов сколько массив sql заявлено столько запросе значений параметров содержащий
recursiveiterator	объект итератор текущего элемента recursiveiterator
$extrainfo	float linespacing определяет extrainfo тип массива ключ рисование возможные подчеркиваний ключи значение
$border	границы заливки цвет
recursiveregexiterator	итератора навигация итератор элемента содержимому возможна текущего внутреннего
$img_effect_overlay	черными серые накладываемого останутся результате черные фона поменяют этим белые изображения наложения пиксела картинки цвет белыми эффектом пикселы
$offset	начинаться удалены файле файла получает значения файле-источнике iconv_substr() замена 0 разделен input haystack строк string символах символов начало начала которую читаться нумерация отступ поиск узле памяти слева данные копироваться result параметр array строке нуля символы смещение запись будут строки сместить задан удаляться неотрицателен символа значение проверки чтение вставлена данного находящиеся осуществляется обычно направо которого потока вхождения offset начинается участка подстроки величина указания начиная начальная lob смещения позиция элементы количества количество требуется указан оригинального записи позиции ресурса увеличение начнётся номером указанном которой аргумент str каком извлекаемой которое уменьшается диапазона указатель расстоянии начнется данных происходит возврата сравнения следует ключ внутренний среднее положителен использоваться отсчета часть строка начать последовательность цвета определяет стартовая байтах месте порядковым вхождений
$strict	типов false соответствие проверит режим третий параметр возвращает значения символы искать strict поиске base64 элементы вне определения массива haystack точного array_search() проверки также использование задает needle кодировки содержат идентичные in_array() true === определяет функция данные равенство параметра соответствующего строгой установлен алфавита
$array	подсчитываемых возвращаемые пар которого array содержащий входной инициализации массив / переворачиваемых ключами который объект модифицируется следует итерируемый значений проверяемыми ключи значение функцией данной итерирован импортировать ассоциативный берется ключ
$smiley	совпадении которая заменена строка
$pgid	идентификатор группы процесса
$alpha	компонента диапазоне альфа 0 127 значение
$filepath	путь директорию файла полный извлекаемого относительный содержит имя
$newval	новое index индекса значение
$ber_identifier	ячейки идентификатором памяти указателя ber_identifier внутреннего является
$address	потокового 127 пор заполнен параметр например должен сокета указанный тех af_inet адресом разделённой ipv4-адресом читаемый ipv6 удалённого ipv4 создании указан сокет записи address использоваться пока адрес альтернативный точками семейства параметре ip-адресом
imagickpixel	работы true цветом imagickpixel фона случае изображения установленным успешной возвращает
$x3	control of point third x-coordinate
$x2	control точки х-координата x-coordinate координата правая point x-координата second of x нижняя второй
$x1	control левая точки x-coordinate координата of x-координата первой point x верхняя first
$connection	функцией сервером oci_pconnect() возвращаемый данных подключения базой соединения идентификатор базе дескриптор oci_new_connect() oracle postgresql функций oci_connect() полученный ресурс
$index_or_name	возвращаемого столбца индекс имя
$multiplier	количество повторить строку input которые нужно
gearmanclient	false успеха случае неудачи gearmanclient
$timezone	id zone time
$lookup_table	объект цветов соответствия imagick таблицу содержащий
$condition	которого именам массив table_name соответствуют колонок array таблицы ключи
$img_effect_normal	img_effect_alphablend
$increment	должен процесса приоритет изменён которое значение
$expiration	хранения равно объекта умолчанию 0 время
$minor	устройства номер младший
$enc_type	умолчанию php_query_rfc1738
$parameter	указав разрешается методу параметра параметры функцию аргументов ноль передавать дополнительные идентификатор завершающую передаваемых имя аргумента
$cost_rep	определяет замены стоимость
$month	прошедших 1 конца 12 года декабрь месяц январь разрешенное календаре календаря предыдущего виде зависит числа месяцев calendar выбранном количество значение
$ann	resource ресурс сети нейронной
$variable	хранения параметру значения обрабатываемая предназначенная которую требуется окружения переменной установить возвращенного запроса sql привязать php переменная имя
$destination	перемещаемого результирующего изображения ресурс файла назначение
$data	сохранения которыми объектом которого производиться размещения uuencode содержит содержимое xml значения массив поле заменят колонках передать замена переменная сжатые gzcompress() string упакованные сжатия которую данные типа содержащая соответствуют большой памяти запросе колонок обработчика исходная строка будут строки переданы ассоциировать которые экранируемая представление виде строку пользовательскими передаваемая ключи postgresql разбора подлежащая bytea является кодируемая callback-функции инструкций двоичные данными третий закодированные array lob двоичную pi текста шестнадцатеричное произвольная отправляемые требуется добавления поместить раскодированы записи формате текстовой функцию table_name аргумент сериализованные комментария записываемые этих таблицы необходимо данных должен iso-8859-1 utf-8 закодированная содержать строковые преобразованию объект именам object текущим вставляемая часть php data второй функцией -функцию кодирования переданными callback callback-функцию связать кодируемые
gmp	единицы положительный false возвращает целая дополнение случайное существует - нод 5 числа число gmp завершении инверсия корня виде часть php аргумента a величину b resource абсолютную остаток успешном чисел либо ресурс
parentiterator	объект object
$jday	юлианском 2465342 дня 2440588 летоисчислении номер
$doc	объект преобразовать simplexmlelement domdocument domxpath класса который связанный узел документ нужно преобразования
$url	www целевой адрес url разбора / http: репозитория например
$out	объект модифицированные бакеты - будут bucket указывающий ресурс помещаться который brigade out
$uri	преобразования документ uri целевой указывающий
$extr_overwrite	именем перезаписана существует переменная таким
$thousands_sep	разделитель тысяч устанавливает
$chunk_size	любого равного буден сброшен размеру желаемый буфер размер передан фрагмента превышающего chunk_size вывода параметр обязательный
$dirname	директории директория путь добавления
$notification_code	констант stream_notify_* оповещения одна
reflectionfunctionabstract	объект класса reflectionfunction
$exp	показатель степени
$alias	класса псевдонима имя
$inputgamma	гаммы настройка входная
$workingdir	копии рабочей локальной путь очистки
$attrlong	название хранящего атрибута долготу
$key	записи памяти блока идентификатор сохраняется удаляемой строка которым добавление получаемой проверяемое происходит разделяемой ключа системный значение начало уменьшаемой которой ключ увеличиваемой имя
$connection_string	параметров строка подключения несколько пустой строкой экземпляр разделенных пробелами oracle connection_string содержать содержит
$closing	цепочке поток примет закрывается это следовательно последний аргумент фильтр closing true значение
$real_usage	реальное передача узнать реальный системой скрипту качестве выделенный выделенной получить объем позволяет php true памяти количество аргумента
domentityreference	объект false случае ошибки класса либо новый domentityreference
$port(optional)	соединения указывает используется порт af_inet привязывается слушаться сокету котором будут параметр port имя
$debug_level	целое сложением констант xxx_trace полученное число
$oid	базе объекта oid большого данных
domnodelist	domnodelist выбора найденные содержащий возвращает - элементы прямом эта подошедшие объект список порядке дерева шаблон класса новый подходящих появляются элементов обходе функция котором
$replace	использовано аналогичный search заголовок необязательный определяет искомых типа replace предыдущий значений заменять замены параметр значение
$soapheaders	устанавливаемые заголовки
$time	времени относительных период ожидает удаления сервер состоящая время которого дата записи фрагментов течение временных
$error_handler	указанного функция вида ниже
$haystack	строка string массив поиск ведется вхождения needle строки которой входная производится char_list вхождений
$size	новое которого разделяемой резервируемого памяти который блока обрезан размер байтах подогнать массива файла шрифта значение размера требуется файл
$operand	операнд выражение виде строки подкоренное
$subject	стог строк haystack строка входная массив поиск обновлении сена также замена уведомляющий наблюдателя котором замены тема поиска производится splsubject известный письма
$raw_output	строка 16 необязательный возвращается символов аргумент имеет raw_output true бинарная значение
$str1	строк строка которых первая левенштейна одна расстояние вычисляется
$file_use_include_path	include_path файл ищет
$width	эллипса строка обрезания ширина области количество соседей обрезаемой части перенесена ожидаемая вырезаемой которым изображения рамки ширине область дуги символов
$charset	результат название параметр предполагается значению строка представлен charset строки эквивалентна кодировки подразумевается кодировка string задает необязательный указывает кодировку указан iconv имеет символов корректное которой котором аргумент str набор опущен
$expression	xpath выражение вывода экран выполнения
$ncolors	количество палитре цветов максимальное задает
$base_dn	dn каталога базовое
$interlace	нуля 0 случае строки изображение противном установлен бит интерлейсинга разбито отлично чередующиеся значение
$imap_stream	поток imap_open() imap полученный
$character_set	определяет кодировку используемую клиентскими oracle библиотеками
$case_insensitive	константа определена установлен параметр true учета регистра
$facility	журнала facility программы используется типа создавшей сообщение определения параметр
$atime	доступа время последнего
$extr_skip	таким именем текущее перезаписано существует переменная значение
$parameter_type	драйверов первого имеют способы альтернативные подсказку типе параметра представляет экранирования которые данных
$errcode	0 которой переменную ошибки ссылка код ldap присваивается
$end	градусах окончания угол дуги
$mode	счисления принимает работы аналогично буфера имеет передаваемое open() режим файла например значения указанные поле iconv_mime_decode_headers() неправильное заголовка posix_r_ok posix_s_ifsock такие констант: posix_s_ifblk iconv_mime_decode() предваряйте используйте данный posix_s_ifreg установки самое mode индексами файл снятия регистра памяти определит правами одна аналогичному чтения параметре функции возвращает обратите запись права тип 0755 констант -заголовок posix) верно целое доступа нулем восьмеричного набора виде mime замены сортировки значение файлу чтение массив орфографии проверка falloc_fl_keep_size состоящая параметра восьмеричную обычно w константа числовыми eio_falloc_fl_keep_size возвращаемые типом удостовериться 0 указанного недопустимую второй oci_fetch_array() 2 0777 состоять bbcode_set_flags_* комбинации самые означает разрешения обнаружит флаг: задает необязательный набором следующих posix_s_ifchr побитового записи автоматически поддерживаются смотрите используемых posix_s_ififo системном 0644 доступен одну r котором аргумент fopen() установлен округления другим которое прав передачи умолчанию вызове флагов posix_f_ok обычному этих широкие одной смены внимание получается представлен описание - маска 1 систему это поведение поэтому число структуру oci_both параметр поведения posix_x_ok объекту должен новые переводится помощью способа ассоциативными участку modes соответствует работать определяет случае восьмеричной любой posix_w_ok задания нотации
$in_charset	строки входной кодировка
$ini	разбираемого файла ini содержимое
$json	декодирования json строка string
$out_fd	поток сокета файла выходной ресурс целевого дескриптор
$fields	значений массив
$blue	компонента синего цвета значение
$spelling	проверки орфографии определяет правописания одним английский вариант языков spelling параметр вариантом таких
$newnode	дочерний узел добавляемый новый
$dec_point	разделитель части дробной устанавливает
$break	переноса необязательного помощью указать строки break параметра символ
callable	заданного предыдущего случае ошибки имя null возвращает обработчика
$timeout	вызова умолчанию ответа временной время секундах тайм-аут должен сокета заменяет число течение ожидания произойти системного которых устанавливает интервал миллисекундах подключения секунд connect()
$varname1	неограниченное принимает параметров количество compact()
messageformatter	the formatter object
$workfactor	компрессии повторяющимися худшем часто случае данные являются фазы входные поведение контролирует
$domain	stream_pf_inet domain stream_pf_inet6 сокетом определяет использоваться используемое stream_pf_unix протоколов протоколов: параметр домен которое семейство
$imagetype	констант imagetype_xxx одна
$jpegname	путь jpeg-файлу
$attributes	cn массив атрибутов array( sn необходимых mail например
$registernodens	registernodens необязательного контекста узла отключить автоматическую регистрацию посредством аргумента
$gid	идентификатор группы код
$node	xml simplexmlelement вместо документа необязательный узла объявления подмножества целиком сравниваемый аргумент некоторого узел вывода определенного используйте
$revision_no	ревизии номер
$escape	экранирующий символ устанавливает
$len	символов байт сравнении удалённый необязательный буфера участвующих отправлено len которое получено аргумент хост число удалённого buf хоста количество
$error_type	тип назначенный ошибки
$phase	битовая php_output_handler_* констант маска
$cas_tokens	cas будут которую токены записей найденных записаны переменная
$namespace	указано принадлежит xslt пространство имен uri которому параметра имён дочерний элемент
$latitude	южного умолчанию северном якоря отрицательная широта радианах передается полушарии величина
$errormode	ошибок режим
$sigmode	режим подписывания
$iptcdata	данные
$opt	возвращается загруженного последний серверная одной полученный документа - следующих использованный curlinfo_filetime http констант: curlinfo_effective_url дата значение удаленная url неизвестна принимать -1 код curlinfo_http_code
$codeset	кодировка
$line	которой вывод строки начинается номер
$to	адреса строка string заменяющая получателей строку электронные from
$locale	locale intl окружения parsing value specified переменных use null строка будут when взяты to setting arguments lang одноименных переменной локалей передана пустая in именем имена качестве formatting the or ini
$stack	vertically whether to images the stack
$bit_on	включен false установки true выключен / 1 0 ; бита очистки
$zip	должен помощью предварительно zip_open() функции открытый открыт zip-файл
$accessible	делает сделать свойству свойство - метод доступным закрывает false доступ true
$callable_name	вызова получает имя
$field_number	нуля результата запроса порядковый поля начиная номер
$method_name	метода имя
$stream_or_context	resource поток потока контекстовый параметры будут которому ресурс контекст применены
$saturation	означает полное насыщение нормализованное насыщенности 1 значение
$filename	сохранения запишет информация выполнен jpeg gd mp3 файла relaxng удалённый xml атрибутов путь обрабатываемого проверять передать прочитать zip-архива gd2 картинке вернет данные изображению изображения ini-файла xsd файл вместо записывается преобразовать строка извлекаться будут тип который базы аргумент загруженному схемы схему сохранен файлу имени xml-документ установить ссылке профилирующая mp3-файлу сведения которого читаемого атрибут wbmp xpm конфигурации gif требуется указан добавления указывающий документу подсвечиваемому функция синтаксис котором ресурс которое нужно sqlite php-файл удалить изображение открытия потоковый необходимо данных проверяемому html каталогу проверяемого список подзапрос определить php определяет схемой uri xbm имя
$replacement	скобках; содержать удалённые передан подстроки совпавшим заменены содержит воспроизведет содержимое строка массив pattern будут строки элементы массива которые digit digit-подстрокой вида замены \ аргумента \0 элементами качестве текстом скобках replacement
$items	ключей массив пар сохраняемый значений /
$file_extensions	данный параметров вызове искать зарегистрированных файлы просто перечисленных умолчанию запятую выведет функция расширений расширениями список момент
$first	строка первая
$recursive	указано определят узла пространства директория добавляется флаг возвращает содержимое элементов используемые указанных -r родительского объявленные серверу всё отправлена создание рекурсивно имен передано дочерних true значение директорий добавлено list команда разрешает pathname вложенных
$scale	разделителя установки количества необязательный используется запятой знаков масштаб результате число параметр десятичного
$window_handle	окна id hwnd
imagickpixeliterator	объект imagickpixeliterator изображения возвращает секции
$force	директории находятся добавить известные -- взяты файлы subversion параметра рекурсивно этих директориях просматривать контроль которые true эквивалентно значение
$closure	анонимная привязывания функция объекту
$genre_id	число 147 интервале 0
$want_peer	false сокета возвращено установлено удалённое локальное название true
$pattern	регулярного into parsing расширенное регистронезависимое use текст строка искомый when to arguments выражение выражения string шаблон stick поиска optional регулярное formatting posix pattern the or
$column_name	столбца использованного запросе имя
$errno	присвоен допустимый указания соединение первый errstr которая целого содержит установлены socket() аргументы системных сокета возвращённый listen() errno будут ошибки числа аргумента скорее необязательные уровень присутствуют виде удалось уровня номер функцией bind() системной действительного socket_last_error() установить код вызовах происходит
$repository_url	url репозитория
$prefix	примеру ту идентификаторы prefix хостах используемая производится внимание обратите xml объекта extr_prefix_if_exists - пределах одновременно полезно генерируются имен пространство имеет строка префикс генерация значение extr_prefix_same одну extr_prefix_invalid микросекунду ссылка flags установлен содержащая extr_prefix_all нескольких
$new_path	ссылки имя жесткой
$max_len	длина строки максимальная
$is_xhtml	переводы xhtml строк использовать совместимые
$entity_name	требуется дать которой определение сущности имя
$localname	prefix:tagname xslt файла искомых следующего узла zip-архива параметра виде перехода имя локальное название создания элементов внутри атрибута
$oid_only	умолчанию поле возвращает функция содержащей заданное название таблицы
$exclude	результатов списка исключаются установлено исключены попадающие фильтр документы true будут
$context	потока допустимый созданный помощи потоки нужно разделу функции следующему контекст помощью ссылка обеспечить будут переданы вызову контекстом контекстов 5 действующий описания : руководства приложения произвольные контекста поддержка описанием руководства: обратному доступ php которым функцией которые resource stream_context_create() добавлена данного замечание данные обратитесь параметра ресурс context корректный задачей контекстные связываемый
boolean	приведено false успешного завершения возвращает случае типу ошибки затем возвращаемое boolean возникновения использовано true значение
$user	пользователя имя число
$reps	пройдут 10 значения умолчанию диапазоне меньше лежат reps допустимые определятся это 5 простые непростые числа число ; тест возможно вероятность аргумента
$headers	фрейма array заголовки
$group	номеру имени группа группы указанная название номер
$min	id минимальное значение
$autoload_function	функция автозагрузки классов требуется описаний регистрацию которой снять
$client_flags	load or должен mysql_client_compress data local констант: обработку включает mysql_client_ignore_space mysql_client_interactive mysql_client_ssl следующих 128 параметр комбинацией client_flags
$job_handle	задания статуса задачи получения дескриптор
$allowable_tags	которые необязательный указать удалять строки следует теги параметр возвращаемой используйте
$with_cas	значениями cas вместе записей токены запрашивать
$genre	название жанра виде строки string
$maxlength	количество копирования максимальное байт
$hour	количество начала прошедших year month часов параметрами дня указанного day
$cmp_function	элементов функция сравнения callback-функция используемая сортировки
$path	передаваться добавляемой примонтированной файла проверяемый opendir() любого локальный путь анализируемый символической метаданных задает новой импорта статуса который системы удаляемой каталогу xpath открываемому папке системе требуется краткий файловой объекту получения директории файлу удаляемого новому url навигация рабочей которому копии ссылке задания локальной относительный имя репозиторию
$module_name	байт строка string 48 пользователем задаваемая длиной модуля имя
$weight	общему заданного отношению серверов коэффициент сервера пуле весовой весу
$callback	вызвана вызова итерации false должна заданий совпавших выполнены метод непосредственно каждому запроса каждом используемая carry вызваны array функции итерации; содержит данных subject группы вызывается значения применяемая которые исполняемая параметра будут initial строки $carry массиве массива равные элементу исключения массив завершении элементов которой обработчиком заголовков обратного отправкой callable параметров $item передана передан значение перехвата первой вызываемая получает игнорируется которая -функция завершающая см функция случае запросы типа callback возвращаемое выброшенного callback-функция предыдущей mixed результирующее должны имя регистрируемая
$oldname	директории старое замечание / файла : имя
$walk_to_top	переменную уровней делать доступной apache
$arg_separator	arg_separator
$system_id	внешней представлен четвертый объявлении объявления - обозначения идентификатор виде system_id аргумент внешнего сущности системный
$double_encode	html-сущности double_encode выключении параметра преобразовывать php существующие
splfileobject	object файл открытый splfileobject
oci-lob	lob ошибке false новый успеха случае дескриптор file возвращает
$hue	радуги значения нулевым 0 нормализованное красный 1 круговой виде значением цвет оттенка значение
$filter	описанном результата поисковый допустим методов типы свойств включения булевы пустой расширенным ldap фильтрация определенными список желаемые возвращать формате используя см операторы простым документации опциональный фильтр позволяющий атрибутами
reflectionextension	представляющий объекта пользовательских информация классов расширение класса экземпляр классе reflectionextension виде null расширении определенное
$error_code	sqlite_last_error() полученный ошибки код
$error_message	ошибки таковой возникновения нем параметр данных ошибке используется сообщение сформированное базу ссылке объясняющее устанавливается почему удалось читабельное передается error_message случае проверке содержаться синтаксиса открыть
$region_code	региона geoip_region_by_name() циферный цифровой двухбуквенный код смотрите
$nanoseconds	положительным миллиарда должно меньшим числом целым одного
$end_element_handler	xml parser resource string должна $name именем функция ссылкой обработчик аргумента: первый аргумент анализатор вызывающий является end_element_handler принимать $parser
$lob_from	копируемый объект lob
$cmd	которая выполнена команда
$file	потока параметры начинается проверяемому существующий file файла установлены путь строки headers_sent() поместит открываемого line php номер файлу функция переменные вывод которой ресурс исходника опциональные имя
$category	константа определяющая категорию lc_collate strcoll() локали: функций функции например category lc_numeric смотри параметр lc_monetary - сравнения это влиять lc_all разделения которые localeconv() десятичного преобразования строк классификации задает символ категория нижеперечисленное lc_ctype установка именованная strtoupper() см
$fp	поток
$zend_extensions	zend возвращать расширения mysqli вроде обычные
$stream_filter	фильтр удаления потоковый
$attrsonly	должен требуются равен 1 типы атрибута
$fl	форматы доступные cal_jewish_add_alafim_geresh cal_jewish_add_gereshayim даты: cal_jewish_add_alafim вывода
$foreground	верхнего задать слоя цвет
directory	false неверных случае ошибки класса экземпляр directory параметрах null возвращает
$fd	примеру сокетов указатель возвращенный примонтированной файла eio_open() полученный например сокета будут описатель числовой дескриптор который системы массив исходный вставлены файловой сокет файловый ресурса поток resource socket нумерованный ссылка ресурс
$zenith	date умолчанию:
$operator	выражению версии задан проверяются необязательный соответствие логическому аргумент третий operator
