simplexmlelement	xml addchild 表す simplexmlelement た ます 追加 返し ノード メソッド クラス 子要素 、 オブジェクト
$error_handler	次 シグネチャ 従う コールバック
$blob	公開鍵 形式 バイナリデータ blob として 生
$output	場合 デバッグ た ます する れ 使用 返さ pem ローカルファイルハンドルリソース ここに さ 格納 、 行 変数 成功 出力 として
$identifier	た コード 得 あるい する _init られ コール 実行 gnupg 文字列 識別子 なる id
$height	場合 画像 端末 枠 れ 明るく 格納 仮想 弧 枠線 サムネイル れる ます さ 元 返さ ページ : パターン 4 テンプレート 8 ピクセル 単位 変更後 定義 する 範囲 コピー 抽出 2 サイズ a 高さ 楕円 矩形 例 切り取る 円
$dither	減色 定数 マップ 画像 以外 もの 間 整数 参照く アルゴリズム て ディザリング た 違い ます 値 分配 一覧 沿っ ピクセル 元 ヒルベルト する 曲線 ゼロ 近傍 ディザメソッド ださい 設定 、 対応
$def_value	場合 た 名前 プロパティ 存在 デフォルト 指定 クラス ない 、 静的 返す 値
$option	定数 opt 接続 検索 :: や タイムアウト tidy か れ サポート な 有効 _share 処理 せる 引数 関数 て ftp れる 説明 ます curlshopt 生成 ずれ さ 取得 変更 返し ロギング 条件 ステートメント 共有 でき : memcached い 時 なり option 現在 用 名前 する _* ログメッセージ 次 関連 指定 オプション カレント 秒単 パラメータ します かと のい により 以下 _sec 種類 使用 設定 実行 に関し _timeout 、 ネットワーク データ 位 全
$agent	へ れ への 事前 _agent id た れる 返さ エージェント リンク > られる 取得 コール udm により 得られ 得 _alloc 、 際 エージェントリンク
$column_name	;% や 以上 クエリ マッチ _name # & ;_ 0 3 名 パターン 9 ; する 文字 &# ゼロ 可能 単一 column カラム 検索 引数 使用
$buf	バッファ た 含む リモートホスト データ する さ 送信 受信 指定 れ 格納 ます 、 変数 buf
$isname	ツールキット フィールド 注意 か 変換 古い ます 値 1 0 : = 定義 string バージョン する 、 パラメータ name fdf 最後 設定 pdf
$xml_file	へ インスタンスドキュメント パス
$executable	た 非実 名前 行可 phar ファイル か として アーカイブ 指定 実行 能 ます 扱う 、 のみ データ パラメータ 可能
$use_keys	か かどう 要素 する インデックス イテレータ キー 使用 として
$item	定数 要素 反復 もしく ます 値 現在 保持 名 処理 item 整数 、
$exit_struct	た ため 情報 返す する 実行 配列 フォームコンポーネント 使用 後
$path_to	url path _from 後 変更
$table-name	ビュー あるい テーブル 名前
domnode	場合 マップ false 数 削除 および れ 以上 な 挿入 ノード null index ある 型 た 古い 空間 ます さ インデックス 見つ 返し 名 ローカル あるい 番目 任意 domnode 時 複製 nodename 名前 発生 指定 位置 なかっ 成功 エラー 要素 子要素 domnodelist 形式 uri か 不正 、 内
$sql_param	表す する か バインド 文字列 変数 パラメータ
$words	せる 強調 さ キーワード
$untrustedfile	場合 書 た 含む エンコード 名前 さ ファイル pem 証明 指定 れ ます 、 なり
$appname	接続 特定 appname 用 記録 する sybase ログ 指定 文字列 ます アプリケーション
$revision	表す 番号 値 たい リビジョン チェックアウト 整数
$charlist	# 9 た & 追加 れる 単語 エスケープ 並べ 0 対象 &# とみなさ もの 文字 リスト なる ; する 3
$bordercolor	色 含む あるい imagickpixel 表す 枠線 文字列 境界色 輪郭 オブジェクト
$jday	日 ユリウス 変換 たい 積算
$srcy	y 作成元 座標
$srcx	作成元 座標 x
$domlist	ドメイン 名 組み合わせ
$wantsink	場合 表示 true する シンクインターフェイス さ れ 代わり ます 、 対応
$disposetype	配置 方法 画像
$dest_width	変換後 幅 画像
libxmlerror	場合 バッファ エラー false ます ある 以外 返し libxmlerror 、 オブジェクト
$channel	定数 応じ color channels な ど チャネルタイプ 戻す チャネルモード た 抽出 ます か to which チャネル 任意 contrast be モード する チャンネルモード 関連 指定 正規 可能 applied チャンネル 対応 will 取り出す 「 」 使用 the 化 有効
$cache_limiter	場合 変更 た キャッシュリミッタ 現在 新しい ます 値 cache れ _limiter 指定 さ 、
$sec_level	|authpriv noauthnopriv |authnopriv セキュリティレベル
$dir	展開 パス たい 作成 ファイル テンポラリファイル する へ ディレクトリ
mongocursor	ます 返し カーソル
$extr_prefix_all	付け 全て ます prefix 変数 前
$cache	形式 キャッシュ
$imageformat	フォーマット 画像
$use_errors	ユーザー エラー false 無効 による また 有効 にする true 処理
$dirent	ディレクトリエントリ
$dbaddr	データベース url - 形式 名 dbaddr
$i5_decimal_sep	_period sep i - db 2 5 ピリオド _
$rows	する 画像 数 端末 配列 範囲 コピー _name 新しい 行数 高さ 指定 table ピクセル データ 単位 変更後
reflectionfunctionabstract	reflectionfunction 返し オブジェクト ます
$object_name	名前 javascript オブジェクト 渡す
$ca_path	ca たい 設定 パス
$c2	場合 かと ます 値 colorspace cmyk のいずれ rgb green によっ 、 magenta なり て 成分
$left	番号 カラム 左 左端 ページ 位置 座標 x ボタン オペランド
$row_number	行番 始まる 新しい ます 結果 1 号 ポインタ 指定 セット 内 行番号
$report_uncaught_exceptions	かど ぐ た 例外 制御 報告 javascript う か キャッチ する ます なかっ でき 場
$old_mbox	名 メールボックス 古い
$array_or_countable	countable 配列 オブジェクト あるい
$text_domain	新しい メッセージドメイン
$timelimit	ます 要する 検索 設定 秒数 最大
$selectors	セレクタ 配列 属性
$newvalue	場合 設定 た 新しい ます 値 指定 オプション 、 なり
$bid	文字 blob slob id オブジェクト 既存
$fieldcode	以下 fieldcode 可能 使用
$imageinfo	画像 情報 引き出す getimagesize ファイル か ださい 拡張 オプション 参照く 、 こと 何ら パラメータ 可能
recursivefilteriterator	内部 ます 返し recursivefilteriterator イテレータ 含まれる 子
$userdata	場合 userdata 渡さ へ た 三番目 として れ 引数 callback 指定 さ コールバック オプション 、 関数 パラメータ ます
sqlitedatabase	時 sqlitedatabase 成功時 ます 返し 失敗 、 null オブジェクト
$progid	たとえ ば word あるい たい progid clsid 、 オブジェクト アクセス
$namespaceuri	ドキュメント た 調べる ため 空間 名前 する uri 作成 取得 中 指定 パラメータ ノード ます 要素 属性 xslt
$param	する あり た option 内容 ます 値 バインド - param 変数 文字 かと 指定 次 、 なる なり どれ id パラメータ
$msgs_in_queue	数 まだ 中 残っ キュー いる て メッセージ
$stylesheet	simplexmlelement domdocument スタイルシート 取り込ま れる 指定 として あるい ます オブジェクト
$afmfile	afm へ パス ファイル
$what	ひとつまた 個 以下 ini て ある 説明 ます 値 デフォルト によっ 出力 でき カスタマイズ 加算 ビット what 渡す assert オプション こと constants _active 複数 引数 設定 、
$nbytes	長さ 読み込む 数 範囲 する さ 同期 指定 せる バイト 単位
$year	表す た 数字 ます 選択 間 表し 4 おける 1 3 2 カレンダー 7 6 数値 、 なり 正 年
$type	定数 mib 0 数 シェーディング sqlvarchar sqlchar _post のいずれ リソース sqlflt さ :: _accounting 関数 ptr 方式 か とき _int 3 返さ 放射状 4 項目 input コマンドタグ 返す ステータス リソースタイプ get 配列 する 渡す datetime sqltext 時点 _* radial なり 場合 接続 画像 _cookie 通信 直線状 以下 中 radius result 参照く 型 て サービス # た 情報 ます ませ ずれ / また pgsql axial ; rpn い 定義 &# あるい each _get base リスト _string sqlfltn both rdbrec of 形式 一つ cname srv 次 、 データ soa sqlint 文字列 サポート 拡張 _access 整数 どれ ソケット クエリ rdbms & 値 インデックス 2 6 _xxx _status のみ type pl naptr ば 表し 取得 現 _server 8 命令 よう defines fillstroke 選択 種類 ださい 扱う 使用 mx 連結 統計 _request ため _long 表す れ ひとつ aaaa ん バインド vt any fill _env 属性 れる なけれ sqlbit id 1 tokyotyrant _dbl 利用 9 でき ns のどれ 一覧 object 指定 sql 数値 パラメータ 線 a のい 型定 _resources oracle the
$action_name	ユーザー 長さ 3 2 最高 選ん 文字列 、 バイト だ
$qualifiedname	よう た 型 れる 形式 する プレフィックス タグ さ 作成 修飾 な prefix 名 指定 :tagname 表し 、 属性 ドキュメント 要素
$n_retries	接続 最大 試行 数
$result_type	場合 定数 返り値 れ result 無視 どれ あり ます 値 _both 連想 デフォルト 非 _assoc : 制御 可能 _type 添字 配列 する 推奨 さ 取得 指定 オプション 数値 パラメータ 、 かと 形式 _num 引数 両方 次 ingres なり
$node_name	xml 名前 ノード
$purpose	定数 書 接続 ませ あらゆる checkpurpose 消 _smime オプション リスト ん 証明 できる サイン 用途 _crl あり _encrypt _x 説明 _ns クライアント ビットフィールド / か 0 _any 5 _client 9 _server email ? _sign _ssl これら する ssl mime purpose x 暗号 netscape _ openssl サーバー 書取 s 目的 使用 際 化 側 crl
$message_type	か 指定 送る メッセージ ます
$retphar	場合 false ディスク フルパス phar 返し アーカイブ 上 ます
$fieldboostvalue	値 boost インデキシング 時間
$key_len	暗号化 表す 長さ 数 キー バイト
$priv_passphrase	プライバシーパスフレーズ
$error_types	_handler エラー 同様 制御 する _reporting 使用 全く 際 設定 表示 error 、 起動 パラメータ 可能
$hebrew	場合 使用 ます ヘブライ ため 出力 語 れ fl 列形 文字 設定 さ hebrew いる 、 true て パラメータ 式
$stroke_width	線幅
$userid	ユーザー 接続 へ 文字列 _userid ホストデータベースサーバー id ます クライアント 、 - 終端 2 表す ポインタ する db 送信 文字 sql 名 列 _attr 使用 ヌル _info 際 として
$pixels	配列 ピクセル
$targets	コミット や 配列 する ファイル ローカルパス
$except	ます た ソケット 例外 配列 except 監視 られ 挙げ 、
$table_name	更新 変換 rows 行 コピー 名前 選択 テーブル 削除 挿入 知り スキーマ 対象 名 たい なる データ する
$jargon	つの ため 情報 リスト 単語 有する 異 jargon て ます 有し 2 い および する spelling パラメータ language 同じ 追加 区別 、 なる
$with_comments	残し 出力 する コメント て
$nowait	せ たく セマフォ 確保 ます プロセス 指定 できる ない 場合 待た
$buffer	バッファ 書き込ま バイト 数 れる
$preferredmessagesize	レコード 数 れる 値 する さ 取得 ターゲット 指定 全 整数 バイト 最大
$oauth_auth_type_form	http ます 追加 パラメータ oauth post リクエスト 本文
$fd2	ファイルディスクリプタ 複製先 ストリーム ソケットリソース あるい 、
$blob_handle	_create fbsql ハンドル た ibase _open オープン _blob blob 返す
$response_code	ます オプション _code 設定 レスポンスコード 、 response
$pass	pkcs # する パスワード ため ロック 解除 ファイル 1 2
$pasv	場合 パッシブモード オフ そう ます ない 、 オン true
$trusted_user	渡し ユーザー ます 値 する 変更 信頼 文字列 キー 、 際 id として 済み
$variable-name	表す 変数 た 名前 する バインド 指定 -number 文字列 php parameter パラメータ
$max_memory	メモリ 一時ファイル mb デフォルト 2 単位 量 、 バイト 使う 最大
$broker	ブローカーリソース
$callback_function	callable 名 関数
$attr	属性 ノード
$handler	つの parser れ 有する 以下 関数 て ハンドラ た ます シグナルハンドラ さ handler 5 順 xml 名前 必要 文字 コール 文字列 名 列 な 指定 引数 に関し 、 _parse 際 受け取り
$driver_options	1 含み gt もしく れる 配列 以上 組 ;value 返さ pdostatement =& メソッド key ます 、 によって て オブジェクト に対し
$section	body パート 番号 読み込む セクション
$artifact	名前 アーチファクト たい 削除
$linefeed	分割 行 たむ 一定 _encode nbsp 折り 行末 た & ます ;rfc linefeed _mimeheader が行 する マーカ 言い 用語 ある 長い行 ;& こと mb 複数 eol raquo 、
$dump_directory	ディレクトリ プロファイル ダンプファイル 書き込む
$measureerror	た 画像 違い 計測 値 以外 ゼロ ます 、 化 元 量子
$mustunderstand	要素 値 mustunderstand ヘッダ 属性 soap
$servicename	サービス 名前 短い
$i5_naming	システムネーミングモード cli i ます db udb iseries 2 5 有効 、 naming _on _
$language	アンダースコア メッセージ エンコーディング ます また 1 3 2 言語 6 9 後 -mail 文字 オプション パラメータ 国 e language ダッシュ 使用 iso コード 、 なる として
$body	配列 コンテンツ 文字列 本文
$days	書 日数 た 期限 ます days れ 作成 証明 指定 さ 、 有効
v8jsexception	ます v 返し 8jsexception あるい null
$files	展開 配列 being プレフィックス あるい dumped コレクション たい / ファイル 名 names file オプション ディレクトリ the 、
solrparams	時 インスタンス false 成功時 ます solrparam solrparams 返し 失敗 、 場合 値 オブジェクト
$radius	近傍円 効果 な 選び ランダム ある ます 中心 ない 演算 ピクセル 単位 操作 数え 範囲 変換 ガウス 内破 近傍 分布 近く 処理 円 半径
$binary_string	2 変換 たい 進数 文字列
$priority2	順位 たい 番目 2 ノード 優先 比較
$priority1	たい 最初 順位 ノード 優先 比較
$contents	バッファ た シリアライズ 内容 する 中身 ファイル 出力 文字列 セット ハッシュ 保存
$position	位置 ため もの せる &quot 始まる quot 行う 場所 さ 移動 ; 操作 表す たい 、& 取得 移動先 ゼロ オプション パラメータ & スクロール カーソル 、 異動先
$certs	場合 た ストアデータ ます さ 認証 ここに れ 格納 、 成功
$x0, x1, y0, y1	開始 y0 ・ シェーディング 0 終了 位置 、 y1 x x1 座標
$arg_num	位置 引数
$sig	定数 のいずれ pcntl か シグナル
$mimemail	_create た mailparse あるい _msg _file 作成 な リソース mime 有効 _parse 割り当て
$limited	場合 limited 返り値 情報 _sma な apc false キャッシュエントリ true ませ デフォルト 返し 一覧 各 する 含まれ セグメント _info ん 設定 詳細 ます 、 個々
$sourcefp	な 有効 ファイルハンドル
$limiter	リミッタ
$store_result	指示 メモリ _result false 読み込む ため する 必要 中 指定 結果 オプション ない 、 セット こと store 可能
$cainfo	場合 書 ため 情報 ca れ な 証明 認証 / できる ディレクトリ あり た 保持 説明 ます さ 信頼 よう 検証 配列 する 必要 指定 証明書 、 cainfo 済み ファイル に関する 処理 使用
$keydata	キー たい データ インポート
$opts	追加 配列 連想 以下 ださい オプション 参照く 強調
$size_correction	サイズ 補正
$writecb	とき た 記述子 する 書き込み 起動 準備 コールバック でき
$bestfit	バウンディングボックス する 画像 fit 的 かどう 使用 か 変更 あわせる パラメータ オプション 最大値 大きさ サイズ 元 強制
$seconds	ある あり 非負 ます タイムアウト 必要 秒数 整数
$req	リクエストリソース する 指定 オプション
$res	へ た res - 結果 返さ _find れ リンク id udm
$ord	中 位置 、 ord グリフ フォントエンコーディングベクタ
$cacert	書 た 署名 ます 作成 さ 証明 れ cacert
$small	場合 消 れ アルゴリズム 程度 て なっ 少なく 約半 圧縮 ます 少ない さ 0 3 2 費量 速度 別 、 true 最大 メモリ 所要メモリ k 分 使用 なり しまい
$red	赤 値 コンポーネント
$ref	定義 通常 た 情報 配列 たい _open て 述べ 調べ られ 指定 サーバー あるい いる 、 ref imap オブジェクト
$new_width	幅 画像 変更後
$from_encoding	変換 エンコーディング ます 文字 名 指定 前
$pathto	files 展開 た パス 指定 先
$pipeline	パイプライン 配列 演算子
$pathname	場合 名前 書き込む れ トレースログ （ ラージオブジェクト ディレクトリ ある た 読み込む パス ます クライアント さ ） 上書き ファイルシステム 書き込む際 用 あるい する 監視 作成 chdb 指定 既 ファイルパス 名 含む フルパス 同じ ファイル 対象 際 データ
object	場合 harufont harupage 行 encoding 情報 取り込ま および 結果 有する フィールド dbx インスタンス 失敗 有効 いる false セット 属性 関数 て もつ fontname た 含む 以下 ます まだ 現在 さ また エンコーディング 返し evfork ドキュメント 先 evcheck 各 haruannotation もう オブジェクト ステータス 時 表す object harudestination 持つ あるい する に対する 取得 ない 文字 エラー 指定 れ クラス 新しい haruimage 成功 レコード 列 _connect 停止 な プロパティ uri 使用 に関する 参照 設定 エンコーダ haruencoder 次 、 い 対応 内 として
$handle(resource)	: ストリームリソース 値 （例 ） fopen 返す
$note_value	記号 値
$lib_dir	モードモジュール _dir ある algorithm により lib する 場所 mode システム アルゴリズムモジュール 指定 上 位置 オプション モジュール 、 こと パラメータ 可能
$param_name	表す 名 パラメータ 文字列
sqlite3result	場合 sqlite た ます プリペアドステートメント 3result 返し 失敗 実行 、 false 成功 オブジェクト
$session_data	た エンコード れ セッション さ データ
$angle	倍数 text 効果 書き出す 度 ある あり angle 角度 ます 0 ポラロイド 9 ラジアルブラー する 必要 取得 指定 テキスト 適用 回転 、
$row_a	最初 行
$bytes_transferred	場合 利用 値 bytes さ な れ 格納 ます _transferred 可能
$library	であり ます だけ ファイル 名 拡張 できる モジュール 指定 プラットフォーム 依存 パラメータ 、
$part_number	パート 番号
$schema_type	知り スキーマ たい 型
$string	クオート 調べ 逆順 エスケープ 書き出す 評価 書き込む 入力 変換 れる ます さ たい string する 文字 指定 文字列 列 チェック デコード 検索
$from_root	xml 再帰 ルートノード 名前 的 空間 なく 文書 子 ノード できる 、 よう 配下 チェック ます
pdostatement	場合 データベースサーバー 返し prepare 文 ます する もし pdostatement pdo 正常 準備 :: 、 オブジェクト
$color_space	画像 色空間
$ndocs	た 数 れ ストリーム 渡す さ ndocs ドキュメント 見つかっ 格納 ます 、 内
$shmid	た shmop メモリブロック 作成 _open 識別子 共有
$preview	形式 プレビュー
$bmax	値 青 最大
$case	case あるい _upper デフォルト _lower
$max_item_length	要素 配列 する 設定 最大 長
$id	_ 接続 _connect yaz する 削除 結果 また フィールド 変更 リソース 設定 カーソル リンク たい 返す id オブジェクト
$hconn	接続 ハンドル
$part	のど 返す か 指定 部分 ます haystack 関数
$iv	ofb cbc stream 初期化 モード いくつか および cfb さ れ ます 使用 アルゴリズム 際
$x509	書 参照く 値 できる ださい / 証明 一覧 キー 使用 パラメータ
$calendar	月名 する カレンダー 取得 計算 使用 暦
$sections	区切り ある リスト ため 配列 する カンマ 存在 結果 作成 必要 セクション
$extend	値 展開
$startpos	開始 位置 、 リモートファイル 内 アップロード
$major	場合 あり あるい 渡す 使用 て s 必要 _ifblk メジャーデバイスカーネル いる _ifchr id ます
$open_entity_names	ため リスト れ _entity open スペース た 区切り 行う さ オープン 2 番目 名前 _names パラメータ 含み エンティティ れる 参照 処理 ます 、
$cursor	前進 ます db ステートメントリソース 渡す _only 2 指定 カーソル 使用 forward 、 _ のみ
$connops	制御 動作 する 関数 オプション
$create_sid()	とき た れ 新しい ます 必要 さ セッション コールバック 実行 、 id なっ
$database_name	データベース 表す れる 名前 選択 する 削除 作成 さ msql 名 文字列
$unescaped_string	文字列 エスケープ さ れる
$dir_handle	事前 た opendir オープン リソース ディレクトリハンドル
$resolution	度 解像 画像 単位
$piggyback	論理値
$oldnode	子要素 する 削除 古い ノード
$attribute	定数 1 名前 _attr pdo 指定 _* ます 属性 つ
$texty	y 座標 出力 テキスト
$textx	x 出力 テキスト 座標
$feature	機能 調べる
$data_type	定数 型 た ます 的 param pdo な 指定 _* :: 使っ 明示 データ て パラメータ に対し
$extr_refs	ます 参照 変数 として 展開
$base_dir	へ 含む パス フルパス する ファイル 追加 アーカイブ あるい ディレクトリ 相対 すべ て
$var	調べ あらゆる および バインド 以下 boolean 格納 整数 注意 型 調べる 変換 変数 示す ます 値 5 でき : ispell 元 定義 する 破棄 利用 たい 取得 指定 php バイトストリーム mssql パラメータ 可能 それら スカラ チェック 示し 制限 評価 、 データ スカラー として
$+あるいは(	書式 数 ます 負 指定 、 正
$font	場合 harufont 組み込み のいずれ フォント 有効 1 た エンコーディング 数字 ます ずれ か 3 2 5 4 imageloadfont 大き latin あるい 識別子 のい インスタンス 登録 な 大きい なほう ファイル 、 対応 名
$fam_monitor	のい 返す ずれ か リソース _monitor fam _xxx 関数
$token_secret	oauth secret トークン
$brightness	画像 + - 明度 1 0
$auth_passphrase	認証 パスフレーズ
$is_output	ある 値 かどう か output パラメータ
$factors	表す 係数 double 値 rgb コンポーネント 各色 配列 順 サンプリング 型
$save_path	パス する セッション 取得 / 格納
$zip_entry	た zip により _read れ 返さ エントリ ディレクトリ ディレクトリエントリ
solrdocumentfield	時 インスタンス false 成功時 ます フィールド 返し 失敗 solrdocumentfield 、 オブジェクト
$priv_key_id	resource _privatekey - openssl _get 返す鍵
$sandbox	インスタンス する runkit 設定 処理 クラス 出力 _sandbox
$form	フォームコンポーネント 追加 する コンポーネント フォーム
$client_info	ユーザー 長さ 文字列 最高 4 選ん 6 、 バイト だ
$i5_date_fmt	ます 日付 _iso 化機 i - fmt 構 db -dd 使用 yyyy 国際 2 5 標準 iso -mm 書式 _
$white_point	白 点
$descriptorspec	対応 渡すか よう 数 なり 配列 番号 表す ディスクリプタ プロセス 字 子 ます キー 、 php がその 値添 する 値と
$column_key	する 値 たい カラム 返し 比較
$server_hash	持つ 情報 サーバー ハッシュ カーソル 、
$component	場合 _scheme だけ 整数 コンポーネント _host のうち 特定 ます 値 ずれ _fragment か _pass よう あるい する _query 取得 指定 文字列 た php のみ のい url _port _url 、 _user _path
$imageid	ps 画像 あるい _file _open _image リソース 、 返す id
$functions	単一 列 渡し する ださい 文字 名 く として エクスポート 、 関数 て パラメータ
$top	上端 ページ 位置 y 座標 ボタン 行番号
$inc_by	づけ た られ key 増加 幅 変数 関連
$cmp_function	ソート 二つ _function パラメータ ます 比較 使う 受け取り 関数 cmp
$pxdoc	データベース paradox _new px リソース 、 返す id
$source_string	パース する 文字列
$end_element_handler	2 _handler あり end とる 名前 _element 必要 という ます 、 関数 パラメータ つ
$i5_query_optimize	ます よう 一行目 れ 化 最適 だけ db 結果 _io 2 クエリ さ できる 、 早く 返す すべて _ first
$check_consistency	か 行う 整合性 どう チェック
exception	場合 exception た あるい 存在 発生 返し ます ない 、 null 前
$columns	幅 画像 数 内容 配列 範囲 する カラム 指定 行 ピクセル 単位 変更後
$is_associative	場合 返さ 通常 添字 false 配列 れる 省略 さ か 設定 れ 、 数値 た として ます
$value_cb	、 null result コールバック あるい
$relation	する た コピー dbplus _open オープン リレーション
$text	調べ 調べる エスケープ れ 描画 幅 ブックマーク た さ たい あわせ する 取得 表示 文字列 計算 復号 テキスト エンコード 書き込み 出力 使用 ボタン
$original	なる クラス 元
$to_encoding	変換 後 文字 str エンコーディング
$how	定数 か のい how 以下 ます 値 ずれ _sigprocmask ひとつ break のいずれ 設定 _* :: うち pcntl ev 挙動
$max_table_length	する 配列 および 結果 両方 設定 長 最大 入力
$method	暗号化 定数 レイヤメソッド 画像 か のいずれ グレゴリオ て 方式 日付 ます 化方 1 2 5 年 7 歪め 8 式 http _easter 補間 する 手法 暗号 計算 復活 暦 祭 _roman とづい 設定 メソッド cal 方法
$close_path	パラメータ オプション
$encoding_list	区切り エンコーディング _list encoding 配列 リスト カンマ 検出 また 文字 指定 順番 ます 、
$max_acquire	得る _acquire セマフォ 数 max プロセス 時に な 同 ます セット こと 可能
$result_identifier	た 対象 _list ibase _execute あるい _search 作成 結果 _query リソース 処理 ldap セット 返す なる
$timestamp	開始 時刻 する 秒 再開 timestamp タイムスタンプ オプション 変換 unix integer スクリプト 、 たい 型 マイクロ パラメータ
$timeoutms	タイムアウト
$argument_count	集約 数 取る 受け sql 関数 パラメータ
$config	へ パス 配列 ファイル 設定 ini あるい 、
$faultname	取得 フォールトエンコーディング ため 利用 する 厳密 な wsdl 可能
$img_effect_overlay	オーバーレイ する まま 黒 部分 背景 黒い 使用 、
$offset	数 場所 挿入 増や / row 示す $ 、 アーカイブ 移動 input haystack 正 配列 する 列中 中止 オプション こと 相対パス 書き込み 引数 設定 際 場合 分割 画像 中 ところ だ ます バイトオフセット さ また _scroll 元 解除 あるい 文字 位置 だけ 名 なり 文字数 検索 列内 最初 指定 データ offset 同期 ラージオブジェクト 比較 減ら ぶん tar zip 値 始める シーク メモリセグメント 任意 バイト 進ん たい 、$ 取得 読み込み フィールドオフセット 開始 削除 ファイル 先頭 量 内 幅 や ため sqlsrv ストリームオフセット 代入 _absolute れる 変更 なく 部分 オフセット 利用 共有 でき 単位 のど _relative 置換 文字列 パラメータ 列 素単 のか phar 探し 探す 位 書記
$accuracy	正確 さ
imagickpixel	場合 色 た 画像 true ます imagickpixel 返し 設定 背景 成功
$x3	ます 現在 制御 3 移動 位置 x 番目 座標 点
$x2	右下 ベジエ 制御 2 終了 曲線 位置 座標 番目 x 点
$x1	開始 ベジエ 制御 最初 曲線 位置 座標 x 左上 点
$frame	画像 ます + 1 3 5 枠線 囲み x 例
tokyotyrant	へ 現在 ます 返し 参照 メソッド オブジェクト
$cookie	られる プロキシ _result セッションクッキー opaque _control yaz _paged サーバー 送 ldap （ ） _response structure
$exp	何乗 指数 数 ます する か base 指定 、 正
$request_token_url	url api リクエストトークン
$word_wrap	場合 単語 ん 関数 て 途中 達し 含め quot ませ ワードラップ ; 現在 範囲 する true パラメータ 最後 & エミュレート 、 しまう
$env_keys	暗号化 キー た 配列
$url	あり リクエスト url ます する リポジトリ 必要 パース 対象 指定 先 絶対 なる インポート
$uri	する エンコード 空間 名前 あるい たい uri エンドポイント 指す ドキュメント オプション スクリプト 、 変換先
$db2_autocommit_off	autocommit ます 無効
$module	定数 場合 記録 れ のいずれ さ モジュール た ます mongolog また か 名 する ログ 指定 module 文字列 パラメータ 使用 設定 代わり 、 移動先
$msgdesc	記述子 mqmd メッセージ
$full_info	かど 全て 情報 ます 替え する 結果 か 表示 切り う
$key	ロック 行 情報 フィールド 挿入 増や 用い 主キー セット 変数 関数 とき ( 、 付加 項目 解放 秘密鍵 名前 する 渡す られ キュー オプション かど リソース 更新 設定 アイテム なり キャッシュ _store ば 存在 て に対応 す コンテンツ た ます ませ さ か エントリ 先 う あるい 調べ 鍵 key キー 使っ 際 先頭 形式 保持 暗号 化 定数 調べる 群 （ もの 格納 ） apc 減ら 正確 秘密 行う 値 ハッシュ メモリセグメント 表す たい 表し 必要 取得 削除 使用 内 _constants 使う ため メッセージキュー れ ん null id ある あり れる なけれ 増やす 配列 共有 _define 付け 関連 置換 文字列 数値 公開鍵 サイズ データ 追加 ユーザーキャッシュ 確認
$connection_string	場合 空に する デフォルト connection _string 使用 こと すべ て パラメータ 可能
tokyotyrantiterator	ます 返し オブジェクト tokyotyrantiterator
$low	低い点
$oid	データベース id oid 内 ラージオブジェクト
$replace	search た 値 置き imagick 置き換える 見つかっ オブジェクト 換える
$resource	接続 や prepare あるい pconnect db ステートメントリソース か な リソース 2 有効 、 db2 返す _ connect
$rpmr	ファイルポインタリソース オープン た rpm _open
$log	時 使用 する ログメッセージ コミット
$xsd_file	へ スキーマファイル xsd パス
$deferred_prepare	た _prepare プリペア db ステートメントリソース 渡す deferred 2 指定 遅延 ます 、 _on 有効 _ について
$with_error_message	エラー エラーメッセージ ます する れ 返さ 設定 、 各 true
$object_id	場合 oid れ しよ ラージオブジェクト null 関数 id ある た れる ます snmp さ て 返し 解釈 とし 前 う オブジェクト オブジェクトツリー ツリー 配列 object 作成 ルート 指定 なり すべ 、 _id 配下 として
$headerfault	ハンドラ エラー 利用 レスポンスヘッダ 報告 行っ soap いる 処理 間 おい て 可能
$principal	削除 する プリンシパル
$extendedclass	た 拡張 クラス 名前
$consumer_secret	提供 する consumer secret サービスプロバイダ
$auth_protocol	sha あるい 認証 プロトコル md5
$normalized	正規 色 する 化
$parameter_type	クオート スタイル ため ます する 変更 ドライバ ヒント 、 提供 型 データ
$errcode	エラーコード れる する 結果 へ 格納 ldap 参照 変数 含ま
$database_password	データベース 表す パスワード 文字列
$auth_session_handle	セッションハンドル 認証
$request_parameters	リクエストパラメータ 配列
$field_number	フィールド 0 番号 始まる オフセット
$spelling	ある に関し 行う 複数 スペル 指定 言語 英語 、 spelling よう て パラメータ もの
$zurl	列 database [: 形式 文字 ][ host という / ] port
$workfactor	場合 圧縮 多い 制御 動作 最悪 処理 繰り返し ます 、 データ 入力
$registernodens	registernodens 登録 無効 コンテキストノード する 自動 オプション 、 でき こと ます
$gid	グループ id
float	数 コサイン 剰余 フィールド 度 変数 ページ 0 返し オブジェクト 利用 gmagickdraw られ 水平 同等 引い アークサイン 行間 隔 正規 場合 ラジアン な arg 小数 型 # た ます + / また 3 率 ポイント ; boost づけ 文字 &# x 平坦 可能 丸め 乗 ポイントサイズ ハイパボリックコサイン 、 化 点数 あっ float 単語 number フォント もの 幅 拡大 log & 値 ハイパボリックサイン チャネル バイト 表す 表し 平方根 高さ マイターリミット グリフ false 失敗 1 浮動 9 間隔 現在 総 アークタンジェント 方向 ガンマ 関連 指定 文字列 成功 サイズ パラメータ エラー e アークハイパボリックサイン テキストライズ y
$scanner_mode	_normal _raw デフォルト ini _scanner あるい
$iptcdata	データ 書き込む
$attribs	attribs ある 第 配列 連想 に関する 3 全 、 属性 要素 パラメータ
$additional_headers（オプション）	れる 最後 メールヘッダ さ 挿入 文字列
$painttype	ませ あるい ば 1 ん 2 なけれ なり
$zip	た zip れ さ オープン 事前 _open ファイル 済み
$saturation	画像 + - 1 0 彩度
$indent	xml か かど する 行 数 整形 オプション ヘッダ 引数 最初 文字 おく 指定 str 字下げ 、 前 う ます
$newdir	新しい リレーションファイル ディレクトリ
$get_scripts	スクリプト 情報 含む 状態 固有
$window_handle	hwnd ウィンドウ id
$background	色 画像 する 背景色 背景 使用
$usec	マイクロ 秒
splfileinfo	た splfileinfo 用 ます 作成 ファイル 返し オブジェクト
$db2_autocommit_on	autocommit ます 有効
$user	ユーザー 名 番号 認証用 あるい
$mask	umask 含む により 新しい ます 監視 する mask 検索 ファイル て 文字 名 シェルパターン 文字列 ない 、 イベント すべ 制限 許可
$group	あるい 名 番号 グループ 認証用
$client_flags	定数 load _compress 以下 有効 mysql また 1 2 _client 8 _flags local _interactive _ssl _space ： する _ignore 組み合わせ data パラメータ client 処理 、
$new_value	とき た 指す 値 する 新しい 代入 マッチ key 変数
$cipherid	定数 のうち 暗号 一つ
$tablename	れる 名前 テーブル さ データベースヘッダ 名 格納
$i5_fetch_only	専用 や 場所 ん 更新 て ませ - 2 5 でき db 読み込み 指定 、 _ _on i 削除 カーソル 使用 なり fetch
$bottom	座標 ページ 下端
$error_message	場合 ため 的 れ な 格納 原因 た 説明 ます 生成 さ オープン でき データベース 文法 渡さ する 発生 指定 なかっ 記述 パラメータ エラー エラーメッセージ チェック _message 保持 参照 設定 error 、 際 として
$nanoseconds	ある あり 十 億 ます タイムアウト 小さい 必要 ナノ 秒数 整数 非負
$interlace	手法 画像 インターレース
$host_name	場合 接続 た 新しい ます ホスト 名 指定 、 なり
$values	xml 含む 配列 名前 値 指定 ます キー 、 変数 データ
$max_depth	深さ 最大 さ 許可 れる
iterator	内部 __ 渡さ た :: れ 現在 新しい ます norewinditerator とづく で渡し に渡さ limititerator 返し イテレータ construct filteriterator recursivecachingiterator
$pad_type	_type _right _both 指定 引数 _pad pad str オプション 、 _left 可能
$column-name	名前 カラム
$callbacks	場合 コンテンツハンドラ 連想 発行 意味 以下 認証 失敗 message 関数 メッセージ パケット macerror とき た 含む _debug れる いくつか さ インデックス yaml 2 パラメータ 配列 msg コールバックパラメータ 全て 用 あるい void する _ignore callbacks 受信 コール ssh 名 _cb _ $ プロトタイプ language always ignore コード _display debug ノード
$callback_url	oauth url コールバック
$signal	オペレーティングシステム のみ posix 有用 オプションパラメータ
$database	場合 接続 へ カタログ 整数 型 ある あり データベースエイリアス パス ます 値 msql 名 上 データベース 表す 名前 する 表し 必要 指定 文字列 た db2 クライアントカタログ database 選択 形式 サーバー ファイル 正しい 、 内
$docs	列 含む 内容 配列 文字 ドキュメント
$frompath	パス へ リポジトリ 現在
$prompt	ユーザー 示す 列 ます 文字 指定 確認
$draw	色 ます 取得 名 フォント 、 サイズ オブジェクト
quickhashstringinthash	新しい ます 返し quickhashstringinthash
$statement	ば ひとつ 以上 な 有効 id oci データベースサーバー た 含む _execute ます ませ て テンプレート ステートメント 8 ref あるい する 作成 準備 指定 sql 識別子 パラメータマーカ に対し ん 文 返す cursor 対象 実行 なけれ 、 _parse なり
$value2	値 たい 能 な 2 ノード 比較 任意 句可 番目 any 可能
$value1	たい 最後 な 値 する 最初 追加 ノード 比較 任意 array 加える any 可能
string	とは simplexmlelement 行 ・ 形 送られ リソース informix 戻し :: 変数 月名 とき 特定 ;rfc やすい 接頭辞 返さ 0 返し ホストキー include 内部 string 稼働 限り メタ 絶対 なかっ -mm ユダヤ arrayiterator 内容 差分 バイトデータ f 全文 更新 設定 バッファリング 際 一部 ;real 縮 読み出し 存在 種類 まだ イテレータ セッション 編集 モジュール n ハンドラ 圧縮 ます ませ msql ドキュメント reflectionfunction ; memcached &quot gzeof len フレーム 鍵 だけ apache カレント [ =cccc はさん リリース 形式 ヘッダ _name 最初 記号 :ii ユーザー api ipv もの 素間 apc _start サムネイル コードセット 秘密 & 前 もし ログイン _autoload 6 埋め type 変え セル はその 基づき プロファイル 取得 与え テキスト mb デコード 検出 サーバー ファイル ださい 接尾 繰り返し v spl ステータス 規定 コンテキストオブジェクト フランス sqlite サブディレクトリ 埋め込ま rararchive reflectionmethod 減算 失敗 複数 シンボリックリンク スタブ いる 自身 ツリー バイトストリーム 試行 quot charset 1 付ける 原因 オフセット 一覧 共有 スロー 保存 して 現在 復元 バイナリダンプ 発生 fd 時刻 成功 a エラー のい phpversion 色空間 最後 データ プロパティ しか 同じ あい 詳細 常 ユリウス ;int クラス 数 wddx 剰余 _res スタックトレース nbsp 満た ディレクトリ セット 関数 日付 含め 含む 変更 説明 大文字 カンマ _param アーカイブ 出力用 読み込ん ベクトル 持ち return 組 制御 getname エスケープ ない られ オプション シンボル 置く サポート 最終 に対し 国 オリジナル name スレッド シグネチャ token フォント アイテム なり セクション 場合 エラーコード 画像 番号 データベースパスワード アーカイブエントリ namespaceuri 正規化 参照く 一時ストリーム extract エンコーディング sha req 空 デフォルト content 取り除い 7 取り除き に関連付け 取り除か sbs シリアライズ コール deflate _string evprepare クラスタバウンダリ 権情 一つ 一時ディレクトリ length コード 指定 ローダー 本文 進 バッファ _charsetxx つの encoding 三文字 number 発行 置換後 ノード 整数 のすべて 革命 size に関する パスワード timestamp start フィールドインデックス data 名 レスポンス statement 相当 バイト つけ 後 時 fbsql 列 needle 読み込ま 読み込み クオート すべて udm 以下 文 カラム 現行 親 処理 str クエリ のよう 全 行id ワーキングディレクトリ false や たり れ 他 ん 異 ストレージ エラーフィールド null ドキュメントコメント だ 拡張子 れる 空間 - note 見つ = soap リクエスト object # 起動 わかり directoryiterator エクステンション ] 英文 ソースコード ホワイトスペース エンコード url テーブル uri raquo アルファベット 文書 カーソル _path 書記 返せる 作っ apciterator および tty 挿入 _result 有効 用い エンドポイント また xml 区切り クォート 新しく 始まり 新しい 3 アクティブ メソッド slob ファイルシステム 8 先 dn handle する フォーマット 変更後 1つ あらわす 2 列表 暦 含ま 一意 空白 フォントエンコーディング 適用 中身 ;mysql 済み かつ テンポラリファイル 正しい x 接続 へ ;月 ば 国名 gmagick な 二文字 ;旧 小文字 リクエストヘッダ calendar 型 て ず す た 大陸 生成 ずれ さ 非 か 除去 ページ 上 8js アーチファクト 元 い エクスポート imagemagick リモートシステム すれ 進文 _get key 生 solr 強度 c varname :ss 受け pdo connection 修正 カレントディレクトリ 化 として 暗号化 ライセンス 順序 辞 キー localname メッセージドメイン guid 警告 解決 bbb ハッシュ オープン json mime ステートメント リンク ローカル 表記 4 表す ;string もしく 表し reflectionclass 表さ ルート 環境 トークン 初 作ら 識別子 ひとつ imap バイナリ により による 変換後 value そう 出力 空文 ベース eio 物理 署名 著作 結果 ii 自動 うち 終わる ascii id メッセージ 素 binary html 部分 配列 9 でき 操作 http 用 レスポンスヘッダ oid ホスト スクリプト 見つから 例え php フィールドフラグ インスタンス サブパス crc 指す パス phar 認証子 リソースハンドル 上安 gzip について 新規 秒あ デバッグ 返り値 clob 情報 imagickpixel そして フィールド 以外 生じ 終了 マッチ mysql glue lastinsertid パケット gmagickpixel 伸長 示す $ 例外 列値 成功時 msgid フラッシュ 積算 空文字 blob 時間 haystack オブジェクト 年 データベース セッションモジュール format 名前 作成 もとづく 収縮 amp 最大 d insert 色 _error 行わ 引数 t キャッシュリミッタ キャッシュ 未満 ファイルポインタ ;t 端末 日 各要 字列 magickwand ターゲット export ;f diff 属性 コマンド に対応 変換 アドレス / sqlstate エントリ 自分 _number づけ 定義 参照 あるい 直近 ;新 文字 ;& ホームページ 表現 使っ なる _ 可能 指令 acf extension graphicsmagick column 対応 チェック callbackfunc ob 無圧 次 、 使う 長 定数 翻訳 文字列 文について 拡張 論理型 ラージオブジェクト 短い セカンダリ ・パス errno 値 snmp タグ サイズ 抽象化 見つかっ mbstring xpath バージョン 逆順 -dd 平方根 hh link 期化 ;blob 復号 true count yyyy utf 実行 phpe 使用 _strcut aa tokyotyrantexception パッチ 有する ドメイン _last 報 ある あり 反復 ライブラリ sybase 5 長い 完全 間隔 _type シーケンス 関連 暗号 sql （ ） イベント パラメータ soundex 要素 eof 理論 エラーメッセージ metaphone 現 sqlcode idna
$extr_skip	場合 ませ た 衝突 する 存在 さ ん 上書き れ あっ 、 変数
$y1	開始 ベジエ 制御 最初 0 曲線 位置 y 座標 左上 点
$y2	右下 ベジエ 制御 番目 2 終了 曲線 位置 y 座標 点
$y3	制御 y 3 番目 座標 点
$mask_image	な haruimage 有効 インスタンス
$sec	jan 1 0 エポック 7 9 :
$compcode	完了 コード
$signature	場合 た 署名 ます 文字列 さ れ 格納 signature 、 バイナリ 成功 生
$event	_handler バッファ _event た ibase つき イベントリソース 作成 な 有効 _set
$autoload	場合 的 かどう autoload 自動 さ せる 関数 て マジックメソッド デフォルト か 見つ _autoload ない う 元 ロード オートロード する 読み込ま コール クラス かし _ かど 通じ 指定 ます 、
$handle	ファイルポインタ ハンドル dba ば fclose れ そして まだ な _open いる データベースハンドル fopen て ず ある あり た kadm クローズ ます さ また 返さ オープン ローカル ポインタ ない 5 _popen い もの あるい 作成 必要 正常 使用 （ ） なもの fsockopen 指し ファイルハンドル popen ファイル ファイルシステムポインタリソース なけれ なら 、 によって 有効
$oauth_auth_type_none	なし
$query_string	文 sql
$tagnum	する 番号 タグ ヘッダ 取得 rpm
$signature_alg	いずれ int - か 署名 アルゴリズム
$pmo	put mqpmo メッセージ オプション
$caches	破棄 指定 たい キャッシュ ます
$x_resolution	水平方向 度 解像
$bson	復元 bson たい
$imagedata	た 表し 画像 データ 文字列
$baseclass	たい 拡張 クラス dom
$isolation	する 設定 分離 レベル
$input	バッファ 交換 ローカルファイルハンドルリソース 調べ 多次 入力 長さ 値 あるい オブジェクト する 現在 配列 たい 元配 文字列 繰り返す 列 パース 使用 取り出し として
$newscope	# クラススコープ 0 &# & あるい 現在 維持 づける 3 関連 static スコープ ます 9 、 ; クロージャ
$entry	する パス url たい 削除 ファイル 取得 な アーカイブ ため 完全 、 内
$from	名前 たい ファイル 変更
$functionname	表す 名 関数 文字列
$new_include_path	新しい 値 include _path
$methods	た methods 持つ 示さ 配列 連想 れ 以下 4つ パラメータ
$default	場合 よう なり ます 値 する 見つ 指定 クッキー ない 、 変数 返す パラメータ
$table	か テーブル 返す どちら
$trans_args	ます _committed なり ibase _args _read および _concurrency _version _wait 以下 _no 組み合わせ _consistency 、 _write trans _nowait _rec
$optlist	場合 1 あり 0 現在 いませ ます radial れ optlist ん r 必要 さ 使用 、 type て パラメータ 含まれる
$encoding_mode	ます エンコーディングモード 指定
$flags	_messages 情報 ストリーム フラグ および のいずれ マッチ セット filename 関数 クォート 含める 新しい いくつか _o to 返し メソッド 項目 影響 エントリ データベース 演算子 れる 配列 する 作成 和 法 オプション こと サポート 適用 書き込み 対処 両方 設定 _* 実行 うち 際 なり | 場合 _create 接続 _verify _invert ソケット いませ _normal _stop 存在 既 以下 ど できる 属性 て せ ず _paths た 組み合わ ます ビットフィールド ずれ さ また か 衝突 3 ドキュメント 先 あらわし 出力 _crc かかわらずすべ 定義 あるい _dontfollow 舞い _updates _copy 組み合わせ _omit キー _container _ 可能 _externals _grep 形式 検索 複数 _patch fingerprint eio 次 、 構造 使う 値 として 定数 無視 論理 スキャンリクエスト 振る （ api 拡張 もの デフォルト 比較 apc 状態 や _changed preg オープン 2 _no passed リンク 任意 さまざまな _all 無効 _non _discover _ignore 取得 与え _bin 要素 xdiff bbcode により による 動作 ファイル ビットマスク 処理 使用 扱い _on そし sqlite テーブル 連結 stream ため 署名 プロファイル れ ひとつ ん libxml 失敗 シンボリックリンク :ignore いる xattr なっ あり 追加 連想 _recursive 1 変更 なく によっ 制御 ない でき 操作 検証 _sha 現在 用 _raw 最新 方向 _hex どう 指定 文字列 数値 パラメータ svn たどら 方法 のい エンコード 値と _show プロパティ のか _md5 or に関する スキーマ flags とも pattern the ssh
$hobj	オブジェクトハンドル
domprocessinginstruction	場合 エラー た 新しい あるい 発生 返し domprocessinginstruction 、 false ます
$other	__ と同じ evembed construct ::
$doctype	null あるい する 作成 ドキュメント 、 型
$level	定数 プロファイリングレベル 圧縮 level 新しい ます オプション _reporting mongolog レベル か のいずれ ログ プロトコルレベル 指定 error 、 たい 記録 パラメータ
$autocommit	autocommit 接続 た コミット ます db ハンドル 渡す 自動 2 指定 有効 、 オン _on _ リソース
$index	場合 $values マップ 調べ 画像 配列 適切 色インデックス 番号 フィールド な 添字 ノード さす null ポインタ index 精度 コレクションファイル 長さ パス 値 場所 インデックス アーカイブ アクセス オフセット ビット 属性 実行 する イテレータ 名前 パレット たい コレクション 消去 取得 どう 位置 た 相対 テキスト 可能 色 要素 削除 カラム phar か 設定 コマンドライン フォント 、 内 スケール
$sigma	分布 変換 標準 効果 シグマ 偏差 ガウス 演算 ピクセル 単位
$args	渡し クラス れ 加え 以下 可変長 拡張 関数 て 方式 サービス ます 連想 デフォルト 固有 call あるい パッケージ コンストラクタ クラスコンストラクタ オブジェクト _func 渡さ する これら 配列 args 作成 渡す 文字 指定 コールバック オプション キー _setllw パラメータ 同じ 列 受け付け _user 時 f cmd プログラム 引数 保持 オプションパラメータ _setlk 、 際
sdo_dataobject	ルート ます 返し sdo _dataobject
$success	場合 設定 た 成功 ば さ あい 失敗 れ ます 、 false 際 true
$directory	する 名前 れる 新しい あるい パス 削除 作成 さ 対象 ファイルシステム カレントディレクトリ ディレクトリ なる ディスクパーティション
$matrix	行列 色 値 アフィン 含む
$col_name	知り スキーマ たい カラム
$ctor_args	渡さ 要素 ます れ 配列 コンストラクタ
$resumepos	開始 する 中 位置 、 ダウンロード 内 リモートファイル
$capped	か どう コレクション 固定 サイズ
$cache_cb	read あるい キャッシュコールバック 、 null -through
$reason	コード compcode 表す 原因
$return_float	float 配列 する 返し なく 指定 ます 、 true
$nonrecursive	かどう する か 再帰 処理 ディレクトリ
$proxy	（ ） プロキシ 接続用 yaz
$arg4	_filter : アルファチャネル img _colorize
$queries	配列 オブジェクト tokyotyrantquery
$arg3	青 img 値 _filter コンポーネント : _colorize
$arg2	img 値 _filter コンポーネント 緑 : _colorize
$ang1	開始角
$link_or_trans_identifier	場合 た コミット ます なし れ 引数 コール さ 、 デフォルトリンク トランザクション 関数 ロールバック デフォルト
$character_mask	により character する 削除 _mask 文字 指定 、 こと パラメータ 可能
$right	右 座標 ページ 右端 オペランド
$privkey	ます 設定 た 秘密 _new あるい 系 openssl 作成 他 事前 鍵 ） （ 、 privkey 関数 _pkey
reflectionmethod	ます プロトタイプ 返し メソッド reflectionmethod オブジェクト
$i5_time_sep	ます 区切り sep i - _colon コロン db 文字 2 5 として 使用 時刻 : _
$large_object	lob _open た れ 返さ リソース pg ラージオブジェクト postgresql によって 返す _lo
$checkpoint	a lengthy pause increments service start or stop value its checkpoint to continue during report progress the operation periodically
$fieldvalue	フィールド 値 に対する
$x509cert	書 証明 たい 調べ
$remote_socket	アドレス 接続 する ソケット
$server_socket	付ける 接続 受け 元 サーバーソケット
$token	分割 区切り 値 する 文字 トークン str oauth 使用 際
$newthis	た する 無名 バインド 指定 関数 オブジェクト
$tag	表す 含む locale 連想 値 形式 空 タグ キー ロケール 配列 ない 、 属性
$xresolution	画像 新しい 方向 解像 x 度
$more_entropy	返り値 エントロピー 最後 ます する 使用 追加 別 線形合 同法 、 true て uniqid さらに
$newparent	新しい 親 エントリ
$old_file	最初 へ パス ファイル
$sec_name	名 セキュリティ
$i5_commit	設定 db2 i なけれ ば ませ ん 5 connect 、 commit 属性 前 _ なり
$bbcode_container	_create _container 返す bbcode リソース
$str	分割 幅 番 論理 エスケープ 検出 小文字 比較 入力 変換 大文字 小さい 戻し ハッシュ 取り除く バイナリ 元 する string たい 二 取得 トークン 文字列 ソース 表記 ホワイトスペース エンコード 目 デコード 対象 なる 取り出し
$extract_type	ます 形式 $size 指定 パラメータ 単位
$step	場合 要素 数 ます れ step 指定 さ 増加 いる 、 毎 なり て
$record	配列 データ
$phase	か 開始 する パターン
$cwd	ディレクトリ 初期 コマンド 作業
$fetch_type	定数 _type _first ふたつ のうち _next sql 次 どちらか fetch _fetch
$img_effect_alphablend	通常 false ます 同じ 渡す ピクセルブレンディング imagealphablending 使用
$y-step	際 垂直 方向 並べる パターン ピクセル 間隔 単位
$archive	へ パス ディスク phar アーカイブ 上
$iterator_class	反復 配列 名 イテレータ 処理 クラス 使う オブジェクト
$script_code	スクリプト コード
$data-type	定数 型 する バインド 指定 sql 変数 データ php のか
$dest_height	変換後 高さ 画像
$remote_file	へ パス する 最終更 ファイル 取得 時刻 リモートファイル 新
$pad_string	場合 分割 数 注意 て 長さ れる ます さ pad ない でき : 均等 必要 埋める 文字 られ 捨 _string 切り 、
domnodelist	インスタンス 一致 要素 含む 新しい ます する 返し domnodelist 関数 クラス たすべて 、 なる すべ て オブジェクト
$fielddesc	配列 する フィールド 保持 設定 fielddesc 、 各
$dict	辞書 リソース
$stroke_opacity	不透 明度
$revno	する アップデート 番号 リビジョン
$step_callback	ユーザー 集約 コールバック 名前 定義 適用 関数 する 対象 指定 項目 あるい 、 php すべ て として
reflectionextension	情報 ます 返し 拡張 reflectionextension モジュール オブジェクト
$lock	元用 ロック ミューテックス ます する ハンドル 呼び出し 返し 、 true て
$write(string $sessionid, string $data)	とき た や れ ます コール セッション さ write 終了 必要 コールバック 、 保存 なっ
$zp	ファイルポインタ あり た 指し により オープン ます gz 必要 かつ て な 指定 有効 いる 、 でき ファイル gzopen
$array2	たい 要素 含む 配列 値 する 番目 対象 2 比較 なる 置き換え
$array1	比較元 たい 要素 調べる とと 適用 配列 値 する 置き 最初 換え コールバック ソート なる 関数
$blocksize	時 圧縮 ます 指定 ブロック 長
$main_str	比較 最初 たい 文字列
$applname	接続 へ _applname ホストデータベースサーバー アプリケーション ます クライアント 、 - 終端 名 ポインタ する db 送信 文字 sql 2 列 _attr 使用 ヌル _info 際 として
$cap	ませ のい なけれ 値 ば ずれ か ん 次 なり
$log_dir	ディレクトリ ログ する 存在
$event_name1	名前 イベント
$value	情報 フィールド 挿入 増や / しよ touch 変数 関数 新しく 含む 説明 ペア 二つ 0 付加 項目 とし 配列 する 限り ない 新しい オプション アーチファクト コメント _meta 引数 設定 によって 変わり 追記 渡す値 _cookie 以下 クッキー 属性 て 変換 _field た ます ずれ さ か エントリ シリアル う xslt あるい 文字 だけ キー 先頭 子要素 形式 _time 指定 化 px 定数 場合 文字列 数値 格納 比較 減ら 値 チャネル 任意 埋め option たい コレクション 要素 命令 テキスト 内容 value ファイル 処理 扱う 使用 連結 stream tidy れ データベースフィールド いる curl 型 paradox れる _lock 1 変更 共有 保存 _touch 置換 、 variable _data パラメータ 列 _timestamp のい エンコード データ プロパティ グレイ 追加 値として
$noise_type	ノイズ 形式
$params	接続 $arr 呼び出さ ば れ プレースホルダ ん 中 など て 末尾 # た $ ます ませ 連想 ;] 1 0 3 2 params ストリーム 9 コンストラクタ ; parameter オブジェクト 操作 フィルタ リスト 配列 プリペアドステートメント に対する 、$ さ 共に &# 指定 渡す オプション class パラメータ 最後 = 形式 なく value _name 追加 置き換える [& 、 なり
$request	xml 変換 指令 型 soap リクエスト
$gmax	値 緑 最大
$arrays	かど 配列 する か 指定 ます 各 う セクション
$batch_size	まとめる バッファ レコード 数
$maxlen	varchar ます 値 / char 使用
$constants	gt constant & 連想 形式 value _name 配列 ; =
$timezone_identifier	id タイムゾーン
$patch	unified バイナリパッチ パッチファイル 形式 パッチ 文字列 バイナリ
$initial_value	場合 値 する 存在 設定 ない アイテム
array	gt 行 ・ 識別子 リソース ディレクティブ 描画 カテゴリ ;phase 変数 プリンシパル iterator getnamespaces 返さ 0 返し とし 返す 内部 識別 string ;folder ユーザーキャッシュ クラス 索引 -value 参照 設定 red ヒストグラム 際 有効 分割 :: リスト 存在 クエリ モジュール コールスタック 文書化 index レコード ;、 ます ませ また ドキュメント 状況 ロケール 番目 あらわす ; memcached つぶし 鍵 だけ キー あり 済み 行ずつ inotify 始まり 形式 ヘッダ パース delimiter セッションクッキー すなわち ;versionnumber ユーザー ベンダ imagick api ipv もの 格納 もち 化記 表す値 値添 もつ 白い点 & インターフェイス 6 チャネル 埋め もう skewness たか 基づき 取得 字 kurtosis テキスト md サーバー ファイル ださい 解像度 塗り spl 個々 内 mysqlnd 統計 reflectionmethod 失敗 いる _errors end quot 連想 1 余り 一覧 共有 スロー xhprof 保存 プール 全て 現在 係数 復元 mongocollection 発生 という 指定 エントリー あっ 行列 成功 a メモリ エラー のい 最後 プロパティ 同じ callback green 詳細 といっ 要求 三つ 数 autoload スタックトレース 宣言 セット 関数 ポリシー がつけ 含む 大文字 二つ 含ん ;pattern すべ 添字 _memcache 持つ timestamp 登場 含まれ ;acl られ に対し name シグネチャ 入れ 拡張 なる 操作 マニュアルページ 場合 エラーコード 画像 いませ 番号 意味 static quantum 参照く 多次 固定 _fetch category エンコーディング 空 デフォルト 破線 7 インポート 返り値の コール getavailabledrivers 組み合わせ 印字 つき openssl つの 垂直 サポート notify 整数 array ジャンル 差 width ソート インデックス 同 2 レスポンス 各 後 座標 時 切り出し セッションキャッシュ 割り当て copy すべて 単一 開始 keyword 以下 カラム 購読 処理 とその イテレータ server result false や plaintext れ 組込 ん ソケットリソース アルゴリズム だ チェックボックスツリーアイテムリソース れる 空間 - レベル 見つ 入力 = soap リクエスト 付け ハンドラ getdocnamespaces object グループ ）、 エンコード url 字配 テーブル uri に関する 文書 区別 _id ファイルキャッシュ text および プロトタイプ reflectionproperty errstr スコープ protocol アタッチ &quot 区切り 始まる title ページ デフォルトプロパティ アクティブ メソッド 8 サンプリング よう イテレータインスタンス 残し 部 する フォーマット に対する 全体 =& 水平 reflectionfunction 静的 空白 artist 適用 共に sha うち 接続 ば 国名 gmagick な 中 解決 全 できる 型 て せ た lstat ずれ さ 非 か 3 アクセス 元 い imagemagick 日付 受信 key 名 文字数 pdo opcode フィルタリング ペア スクリプト 構造 として minima 行っ height apache 適当 マニュアル ヒント エイリアス フィールドプロパティ imageftbbox グループセット 短い ドライバ 行ご blob （もし 表す 抜粋 読み込ん 述子 ルート （わざ 色度 有する imap バイナリ 他 内容 セッション buildfromdirectory 出力 ）まだ くだ データベースファイル コマンドラインヒストリ 署名 結果 ファイルパス 囲み id メッセージ なっ 素 最初 組 カラーインデックス キーサイズ アーカイブ getimagesize 名前 ない 開い マップエントリ http ibase 用 レスポンスヘッダ blue 方向 ホスト 集約 php 列 利用 phar スキーマ client について maxima 返り値 情報 要素毎 imagickpixel targetreference そして フィールド 以外 マッチ メタデータ 例外 成功時 回数 者 パターン 4 usage input gmp オブジェクト データベース ;versionstring 配列 コピー 値と 最大 色 メタタグ プロセス 引数 両方 inclued msgno キャッシュ ;r realpath 各要 ;x ;c ;b ;a ;g ;d ;k 属性 ;m に対応 変換 抽出 アドレス / ;min _assoc エントリ 現れる 定義 あるい おける 文字 位置 表現 _ 可能 なり 登録 対応 乗 range 小文 次 、 データ 長 定数 さい setlocale 文字列 単語 （ すれ 長配 データベースハンドラ bson 応答 ;max errno 値 snmp タグ サイズ start ;y バージョン 平方根 oauth 復号 true localeconv limit 実行 使用 見える 回前 幅 uid pid ひとつ ini カテゴリツリー ある 代入 長さ ジオメトリ パス なけれ depth 逆転 5 完全 stat 関連 暗号 sql 数値 ） メールボックス イベント パラメータ reflectionparameter 要素 ご覧く エラーメッセージ 数字 バックエンド _sqrt cpu
$delimiter	列 rows 要素 区切る 区切り 一文字 値 する フィールド 文字 1 指定 オプション 、 各 対応 内 のみ
$priv_protocol	あるい aes プライバシープロトコル des
$start_index	返さ 配列 インデックス 最初 れる
$dbase_identifier	データベース リンク id
$expr	式
$encoding	定数 _encoding 調べる 数 encoding オプション および 単語 表す れ サポート のいずれ 入出 デフォルト 宣言 モジュール null て 入力 xml ps ある た エンコーディング 読み込も ます _http ずれ さ 出力用 か 名 ドキュメント 4 mbstring あるい 出力 id う 時 エイリアス 渡さ http エンコーディングタイプ 試み _findfont 名前 する 変換 予想 文字 期待 指定 列関 、 おい 場合 php パラメータ 文字列 のい mb チェック zlib 一部 ファイル れる _output 設定 _* に関し 力 使用 テキスト として もの
$host	つに 接続 ip ドット フィールド 分け 待ち受ける ftp た アドレス ます snmp cyrus か 名 4 エージェント memcached レプリケーションマスタ あるい ホスト host られ 指定 sql imap 形式 サーバー memcache 、
$outer_bevel	外側 幅 影
$exception_handler	た 例外 れる 名前 れ 発生 キャッチ コール さ ない 際 関数
$estimated	取得 予測 する エントリ 数
$envelope	配列 ヘッダフィールド 連想
$value_compare_func	二番目 ユーザー 比較用 ます および ださい 結果 引数 最初 usort 返し uksort コールバック 参照く 比較 、 定義 について 関数 例
$dn	エンティティ れる 識別 証明書 名 さ ldap 使用
$mtime	変更 時刻
$db	データベース
$first_page	付け 含む 範囲 最初 ページ ラベル
$deep	かど コピー 含め 子孫 ます する う か 指定 要素 て
$link_identifier	場合 接続 み リンクid れ dbx もの mysql id 省略 た ます なし さ msql オープン interbase ldap リンク 返す 開い _pconnect fbsql あるい ない 指定 sql mssql _connect 最後 リンクオブジェクト 使用 ms frontbase 、 使い
$connect_type	場合 接続 _string たとえ れ まっ た 新しい ます _force pgsql オープン 同 一 たく 渡さ _new あっ 既存 _connect connection 、 ても
$save_indexes	添字 配列 う 数値 試みる しよ いる 使っ 保存 て 元
$new_size	新しい サイズ
$c1, c2, c3, c4	ps さい _setcolor 意味 参照 て パラメータ くだ
$increment	加算 値 する 変更 優先 増加 度
$process	られる _open 閉じ リソース 終了 さ せる proc
$rowcount	ます こと せる 数 - クライアント する db 取得 rowcount 2 全行 、 問い合わ _on 前 でき _ _prefetch
$reverse	ます する 逆順 1 ソート 、
$base_group_id	取得 番号 パスワードファイル た グループ
$#n	進 基準 ます 桁数 n 1 0 文字 小数点 最大 左側 指定 : 例
yaf_controller_abstract	_abstract インスタンス _controller ます 返し yaf
$cols	端末 新しい カラム 画像 数
$index_key	使う 配列 カラム インデックス 返す として
$page_per_pages	数 保持 ページ できる pages オブジェクト
$only_names	プロパティ かどう か 名 返す のみ
$gamma	量 値 補正 画像 ガンマ
$key_compare_func	二番目 ます 結果 引数 最初 返し 比較 、 関数
$character	変換 する 文字 コード
$flag	場合 false cl true フラグ リスト れませ 以外 自動 デフォルト 格納 暗黙 送る でしょ メッセージ oci 設定 た がつい _buffer ます 置換 フラッシュ 使用 て か _expunge する 2 bool 項目 解放 よい でき : 前 う 注意 明示 マーク たい 全て 独自 利用 クレジットページ _lob さ 決める flag memcache 指定 、 オン こと メールボックス 圧縮 的 閉じる _free ん 保存 zlib 削除 リソース 引数 callback 出力 行う うち オフ として _compressed
$set_leading	場合 ます - y 、 なり true テキスト リーディング
datetime	インスタンス 新しい ます datetime 返し オブジェクト
$set	解除 する 待つ 配列 シグナル リスト か 設定 false true フラグ
$y_resolution	度 解像 垂直方向
$result	情報 dbx リソース 有効 mysql セット 変数 関数 含む _execute 返さ ldap 返す なり returned 配列 られ 含ま resource _search large 参照 実行 なる _lo スキャン 場合 _db な クエリ て ハンドル た エンコーディング ます さ 固有 い あるい 文字 コール キー by _params _tables postgresql 検索 対象 、 格納 応答 rpn lob 得 もし _open pg ステートメント 時 fbsql ポインタ 結果 _fields テキスト 内容 デコード サーバー 処理 sqlite れ 他 評価 id 代入 _list れる _dbs interbase リクエスト object 変換 _query 指定 成功 列 追加
$filesize	バイト たい 数 確保
$events	表す た _read フラグ 指定 組み合わせ 任意 _write ev イベント
$bytes	長さ 読み込む 数 ます bytes 指定 キー 、 バイト パラメータ
$dest	ファイル パッチファイル へ 結果 パス
$mime_encoded_text	た エンコード さ mime れ 文字列
$initial	場合 intial れ 利用 結果 たり 空 さ 使用 最初 な 処理 配列 オプション ます 、 として 最終 可能
$cache_type	場合 & _type れ quot 情報 ます cache クリア さ 返し ユーザーキャッシュ user ;
$fieldname	表す fdf 名前 フィールド 名 文字列
$encoded_headers	表す た エンコード れ ヘッダ さ 文字列
$i5_lib	参照 ます ライブラリ する デフォルト ファイル 解決 指定 使用 際 未解決
$message_code	場合 渡さ 説明 ます する 存在 れ コード について イベント
closure	closure た クロージャ 新しい ます に対する さ 返し 指定 れ 関数 オブジェクト
resource	持続 filename 行 0 数 show 情報 ストリーム ととも および _file _listen ドキュメントハンドル グリッド リソース informix 有効 mysql 返り値 セット 非 関数 リソースリンク &quot 示す 含む _buffer 変更 新しい fwrite explain _rename 返さ -ftp 返し blob 読み込ん ldap 5 gmp 正 _close postscript _grp handle リクエストリソース fclose する 作成 ssl _create ssh _seek fam フォームコンポーネント _unbuffered _write こと _fsync イメージリソース resource 番号 ポート ifx クエリー プロセス 引数 _futime _mknod _* _mkdir 回転 なら x サブシステム 際 _busy 片方 もの 場合 モニタリングリソース 接続 へ 画像 _do _symlink pclose ば フォーム な エントリ コンポーネント クエリ result できる _chmod リクエストグループリソース 型 _chown て コマンド 一方 ハンドラ サービス ハンドル 化記 た _lstat ます ibase 暗号 ずれ さ また か ドキュメント のみ _unlink ; ソケットリソース い xml _new パーサ あるい ステートメントリソース 存在 _get 鍵 ステートメントハンドル ゼロ ;curl イベントベースリソース 共に あり _ kadm _stat 発生 なり postgresql firebird 停止 fopen 辞書 _read トランザクションハンドル 正しく パース 成功時 やその ファイルハンドラ frontbase 次 、 共有 ディレクトリハンドル データ publickey 書 バッファ ボタンコンポーネント 組み合わせ ファイルポインタ _add フォント _open 格納 のすべて _rmdir ストアドプロシージャ select 思わ データベースサーバー に関する 秘密 つき _range _blob 値 _entry 読み書き _dup 向 オープン 2 sybase 関係 rpm 使わ リンク : 後 _fchmod 妥当 _fdatasync fbsql 表す _ftruncate メモリセグメント 全て ポインタ fgets 受け付け 述子 正常 ingres れ のい true imap socket ファイルディスクリプタ fgetss ラッパー 名 により fdf 文 カラム ファイル 指す 異 実行 ms 使用 内 eio 全 リソースハンドル 時 セマフォ false 使う や ため 的 かどう share 通常 結果 検索 他 ところ 証明 _sync 失敗 処理 いる curl feof id メッセージ / 最初 縮尺 だ mnogosearch zip れる クローズ なけれ msql event 権限 余り interbase ユニーク エージェント ない odbc でき ストリームコンテキストリソース 含む新しい ファイルポインタリソース せ 一致 といっ リンクリソース ftp describe ある ホスト _query ハンドルリソース 準備 別 指定 sql _fallocate 公開鍵 _sendfile 成功 イベント パラメータ fsockopen 9 エラー ストリームリソース ソケット _readahead ボタン テーブル uri sftp callback メソッド 同様 新規 _statvfs _base
$xmlversion	xml バージョン 文字列
$numcolors	色数
$req_params	必須 たい 削除 パラメータ
$isglobal	か ロック 制御 する システム ローカル スコープ ます 全体
$details	か 現在 あるい 値 する 取得 な 設定 詳細 、 各 のみ
$setting	&quot =bar 形式 設定 ;foo ;
$isid	場合 false name ます たい 以外 設定 、 型 true id
$peername	選択 場合 た アドレス 名前 クライアント トランスポート れ 接続元 設定 有効 あっ ます 、 て 含ま い
$fetch_flag	_flag 定数 ibase ます 論理 および 指定 _text 和 、 fetch _unixtime
$is_final	場合 なり た データ 最後 data 送られ れ という 設定 さ 間 ます 、 こと true 処理
$threshold	試みる ソラリゼーション 圧縮 ます 値 最小値 効き 具合 自動 指定 長さ 閾値
$exclusive	xpath た 空間 名前 する プレフィックス パース 対象 指定 マッチ あるい ノード だけ 有効
$delay	化 待つ 画像 無効 ます する / 1 0 指定 遅延 待機 秒数 アイテム 秒単 位
$ident	ident ます さ 追加 れ 文字列 、 各 メッセージ
$ignore_transparent	透過 場合 色 無視 保持 ます する さ 他 以外 指定 れ ゼロ 、
$local_socket	ませ ソケット や af ip 番号 トランスポート れ ターゲット 決定 / tcp また て た れる _inet ます _socket さ インターネットドメイン 名 部分 によっ : い 構成 udp ば フォーマット 作成 ホスト という 指定 タイプ 続く [ ] パラメータ remote ん url コロン 形式 ]: ポート アドレス られ といっ なけれ 、 なり それに 区切
$schema	ば た 含む 所有 なけれ テーブル 作成 者 ん スキーマ 指定 ませ プロシージャ 型 なり
$ex	x 矩形 終了 位置 座標
$ey	y 座標 矩形 終了 位置
$optname	デバッグ 情報 記録 な 型 関数 _debug 説明 ます か _option う ソケットオプション 報告 する _get オプション 可能 かど socket 同じ so 使用
$constantname	定数 表す 名 定義済み 文字列
$font_index	imagepsloadfont 返す フォントリソース
$row	行 番号 結果 な 号 用い セット た ます インデックス オフセット する 取得 指定 可能 列 行番 スクロール カーソル 、 内 行番号
$rot	角度 ます 度単 指定 回転 位
$oid_only	返さ テーブル 属 名前 する デフォルト フィールド れ ます 、
$lob1	lob id
$lob2	lob id
$observer	デタッチ する splobserver
$ed	終了 角度
$priv_key	に対応 pkcs # 秘密 プライベートキーコンポーネント _key する ファイル 1 2 鍵 cacert priv
$encoded_string	た エンコード url さ れ データ
$configargs	書 数 たり システム 証明 など 使用 ます デフォルト 上書き エクスポート 処理 ビット する 作成 鍵 configargs （ ） こと 可能 により 指定 openssl ファイル 追加 設定 詳細 、 方法
$count	場合 数 行っ れ マッチ 格納 ます て ぶん た れる 回数 個数 さ か バイト 返す 渡さ 現在 する 文字 置換 位置 オプション 要素 行わ 削除 指定 引数 箇所 、 データ
$leading	ピクセル する 行間 指定
$field	連結 ・テーブル ・ カラム 番号 ドット フィールド 数値 もの か た 始まる field ずれ また 1 0 名 オフセット 名前 インデックス 表す する あるい たい 取得 文字 文字列 （ ） フィールドオフセット 列 のい テーブル 形式 引数 、
$subjectlength	文字数 プロパティ fetchsubject
$new_link	場合 回目 既 mysql でに id ず 確立 た れる ます 再度 さ 返さ オープン にす 2 なく リンク _pconnect 回 作成 コール れ mssql _connect 同じ 引数 代わり 、 新規
$help	ヘルプ 文字列
$country	定数 国 \gender れる gender する 表さ 指定 クラス id
domcdatasection	場合 エラー た 新しい あるい 発生 返し domcdatasection ます 、 false
$idna_info	場合 intl だけ variant _variant _uts 4 _idna 6 、 使う パラメータ
$session_id	破棄 読み込む する セッション データ id
$class_method	た 区切っ 名 メソッド クラス : もの
$retries	時 とき た 再試 数 回数 発生 タイムアウト 行回 行
domdocumentfragment	場合 エラー domdocumentfragment た 新しい あるい 発生 返し ます 、 false
$which	取得 要素 配列 渡す フィールド オプションパラメータ 、 こと 可能
$deleteoldrdn	場合 古い ます 値 削除 rdn true
$imagecontents	画像 内容
$trustedcontext	接続 コンテキスト _context 信頼 db ハンドル 渡す 2 _ ます 、 済み 有効 trusted _enable
$search_criteria	条件 フォーマット 検索 2 文字列 imap
$shared_library	名前 たい 読み込み ライブラリ
$type_namespace	空間 名前 型
$port	場合 接続 ソケット 数 af ip 番号 tcp 大きめ / できる いる でしょ 待ち受ける リモートホスト _inet ます インターフェイス ポート port 先 6 任意 でき memcached う データベース udp レプリケーションマスタ 必須 あるい する いい て 別 指定 、 こと すべて パラメータ のみ 動作 サーバー ほう memcache 要求 使用 なり だけ
$alias	エイリアス とき 文字列 指す する phar 短い アーカイブ クラス 使用 さす 名 際
$shm_identifier	メモリ た id 取得 _attach メモリセグメント 共有 メモリリソースハンドル 返す shm
$working_copy	場合 コミット 作業 ます コピー ファイル エクスポート ない 、 true て い
$anything	変数 変換 たい
$edition	データベース た ・ れ & create quot 作成 さ edition エディション 名 であらかじめ sql ; コマンド オラクル
$fam	a サービス 接続 へ resource returned service 返す 表す _open to connection fam 、 the representing by リソース
sqlite3stmt	場合 sqlite た 3stmt ます 返し 失敗 、 false 成功 オブジェクト
$siginfo	siginfo 含む 情報 配列 シグナル さ 設定 れ ます について
$type_name	型名
$nameあるいはoptions	あるい 配列 文字列
$code_page	場合 クラス ます 働き 同様 com
$term_type	termcap term た れ 一つ ます 記載 _type / システム etc 対象 エントリ さ 相当
$work	ワーカー threaded する worker 積ん 事前 だ 実行 型 オブジェクト
$community	ライトコミュニティ リードコミュニティ
$next	開始 へ ます さ 参照 設定 れ 位置 次
$ber_identifier	内部 メモリ ポインタ おける 位置 ber _identifier id
$connection	付け 接続 へ pconnect な リソース connect mysql _pconnect id なっ oci その後 ハンドル た が返し クライアント 2 アクティブ 返す データベース cloudscape もの 無効 _new あるい derby db 関連 指定 apache 当初 db2 成功 _ _connect postgresql ibm サーバー られ ます oracle 、 有効
$multiplier	input 回数 繰り返す
$pos	最初 新しい ストリーム - 1 0 取り出す ドキュメント 位置 はすべて 、
$minor	マイナーデバイスカーネル id
$parameter	ます 渡し 名前 たい 渡す ひとつ 関数 指定 メソッド 配列 id 、 すべ て パラメータ
$month	月 日 vendăšmiaire 間 た 数字 ます - カレンダー 1 3 2 5 6 前 数え 表す おける月 各年 年末 最後 月数 選択 、 なり
$variable	バインド 格納 変数 れる ます 値 さ 返さ づける 名 ステートメントパラメータ する 環境 bv 関連 指定 sql php カラム _name 評価 設定
$data	暗号化 - および ウォッチャー そして フィールド 挿入 更新 マッチ 書き込む せる uuencode xml とき 読み込む ペア 、 含ん 8 返す 添字 カスタムデータ 配列 する 作成 渡す バイナリデータ 9 文字列キー 収縮 2 _retrieve コメント 内容 保存 メモリブロック 引数 有し mode なる gzcompress bytea デコード イテレータ 型 て gzdeflate 変換 た 圧縮 ます 直接 さ また づける 3 エントリ テキストデータ 番目 元 い あるい 送信 文字 表現 キー 使っ 含む postgresql 整形式 指定 ヘッダ _name 対象 関連 iso 暗号 _record 化 px 進 エスケープ 格納 ラージオブジェクト table 送り もつ lob 値 名 6 任意 pi もしく たい chdb cdata 命令 復号 テキスト 追加 により カラム ファイル 処理 値に 書き出さ 署名 形式 れ システム など ある だ れる 連想 1 5 によっ 共有 前 soap リクエスト 現在 object バイナリダンプ cipher 置換 文字列 数値 data パラメータ 第 エンコード データ テーブル パック シール callback バックエンド 書き込ま
$parameter-number	プリペアドステートメント 位置 パラメータ
$date	日付 文字列 あらわす
$doc	変換 simplexmlelement domdocument れる ます あるい する 指定 文章 さ domxpath 対象 られ ノード 、 た なる オブジェクト に関連付け
$extr_overwrite	場合 た 衝突 ます する 存在 さ 上書き れ あっ 、 変数
$chunk_size	チャンクサイズ
$perm	セマフォ 設定 パーミッション オプション
$embed	ドキュメント グリフデータ 大きい ます 値 する 指定 埋め込ま れ ファイル 0 設定 フォント pdf 、 埋め込み true
$dirname	へ パス 新しい する 監視 ファイル ディレクトリ
$faultactor	エラー た アクター 識別 する 文字列 原因 なっ
$word_space	単語 間隔
$right_operand	右 表す 文字列 オペランド
$debug_level	定数 _trace による 値 xxx 組み合わせ 整数
$new_height	高さ 画像 変更後
$dash_on	破線 形式
$inputencoding	データベース エンコーディング データ する 際 保存 入力
$subject	場合 調べ ・ 各要 および れ 更新 て subject 素 返り値も observer ます 、 あるい splsubject たい もしく 配列 する 送信 文字 指定 文字列 通知 に対し 列 件名 表題 検索 メール 対象 行わ 置換 なる なり
$callbackfunc	渡さ 展開 た れる あるい する れ 返し 指定 さ コールバック ます 、 null 関数 セクション
$publicid	サブセット 外部 公開 id
$atime	時刻 アクセス
$blobidarray	場合 blobidarray text 有する クエリ id &quot ある quot もし また blob ; する て ;blob おい byte こと パラメータ 可能 & カラム 追加 、 対応
$blur	要素 blur
$treedepth	1 通常 ます 値 か 0 整数 、 なり
$quota_root	通常 調べる ます _root quota （例 か 指定 user はど ） 、 : メールボックス inbox
$sinkinterface	れ デフォルト しよ せ php た ます インターフェイス さ 名 sinkinterface う comobject する たい タイプライブラリ 関連 指定 使用 こと 可能 上書き ディスパッチインターフェイス 、
$blue	値 青 コンポーネント
$class_name	splfileinfo ため および _file れ 派生 :: て openfile た れる ます 値 getfileinfo さ 名 コール パラメータ エクスポート simplexml よう 返す オブジェクト たい 名前 する 作成 指定 getpathinfo クラス オプション _load インスタンス 返り 使用 設定 、 際 化 プロパティ
$property_name	プロパティ 名
$i5_dbcs_alloc	アロケーション db2 i dbcs db 用 2 5 有効 、 6x _alloc トランザクションカラムサイズ _on _ ます
$pad_length	場合 列 ある 以下 行わ ませ ん さ また 値が 文字 pad れ 埋める _length 、 操作 負 長 入力
$jpegname	へ パス jpeg ファイル
mixed	disp gt ・ リソース :: 変数 許可 とき 返さ 0 返し _unknown 文字列 返す 渡し 渡さ string 同時に 限り _chars 値以上 クラス なかっ entire 返す文 により 参照 設定 リスト 存在 種類 イテレータ index 他結 圧縮 ます ませ 場所 また 式 ; xml ;none だけ キー 形式 _name 最初 _output パーサ explain あらゆる ひとつしか win 内破 深さ もの 格納 どれ select & preg もし なりえ チャネル もう たか ビット 最小 おかし 取得 memcache テキスト 追加 mb 自動 サーバー ms _err 失敗 内 内部 無関係 減算 ランダム 静的 いる いれ quot 連想 1 変更 除算 型付け スロー onoff 検証 無制 現在 行分 省略 variant 発生 置換 成功 response のみ spool エラー のい 最後 プロパティ or 要求 等しい 数 次の jpeg セット 関数 group 含む 二つ _e すべ return オフセット コミット あわせ 拒否 られ キュー オプション こと _rand domnodelist mode timeout なら なる csr 場合 画像 番号 dbplus エンコーディング 空 デフォルト pgsql max 両者 単 日付型 行全 コール 表示 language _long 一つ 不正 コード 指定 単純 encoding snmp サポート 認証 ノード ;msec 整数 array いろいろ $this 向 インデックス 性 名 _status 後 時 option 進ん needle 各 gmagick な 文 double カラム 値と and 初期化 false や れ 他 ん ストレージ 処理 null チェックボックスツリーアイテム だ min - レベル 限 microtime 一方 前 soap 空の object _warning url テーブル 対 に関する _id 取り出し 解凍 show 有効 用い &quot _http すべて メソッド よう 否定 する db に対する 列列 入れる 2 暦 resource ハンドラコールバック かつ implication 一 正しく _exception 接続 _callback にまだ ば simplexmliterator 以上 以下 中 sec _row ステータスコード 型 て subject た 生成 ずれ さ か 3 先 演算 元 い 改暫 javascript どちらか 相対 c 先頭 受け pdo connection expression として 論理 反復 調節 username 表す describe もしく 無効 pdostatement tagnum _overflow 選択 value ルール 出力 署名 ～ 結果 parse 証明 id メッセージ _divbyzero 次行 部分 名前 ない でき http oid あり php 列 逆方 体 指す com れる options なけれ について 従っ ラベル left 返り値 列型 フィールド 以外 インスタンス マッチ mysql 例外 成功時 haystack 負 オブジェクト opt へ format 配列 integer 最大 _error = fetchcolumn 引数 対応 right 適切 属性 autocommit 変換 エントリ 拡大 づけ 定義 あるい 文字 位置 offset _ 可能 キャッシュ 乗 複数 保持 _url 次 、 エラーハンドラ データ 状態 グレゴリウス float 比較 値 小さい タグ 見つかっ xpath デシリアライズ 要素 true ハイライト count 標準 使用 書 応じ parser ひとつ 評価 ある 果 no 曜日 ライブラリ _code ポインタ 完全 規則 _query _replace 関連 eval sql 数値 readline パラメータ e とも
$bcc	さ た れ ます 除外 者 bcc 受信 指定 ヘッダ 、 mail
$len	数 書き込む 読み込む リモートホスト れる ます 返さ バイト 返す する len 取得 文字 送信 表示 オプション （ ） buf サイズ 最大 データ 長
$errormode	エラー 形式
$sigmode	署名 形式
$skip	無視 数 dba れ さ 行 飛ば レコード ます 値 / 0 デフォルト データベース する 取得 行数 結果 組み合わせ 使用 キー 何件 開始 先頭 最初 、 すか 際 読み
$input_headers	配列 する 送信 ヘッダ soap リクエスト
$to	新しく from 使用 たい 者 かわり メール 受信 送信先 メールアドレス ファイル 名
$contextname	名 コンテキスト
$stack	画像 垂直 積む 方向 か どう
$result_id	!) odbc is 結果 な リソース クエリ 有効 _exec 型 id select た れる _execute また 返さ only valid interbase 返す returned ibase あるい _query 取得 れ resultid by のみ a _prepare により type ifx 対象 処理 queries 、 なる _id or result
$bit_on	on false します ビット 値 する クリア off / 1 0 にし 設定 ます とその 、 true
$td	_module _open 述子 暗号 mcrypt 化記 返す
$bv_name	につけ た 先頭 ます コロン プレースホルダ バインド ステートメント 変数 内 使い
$qualifier	データベース いる db2 稼動 あるい / 0 3 サーバー 9 修飾子 z os て 上
$recursive	場合 もし 的 および れ 発行 無効 中身 造 ノード 宣言 いる ディレクトリ dirname 子構 許可 ある た recursive れる 空間 ます - さ targets か 再帰 返し 親 コマンド 名前 pathname う 表す 全て 配列 する コミット 作成 必要 て 指定 子 フラグ オプション true パラメータ かど list 自動 使用 追加 r 設定 処理 入れ 、 アイテム なり
$soapheaders	たい 設定 ヘッダ
imagickpixeliterator	場合 imagickpixeliterator た 画像 ます 返し 成功 セクション
$force	場合 調べ ば れ いる ディレクトリ て 管理 すで ます もし さ 下 ない い バージョン おか true 中身 ファイル 追加 、
$prefix	_invalid 場合 さい 配列 ページラベル 生成 ば プレフィックス 表す れ 辞 な prefix 注意 変数 て _exists ある _same れる 空間 ます _prefix さ id 付加 名 文字列 あるい 有用 のみ 前 インポート xml たとえ グローバルスコープ 全て 列 名前 する 作成 必要 文字 ホスト 同時 、 キー こと クラス くだ _all 接頭 よう extr 複数 使用 テンポラリファイル 参照 flags オブジェクト _if 際 使う 内 として
$new_path	リンク 変更後 先 パス
tokyotyrantquery	場合 た tokyotyrantquery 現在 ます 返し メソッド 成功 オブジェクト
$context	_context stream ストリーム コンテキストリソース 結果 サポート な マニュアル 有効 コンテキストストリームリソース diff 参照く 注意 関数 た 含める ます filename to 5 passed : 行 _create 数 作成 指定 php パラメータ コンテキスト 前後 ファイル ださい 詳細 context 、 the について
mongoid	& 0 ます 値 quot 持つ新しい 返し ; id
$components	追加 する コンポーネント フォーム 配列
$algoname	アルゴリズム 公開鍵
$minimal	非常 ます 最小 する 結果 ファイル かかり 時間 、 なり true パラメータ
$xpath	xpath 配列 絞り込む ノード ため
$hour	時 日付 た 決まる 数え month 0 「時 」 year 、 day
$bevent	な バッファ イベントリソース 有効 つき
string|array	取得 ます 現在 行 ファイル
$.p	進 続く 基準 0 ます 桁数 以降 1 p 文字 指定 数値 、 ピリオド
$stmt	_init 結果 な リソース 有効 セット lob た 含む prepare れる ます 返さ 2 返す exec あるい プリペアドステートメント db ステートメントリソース stmt _query 取得 指定 db2 mssql _ execute _prepare sqlsrv データ
$oldname	現在 名前 / ファイル 変更 ディレクトリ 注意 : 前
$system_id	た エンティティ 言 れ 指定 さ システム 用宣 systemid 4 宣言 番目 、 外部 id パラメータ 表記
$end_revision	番号 最後 たい リビジョン 取得 ログ
$min_saving	圧縮 ます 値 する 指定 率 、 際 最小
$filter	定数 情報 論理 オプション れ ん 型 nbsp 結果 用い 参照く 属性 て 簡単 こと た 含める 高度 ます ;rfc ませ 空 さ また 1 ドキュメント 4 ldap なもの 5 でき よう メソッド フィルタ 演算子 一覧 持つ あるい する フォーマット 取得 ;netscape 指定 ;& だけ 特定 たい 記述 sdk 絞り込み 利用 な raquo & 検索 に関する ださい 詳細 directory 、 について プロパティ
$rmin	赤 最小値
$error_code	エラーコード icu
$stringparam	ん 使用 さ れませ
$numprimkeys	プライマリキー 数
$dash_off	破線 形式
$cmd	のい れる する ずれ さ か 以下 実行 コマンド 処理
$fp	ファイルディスクリプタ な ファイルポインタ 有効
$fl	_alafim および _jewish 、 フォーマット _gereshayim _add な cal 使用 _geresh 可能
$blob_data	データ blob
$foreground	色 ます 前景 指定 、 でき パラメータ
quickhashintset	新しい ます 返し quickhashintset
$fd	へ つの など ストリーム ば な ソケットリソース もの 格納 ストリームリソース た れる _open 2 配列 返す たとえ 複製元 あるい 表し さ 数値 php ファイルディスクリプタ dio 記述子 ファイル 参照 、 eio 有効
$owner	者 所有
$hostname	場合 接続 ip 番号 れ サポート / いる て 可能 方式 snmp データベースサーバー fqdn レコード リモートホスト 区切り アドレス ます クライアント hostname 場所 さ また 付加 名 エージェント でき : 前 ドット 経由 あるい する ホスト ssl 探す 指定 tcp 地域 使用 こと 含める tls により インストール ポート 形式 openssl サーバー 対象 、 なる 際
$restrict	xpath こと する 特定 ます できる 制限 コール 、 使っ でき よう 関数 て パラメータ のみ
$types	リクエスト する 種類 指定 パラメータ 、 types 使用 変数 インポート 可能
scalar	場合 現在 ます な 返し 以外 有効 キー 、 null 状態
$filtername	フィルタ 名
$threshold_map	ディザリング マップ 含む する 文字列 使用 閾値
$object	場合 比べ マップ 調べ 削除 ば tidy datetime れれる ヘッダ 探し 型 キー リクエスト ます 値 ませ / 返さ 2 メソッド 名前 番目 静的 : 検査 オブジェクト 処理 _create たい ペア あるい する 取得 ない 手続き 指定 クラス 使用 date 取り除き パラメータ のみ インスタンス ん 返す プロパティ れる 含ま object 追加 実行 なけれ 、 なる なり 内 として
$colnum	番号 カラム 結果 な リソース stmt 、 セット 内 有効
$length	返り値 解凍 数 リソース 終了 書き込む 達し 読み込む 置換 返さ 終端 4 返す 正 string 配列 コピー 以降 オプション こと 含ま 時点 書き込み 場合 ソケット 削除 読み出し 起こっ 中 全 型 て subject ハンドル 改行 圧縮 ます ずれ さ か 早い stmt 文字 受信 offset 希望 可能 socket 停止 検索 length 、 データ 状態 長 圧縮前 調べる ラージオブジェクト 比較 lob 0 セグメント 値 終っ 2 バイト 後 メソッド 、( たか たい 表し 副文 取得 読み込み れ 方 字列 eof により デコード 最大 幅 bzread 検出 長さ れる - つめ 1 切り 部分 オフセット 制御 ない 前 単位 する 省略 波長 指定 た php data サイズ パラメータ のい 素単 いずれ 最後 分 達 一度 位 書記
$selectorcount	セレクタ 数
$content	検証 表す する た 内容 ます ととも 文字列 さ ファイル content 名 指定 れ 格納 書き込む 、 データ テキスト 新規
$regex	pcre オプション する 指定 表現 正規
$iterations	せる 回数 画像 さ ループ
domattr	場合 エラー た 新しい あるい 置換 返し さ そう 発生 domattr ノード れ null ます ない 、 false 属性 前
$tile_geometry	数 タイル + 0 ページ 例 行単位 6x 、 単位 4
$=f	ます 続く f = さ シングルバイト 文字 れ 使用 数値 、 埋め 後 として
$on_off	デバッグ false 無効 ます する 表し 出力 有効 、 オン true
$dbhandle	sqlite データベースリソース
$matte_color	色 あるい imagickpixel 表す 文字列 マット オブジェクト
$needle	ひとつまた 場合 番号 字列 中 整数 注意 ある ます 値 、 する 探す値 ない haystack う 見つける needle たい 変換 副文 文字 文字列 しましょ こと 見つけ 検索 複数 探し 探す 扱い 対応 として
$gmagick	する 参照 画像
$signo	シグナル する 番号 処理
$high	高い点
$storage	たい ストレージ 格納 ピクセル インポート 方式
$src_y	y 座標 コピー 元
$src_x	x コピー 元 座標
$securityprefs	新しい 設定 セキュリティ
$grp	_grp リクエストグループリソース 返す eio
$src_w	コピー 幅 元
$src_h	コピー 元 高さ
$script	たい 実行 コード 文字列
$webindex	場合 た パス ウェブブラウザ する phar アーカイブ アクセス 、 相対 内 実行
$fontfile	コレクションファイル 読み込む truetype 可 ファイル url 名 フォント ttf
quickhashinthash	新しい quickhashinthash 返し ます
$function_args	列 へ 区切り ます カンマ 引数 文字 指定 関数
$bytes_max	場合 利用 値 bytes さ _max な れ 格納 ます 可能
$modifier	ます 値 て 取得 リソース 指定 しよ とし いる 、 modifier う
$read(string $sessionid)	ませ た シリアライズ read なけれ ば さ 返さ ん セッションエンコード れ コールバック 文字列 、 なり 常
$minute	時 数え た hour 分 0 」 「分
$tdo	な 大文字 有効 型名
$name1	名前 調べる
$name0	名前 調べる
$errline	エラー た 行番 errline ます 発生 整数 号 4 格納 オプション 番目 、 パラメータ
$pieces	列 文字 たい 連結 配列
$admin_server	サーバー
$arr	場合 arr リスト れ 「線 ならべ 変数 た 違い ます さ 2 部分 番目 保存 配列 指定 長さ 空白 要素 互い 引数 「 」 代わり 、 として
$oldset	た ます シグナル リスト さ 設定 れ ブロック oldset 、 て パラメータ い
$errmsg	する エラーメッセージ れる 結果 へ 格納 ldap 参照 変数 含ま
$severity	定数 深刻 エラー 通知 stream _severity 新しい _notify ひとつ _* 度 メッセージ
$arg	ラジアン た 角度 する 表し 渡す 引数 処理 コールバック オプション 任意 各 パラメータ
$ftp_stream	リンク ftp 接続 id
$session	接続 た て 取得 2 コール ssh によっ リンク id _ connect
$auto_release	時 かど セマフォ ます 的 する 開放 か 自動 終了 指定 う リクエスト
$is_prefix	場合 ある false プレフィックス uri 、 ns true
$var_array	配列
$file_skip_empty_lines	ます 読み飛ば 空行
$start	場合 調べ ゼロ 数 中 $haystack subject 始める ある れる ます 値 置換 デフォルト 返さ start シーケンス バイト 正 数え 非負 string 角度 列 ビット する 番目 文字 指定 位置 開始 素単 始まり 内 最初 始点 、 なり 位 目以降 書記
$msg_number	番号 メッセージ
$notext	ます 変化 内容 冗長 出力 する 性 設定 パラメータ オプション 、 notext
$orientation	定数 のいずれ か 方向
$displace	カラーマップ image displace さ 移動 量 せる
$enclosure	1 する 囲み フィールド 文字 指定 オプション のみ
$convmap	変換 コード 配列 する 指定 領域 convmap 、
$line_pos	た 起点 さ 行数 移動 ゼロ せる
$signature_method	定義 署名 ます オプション する 使用 、 パラメータ 方式
$public_id	場合 パブリック 用宣 れ 宣言 外部 id た 空 さ また 言 5 ない 番目 指定 文字列 publicid パラメータ 表記 エンティティ 、
$pid	__ 場合 evchild 情報 pid :: なかっ id 統計 た 変更 ます construct 0 と同じ 現在 する 取得 指定 使用 待つ すべて プロセス 対象 、 状態
$label	追加 する ラベル
$max	場合 要素 レコード 数 サイズ コレクション 内 格納 できる 、 固定 最大
$update	条件 更新
$oauth_auth_type_authorization	渡し http ます ヘッダ パラメータ oauth authorization
$controller	名 移動先 コントローラ
$username	場合 ユーザー 接続 リモート 認証 た 新しい ます sybase 名 データベース する 表し 字 指定 、 英数 接続用 時 設定 oracle ingres 使う として
$condition	へ 行 そして フィールド cond マッチ :: table 変数 もつ ハンドル た 呼ん create 名 配列 する 取得 キー 条件 テーブル _name 対象 値に 、 なる データ
mongocollection	新しい ます コレクション 返し あらわす コレクションオブジェクト
variant	場合 返さ へ た ます variant 返し れ 他 スクリプト 中 vt さ 同様 _date 要求 、 型 com オブジェクト 実行
$variables	php javascript 中 マップ 変数 使う
$query	ひとつまた オプション 情報 つまた 論理 sql れ 検索 な マニュアル クエリ mysql query て rpn 1 ハンドル た ccl ます プリペアドクエリ さ find 文 3 interbase 9 提供 い 演算子 ibase する db algebraic 準備 文字列 aql クエリパラメータ パラメータ 可能 条件 z オリジナル _prepare language ++ クエリー 複数 使用 に関する たい 詳細 実行 次 、 について 化 mnogosearch
$document_or_id	渡し 場合 た 利用 配列 フィールド として 参照 _ あるい 、 id オブジェクト ます
$fontname	名前 フォント
$contextnode	xpath 場合 基準 する 指定 クエリ 実行 ノード オプション 、 相対 こと 可能
$user_vars	ユーザー being variables dumped user the 変数
$register_shutdown	する 登録 _shutdown register かどう か _function session _write 関数 として _close
$oauthexception	oauthexception
$class	定数 インスタンス 表す コピー もしく 含む 名前 あるい する 名 指定 メソッド クラス 文字列 ます 関数 インターフェイス オブジェクト ロード
$fdf_data	_create fdf あるい _open ドキュメントハンドル _string 、 返す
domdocumenttype	null た 新しい ます 返し 設定 domdocumenttype ノード ownerdocument
$fromlength	文字数 fetchfrom プロパティ
$base	場合 返り値 とと ため システム systemid 基本 注意 外部 て 基数 変換 数 ます 有し id 0 var : い 決め 基づい 利用 する フォーマット 取得 base 、 なり エンティティ 使用 なる 際
$variant	場合 # uts intl 6 variant _variant 0 3 2 4 _idna あるい 、 _uts オブジェクト idna _
$connection_id	接続 _connect ibase odbc interbase リンク 返す id
$number	ラジアン 変換 する あるい 値 たい フォーマット 引数 1 0 数値 処理 文字列 整数 進数
$limit	場合 数 れ リソース 全 て subject 設定 た れる ます 値 置換 さ 返さ ダンプ 5 最大 cachedump 行う パターン 各 type 正 リクエスト 部分 する string 配列 たい グループ おける 取得 ログ エントリ 指定 文字列 おい 残り 使用 含ま 要素 最後 による 制限 limit 回数 、 内
$black_point	黒 点
$ip_address	アドレス ip 形式 ホスト 標準
$uid	ユーザー id
quickhashintstringhash	新しい quickhashintstringhash 返し ます
number	進 場合 float 整数 binary 変換 た 新しい 合計 値 hex また 1 0 返し 表し base _string 成功 乗 exp ます として
$uir	ベース uri
$detail	エラー 情報 な 詳細 について 原因
$inner_bevel	幅 影 内側
$precision	データベース 精度 際 桁数 丸める ます する バインド 指定 オプション 、 変数
$str2	次 文字列
$timeout_type	のいずれ _opentimeout あるい _readtimeout _closetimeout か _writetimeout 、 imap
$str1	最初 文字列
$fdf_document	_create fdf あるい _open ドキュメントハンドル _string 、 返す
$wbmpname	変換後 へ wbmp パス ファイル
$autoindexid	インデックス とき false 無効 化 的 する 作成 フィールド な 自動 capped ます 、 でき true id _ 上
$yresolution	画像 新しい 方向 解像 y 度
$sealed_data	シール データ 済み
$gmpnumber	変換 php 数 たい 5 文字列 gmp
$rectangle	表す つの 配列 範囲 アノテーション 4 座標
$new_file	番目 2 へ パス ファイル
$old_data	最初 文字列 データ バイナリデータ 含む
$bbcode_arg_parser	_create _container 返す bbcode リソース
$tv_sec	する tv _sec および ともに 指定 タイムアウト 、 _usec パラメータ
$rename	新しい 名前 関数
$effect	定数 以下 か のい ずれ
$sessionhandler	インスタンス する た 実装 とえ sessionhandlerinterface ば sessionhandler 登録 クラス 、 セッションハンドラ として
$day	日数 表す た 数え 数字 日 範囲 末 れ month 1 0 3 指定 さ ます 、 なり 内 前月
$version	xml ある 調べる 3 バージョン 番号 feature ファイル 1 一部 ドキュメント mp 宣言 oauth 、 soap 機能
phardata	場合 た phardata 返し メソッド ます 、 成功 オブジェクト
datetimeimmutable	新しく た ます 返し 作っ オブジェクト
$sort_flags	sort 修正 により ソート 動作 オプション _flags パラメータ 可能
$n	: 割られる 数 など de フォーマット _de 件数 5 通貨 ロケール php eu1 例 国内
$extended_data	や 情報 ば れ unix 拡張 ファイル て いれ た ます さ アーカイブ する true ntfs acl 設定 といっ 、 取り出し オーナー
$i	番号 国際 小文字 整数 1 usd usa ソート 大文字 / インデックス 3 2 4 ロケール ない : 例 フォーマット （行 ） テーブル 通貨 区別
$f	たく 色 へ あるい たい 色ペア フィールド 前景 返し 参照 ない
$g	値 コンポーネント 緑
$d	a 高さ 数 降順 ソート 値 する 割る n 法 使用 乗数 として
$mutex	ハンドル へ た 呼び出し元 所有 ミューテックス create ロック 取得 mutex :: 呼ん いる て
$b	a 傾き 色 青 へ 垂直方向 数 コンポーネント 値 割る 色ペア ラジアン 掛ける 5 足す数 背景 参照 php
$c	傾き ラジアン する 文字 描画 水平方向
$a	調べ 数 幅 乗数 れる ソート 値 か 変更 昇順 5 られる する 割られる 平方数 たい 平方根 どう 計算 php b 掛け 足さ スキャン
$rpath	さい ため rpath する 指定 リターンパス 使用 て パラメータ くだ
$x	画像 数 原点 ボックス 左下角 切り取る 点 青 白い点 抽出 一番 左端 倍率 中心 矩形 オフセット あらわす ピクセル 表示 floodfill 操作 指定 範囲 する 強い 方向 緑 水平 位置 x 水平方向 た 左上 テキスト 開始 変換後 楕円 左下隅 囲む 新しい 被除数 領域 始点 座標 系 円
$y	画像 数 垂直 原点 ボックス 左下角 切り取る 点 青 ベースライン 抽出 一番 倍率 中心 矩形 オフセット あらわす ピクセル 表示 操作 指定 範囲 する 強い 方向 緑 floodfill 位置 白い点 左上 テキスト 開始 垂直方向 た 除数 変換後 楕円 左下隅 囲む 下端 新しい 領域 始点 y 座標 系 円
$w	進 フィールド 幅 ます 最小値 形式 1 0 指定 文字列 数値 、
$carry	前回 反復 ます 結果 保持 処理
$r	赤 値 コンポーネント
$s	ソート する 大文字 区別 小文字
$p	php 5
$q	任意 クエリ 検索
$status	バッファ れ ひとつ 以下 ステータスコード pcntl ある た 得 ます さ か う status 制御 正常 られ コール 、 パラメータ かど サーバー 出力 うち オンライン 際 状態 _waitpid
recursivearrayiterator	場合 ある 現在 配列 返し エントリ あるい 、 イテレータ オブジェクト ます
$csr	た _new _csr openssl 作成 csr
$^	定義 現在 ます グループ さ ない 字 化文 れ ロケール いる 使用 よう て
$gray	打ち消す 画像内 ば ん 間 1 なけれ 値 ませ か 0 各 ピクセル かどう 影 つけ 黒 ゼロ （ ） のみ なり 以外 ます 、 白 グレースケール
$preserve_keys	場合 preserve とき 完全 ます object まま 保持 _keys 数値 結果 配列 キー 、 _id true する なり
$blob_id	blob id
$opacity	透明度
$server_key	表す 値 する たり サーバー 取得 格納 キー データ
$-	場合 た れる ます 右側 文字 フィールド 追加 左詰め 指定 さ 数値 、 埋め にし すべて
$%	ます 文字 % 返し
domtext	場合 エラー た 新しい あるい domtext 発生 返し 同じ型 ノード ます 、 false
$!	列 除き ます 文字 出力 通貨 記号
$newname	新しい 名前 変更後
double	表す た 始まっ ます 現在 直近 epoch デフォルト 返し イベントループ 処理 秒数 時刻
$i5_time_fmt	書式 時刻 _iso 化機 i - fmt 構 db 国際 hh 2 5 標準 iso _
$dsn	dsn たい 開き
$comobject	ます インスタンス た れ がっ あるい のいずれ _typelib さ か タイプライブラリ 解決 規則 _load 名前 、 com て オブジェクト comobject
$plaintext	暗号化 た plaintext ます たい さ れ 格納 復号 テキスト
$maxlength	時 バインド 長 最大
$buffers	データベースバッファ 数 確保 れる さ サーバー キャッシュ 側 buffers
$vendor	ベンダー id
$blendmode	か する かどう 有効 ブレンドモード
$xdoc	_das sdo オブジェクト _document _xml
$queue	メッセージキュー リソースハンドル
$pgid	プロセスグループ id
$frameid	フレーム 2 id 3v
$wsdl	場合 null もしく モード : する 開発 uri 必要 非 中 あり 指定 ます 、 wsdl ファイル キャッシュ 注意 php
$extension	変換 拡張子 ます する アーカイブ デフォルト ファイル 変更 名 拡張 オプション モジュール 指定 後 パラメータ 、
$max_tries	場合 何回 た 返っ max _tries 結果 て か 指定 リクエスト ます 繰り返す こなかっ 最大
$stream	ファイルポインタ 調べ stream ストリーム ば な など いる ストリームリソース て た _socket オープン _client インポート たとえ たい もの する php 対象 なる 有効
$as_array	ます 返り値 配列 する なく 文字列 、 true
$client_area	含める クライアント かどう か 領域 アプリケーション
$alpha	不透 度単 アルファコンポーネント apply 0 値 レベル 1 to 2 7 contrast 角度 明度 指定 位置 開始 of 透明度 amount the 位
$lob_type	か 以下 のい ずれ
directoryiterator	ます directoryiterator 返し アイテム 現在
$pagesize	あたり ページ エントリ 数
$word	単語 調べる
$permission	これら た ます フラグ 値と 組み合わせ なり
$reqengine	リクエストエンジン たい 使い
$criteria	ひとつ 以下 1 た ます 、 か field 2 criteria とし 可能 のどれ られ 区切 文字列 キーワード のみ 空白 よう な 形式 flags 次 使用
$lowmark	低 ウォーターマーク
$new_password	新しい 、 たい 設定 パスワード
$green	値 コンポーネント 緑
$extraattribs	ため に関する 情報 ます する extraattribs 追加 設定 使用 、 csr
$depth	設定 表す た 数 階層 対象 検索 深さ depth ビット 掘り下げ 深度 ます ディレクトリ なり 最大
$scope	表す 最小値 期間 値 有効 整数 行 id ユニーク
$port（オプション）	場合 接続 ソケット リモートホスト af _inet ます する さ ポート バインド 指定 れ 、 使用 port パラメータ のみ
$destroy	破棄 解除 ロック た ミューテックス 後 する ます 、 true
$direction	_rtl のい ん fribidi あるい 値 ば ずれ _auto か のいずれ _ltr ませ なけれ 次 、 ひとつ なり
$bgd_color	色 れ 回転後 さ カバー ない 、 部分
$socket_type	ソケット af _inet 標準 tcp ファイルベース _af / ip なら 、 _unix apd
$target_frame	フレーム ます する 指定 ドキュメント 表示 、 使用 て パラメータ
$msgid2	id メッセージ 複数 形
$msgid1	id 単数 メッセージ 形
$overwrite	場合 れ 他 て あり ます さ 同 上書き ない のみ い 名前 する じ リレーション 使用 true パラメータ 既存 プロセス ファイル 、
$procedure	プロシージャ 名前
$max_recs	数 返す レコード 最大
$modify	日付 文字列 / 時刻
$cert	証明書
$reflector	エクスポート する リフレクション
$encoder	haruencoder する 指定 インスタンス オプション
$interface	名前 インターフェイス
oci-collection	時 ocicollection エラー false 新しい あるい 返し ます 、 オブジェクト
$owner_password	パスワード 者 所有
$npriorities	表す レベル 優先 数値 度 イベント
$wordspacing	空白 する 単語 比率 に対する 文字 設定 間隔
$function_code	新しい 関数 コード
$dispinterface	idispatch た インターフェイス たい 結果 もの 表示 継承 、
$amplitude	波 振幅
$fingerprint	フィンガープリントキー
$ca_info	情報 ca たい 設定
$file_ignore_new_lines	素 改行 最後 配列 各要 ませ ん 追加 文字
$error	た れ ます する 拒否 さ 指定 パッチ 、 保存 部分
$date(string)	列 返り する （例 パース 文字 ） : 値 strftime
$algorithm_directory	暗号化 algorithm ます _directory する 指定 位置 モジュール 際 使い
$httponly	場合 フラグ できる クッキー て ます 際 アクセス よう を通し http 試み する 送信 php true のみ なり 設定 、 セッションクッキー httponly
$newrdn	新しい rdn
$round	丸め方 _div gmp 説明 値 結果 引数 ださい 指定 _q 参照く 次 、 について 関数 round 可能
$x_shear	x 軸方 角度 押しつぶす 向
$ttl	期間 有効
$i5_date_sep	日付 sep i - 区切り db 文字 / _slash スラッシュ 2 5 として ます 使用 _
$actor	要素 値 ヘッダ actor 属性 soap
$thumbnail	サムネイル 本体 ます する 読み込み 指定 、 true
$mod	モジュロ
$search	pcre たい 名前 値 する 表現 探し マッチ 正規 キー apc
$whence	指示 定数 をど 位置 pos ひとつ 以下 中 ） seek pgsql ます 値 - か _end シーク 解釈 移動 バイト よう オブジェクト な あるい する ）、 _seek offset （ カレント _cur 可能 最後 先頭 目 whence 使用 なり _set
$passphrase	パスフレーズ する 保護 passphrase オプション キー 使用 こと て 可能
$servername	servername れ な 中 有効 ファイル # あり た ます さ 0 3 名 9 ; 定義 名前 interfaces 、& ある 必要 &# sql サーバー 引数 ms x
$topath	新しい へ リポジトリ パス
$paramters	呼び出し 引数
$verbose	する た 情報 識別 か 否か 区分 詳細 出力 について
$src_image	リンクリソース コピー 画像 元
$persistent	持続 接続 _persistent 論理値 かど な ます 的 する 指定 persistent さ 作成 か dbx 設定 れ 使用 、 う パラメータ
$before_needle	場合 返り値 ん 中 あらわ 関数 stristr た れる ます ませ 場所 か 返し 部分 haystack 前 する grapheme のど 登場 needle 文字 指定 含め true 列 strstr 返す _strstr 最初 箇所 、 なり
$foundonly	場合 count 達し た 情報 ます 送信 へ limit カーソル 、 スキップ 関数 制限
$...	リスト 割り れ 当て 以外 演算子 格納 比較 変数 関数 any 可能 た 含む ます 値 さ 任意 可変 渡し たい さら 配列 する 以降 渡す 別 指定 コールバック オプション パイプライン さらに 要素 な 引数 パース 追加 対象 参照 、 なる 置き換え
$dst_h	コピー 先 高さ
$spool	spool フラグ
$argument	エクスポート インスタンス する リフレクション オブジェクト
$dst_w	コピー 幅 先
$salt	ます あり た とと ため 十分 たび する 生成 必要 ハッシュ な 異 ランダム 値と 文字列 キー 、 なる salt なっ
$dst_x	x コピー 先 座標
$dst_y	y 座標 コピー 先
$algorithm	定数 する 調べ あらわす あるい たい のい ずれ か 名 暗号 文字列 mcrypt 使用 アルゴリズム _ 、
$format	月 数 日数 datetime 以外 ディレクティブ さ :: 閏年 セット 関数 日付 夏時間 説明 大文字 sunday フォーマットコード 0 4 時間 解釈 返す 理解 get 配列 する フォーマット オプション swatch こと 指定子 かと 構成 d のいずれ 適用 january l -- 設定 t h なら なり 場合 画像 日 ば インターネット 以下 中 できる 参照く て 書式 変換 た ます / 3 ドキュメント sprintf 7 い 返り値の あるい ビート 文字 ゼロ キー 希望 先頭 認識 パース s コード 次 、 として 短縮 （ unix createfromformat 桁 続く zip つき 2 レスポンス : 後 例 時 表す 用引 戻り値 sun utc b により な そう ださい いれ 進数 str 使用 規定 pack tar 形式 秒数 れ phar 指示子 個以上 スペース なっ % 反復 なけれ format - saturday 1 epoch 名前 9 完全 でき sat 順 単位 現在 用 %a 指定 文字列 date ） パラメータ a 列 _headers e 秒 i m 同じ 分 u 曜日 について
$y_shear	y 押しつぶす 軸方 角度 向
$destroy($sessionid)	場合 破棄 セッション た _regenerate れる あるい さ destroy session 実行 コールバック _destroy 、 _id true パラメータ
$oid_format	_format 値 oid による
$refnode	参照 ノード
$psdoc	ps _new ファイル postscript リソース 、 返す id
$sftp	た sftp オープン リソース 2 ssh _
$delimiters	区切り delimiters ます 単語 文字 指定 オプション 、
$repos	表す url たい リポジトリ チェックアウト 文字列 ディレクトリ 内
$raise	三次元 場合 引き上げ 値 する 効果 以外 引き下げ 指定 ゼロ 、
$param_key	キー パラメータ
domcomment	場合 エラー た 新しい あるい 発生 返し 、 domcomment false ます
$tail	か 可能 カーソル どう 追尾
$hex_string	進文 変換 たい 字列 1 6
tidynode	持っ 場合 tidynode ます 以外 返し 親 ノード いる 、 null て
$filters	ます 大きさ 小さく png ファイル
gmagickdraw	場合 た ます gmagickdraw 返し 成功 オブジェクト
$unique	unique 属性
$expiry	アイテム する 設定 有効 期限
$whitepoint	白 画像 点
$memsize	メモリ サイズ
splfixedarray	インスタンス 含む 配列 中身 返し ます splfixedarray
$extrainfo	時 意味 float linespacing 定義 配列 extrainfo インデックス 行間 描画 ます キー 型
$mimetype	コンテンツ mime タイプ
$expire	クッキー 有効 項目 期限
recursiveregexiterator	内部 場合 反復 ます 現在 な 返し エントリ イテレータ 処理 、 可能
$highmark	高 ウォーターマーク
$maximumrecordsize	単一 レコード 数 れる 値 する さ 取得 ターゲット 指定 整数 バイト 最大
$user_password	ユーザー パスワード
$newval	index た option 新しい 値 する インデックス 指定 格納 オプション
$address	場合 つに ソケット af 文字列 れ ドット ipv そこに ソケットストリーム て た 含む 区切り アドレス ます さ 1 2 4 7 ない : 保存 例 い リモートソケット 作成 限り られ 指定 区切 address （ パラメータ 表記 socket 種類 使用 _inet 別 、 際
$access_token_url	url api アクセストークン
solrobject	xml ます する サーバー solrobject 返し レスポンス 表現
$lookup_table	imagick 色ルックアップテーブル 含む オブジェクト
$bmin	青 最小値
$dbmode	データベース 記憶 用 - 選択 単語 モード sql dbmode 可能
$deferred	ない 即時 データ 読み込ま
$expiration	期限切 なる れ 時間
$iscritical	ページネーション 必須 する かどう か
$failure_callback	エラー た れる ます さ 発生 よう 指定 実行 コールバック できる 際 関数
$destination	インスタンス harudestination 送信 な 有効 メッセージ 先
$parser_mode	solrresponse インスタンス ます _doc パース parse 文書 :: solrdocument 、 内 _solr
$transfer_encoding	_encoding エンコーディング transfer 指定 ます mime 方式
integer	長さ 新しい ます 値 id 整数 返し スタック 数値 性別
$start_revision	最初 番号 たい リビジョン 取得 ログ
$crypto_strong	れ boolean もの 格納 アルゴリズム て ある た ます 値 さ か う 渡し 表す 強い おく 暗号 使っ かど 学的 、
$parser	得る へ 番号 parser れ エラーコード 終了 さ 宣言 外部 関数 xml ある た 、 デフォルト および 言 解放 法宣 pi リファレンス ハンドラ する 用 たい エンティティリファレンスハンドラ 取得 ない コール オプション エンティティ 命令 パラメータ 表記 開始 要素 カラム 最初 参照 設定 処理 使用 パーサ
$restart_syscalls	かど システムコール する 起動 か 設定 再 ます 対応 う
$disp_time	ページ 秒数 表す 表示 時間
$real_usage	取得 メモリ た ます する システム 割り当て 設定 大きさ 、 実際 true
$write	ます か た ソケット 配列 書き込み さ 監視 write られ れ ブロック 挙げ ない 、 て どう い
$props	とき 新しい 配列 プロパティ 作る 、 使う id 理論上
$time	待ち する 削除 サーバー 時間 アイテム
$intparam	ん 使用 さ れませ
$genre_id	値 1 0 4 7 整数
$operand	表す 文字列 オペランド
$file_use_include_path	探し ます include ファイル _path
$additional_parameters（オプション）	additional メール 渡す際 フラグ コマンドラインオプション 送信 プログラム _parameters 追加 として 使用 、 パラメータ 可能
$expression	xpath する たい 実行 表示 式
$addresses	アドレス 含む 文字列
$base_dn	ベース ディレクトリ dn
$variable_key	キー 変数
$write_ver	バイトコード 書き込む際 た フォーマット 使わ れ 使用 ます 以前 て い
$additional_headers	追加 する ヘッダ メール 設定 文字列
$case_insensitive	定数 する ます 大文字 指定 区別 小文字 ない 、 よう true なり
$facility	ロギング facility ます 引数 行う際 指定 、 型 メッセージ
sdo_xmldocument	場合 た _das _document _xml 返し ます sdo 成功 オブジェクト
$data_size	ます 指定 サイズ オプション
$open(string $savepath, string $sessionname)	とき コールバック れ ます セッション さ 開く クラス 、 なもの コンストラクタ よう open 実行
$radius_handle	リソース radius
$mode	ませ 返り値 ・ 情報 ストリーム フラグ および &quot 以外 さ 見なさ ディレクトリ セット レベル メモリー 振る のうち iconv 切り _buffer _x 新しい lo スペルチェッカ 大文字 _s sunday 転送 返さ 0 返し blob _i monday 8 よう システムコール 方策 varchar 7 利用 する 作成 _keytoupper 9 和 _seek オプション こと 暗号 暦 _bicubic くだ 構成 制御 のいずれ h による ifx 書き込み 引数 _rdonly mode 要する うち なる _lo 対応 _nobuffer 場合 _ififo アクセスモード 調べ 渡す値 ヘッダフィールド 番号 マスク 意味 な 動作 替え ;cfb 小文字 参照く 型 て 両 化 変換 た _keep 以下 ます _mode ずれ パーミッション また か 行 3 _append アクセス rb ; を通し _* 定義 強調 ;stream wb あるい _decode 舞い 遭遇 フレームモード ;ofb &# mime 組み合わせ だけ キー 名 _cur _keytolower _ 可能 f img 丸め & 形式 複数 _fixed _w 不正 つまり _ok ;nofb 次 、 読み or 使い 定数 バッファ さい 論理 文字列 可 _ifsock サポート _rdwr ノード 使っ 整数 _size fopen open _fl サムネイル _nearest ブロックモード 再帰 行う 値 * mkdir _mime オープン と同じ 2 書き _xxx _flags : ファイルアクセスモード 進数 時 通常 モード ビット wb6f 、& 読み込み _f 第 ひとつ true _r テキスト count 圧縮 soapserver ;ecb bbcode 内容 falloc 返す 方可 zlib ハフマン ファイル 返すか ださい r posix れる 使用 _set eio 、blob 持続 等 false _request ため 的 間 たり れ 有する ん 自動 アノテーション 一つ _ifchr 注意 ;cbc id _ifreg quot 曜日 - _recursive 1 _falloc _end 際 _ifblk 配列 ない でき フィルター 保存 soap リクエスト デフォルト カウント たい px _bilinear 現在 用 一文字 _neighbour 指定 パス mcrypt （ ） パラメータ のみ a _headers のい データ = 同じ 非 に関する られ _persistence 詳細 について _wronly
$inc	増分
$ini	パース たい ini 内容 ファイル
$extra_headers	追加 ヘッダ
$preserve_cloned_files	場合 た ます コピー ファイル 保持 失敗 修復 、
$backlog	待ち 接続 長さ 定義 ます する か 保持 backlog キュー だけ 、 どれ パラメータ 順番
$document_element_name	要素 ドキュメント 名前
$domain	プロトコルファミリー domain ソケット プロトコル れ な 有効 いる クッキー て 変換 あり ます サブ - さ 名 5 8 利用 する 必要 ドメイン 指定 使用 nis php パラメータ utf エンコード 種類 、
$attributes	&quot 列配 通常 ;mail & ます 列 quot のよう 必要 な ;cn ;sn 保持 文字 、 array 属性 ; php
$bufferlength	バッファ する 長さ 結果 想定
$node	xml 場合 たい 特定 simplexmlelement 以外 ます する 使用 全体 なく 出力 宣言 オプション サブセット ドキュメント ノード だけ パラメータ 、
$revision_no	表す 番号 値 たい リビジョン 取得 整数
$auth_type	定義 _type ます フラグ 渡す 1 次 パラメータ オプション oauth 、 方法 auth コンシューマ
$namespace	場合 所属 要素 xslt 空間 名前 する uri れ 子要 ヘッダ 素 指定 さ パラメータ ます いる 、 属性 て soap
$param_number	オフセット パラメータ
$charattr	文字 属性
$link	接続 _connect パス 名前 結果 へ クエリ シンボリックリンク ldap リンク 返す id
$record_number	インデックス レコード
$line	開始 た 行番 ヒストリ する 追加 出力 号 行
long	条件 ハンドル へ た ミューテックス ます ロック 返し 新しく 作り オプション 、 変数
$delta_x	だけ か 軸 seam 横切る x どれ
$packet_id	パケット wddx _start _packet 返す
$cluster_threshold	表す 数 れる 最小 ため 必要 な hexedra 有効 見なさ 、 ピクセル 内 パーセンテージ
$replacement	場合 れ な 中 いる て た 含む 数字 pattern 、 さ 部分 でき 行う オブジェクト もしく 配列 する 文字 られ 指定 埋め込む 文字列 でくく こと \ 含ま 列 色 要素 括弧 削除 imagick 置き換える ます 置換 のよう replacement
$scale	画像 スケール 結果 バインド 小数 変数 て 拡大 位取り scale ます 、 倍率 下 率 データベース する 桁数 指定 オプション パラメータ 点以 設定 オプションパラメータ 使用 際
$style	番号 形式
$sharpen	false increase decrease the true contrast if
$errno	場合 接続 ソケット bind 番号 存在 れ 失敗 connect 格納 整数 せる 実際 て _last とき た ます さ レベル 返し コール システムレベル 設定 返す listen および する 発生 _get 指定 オプション おい パラメータ socket エラー _error そこに システムコール 最初 posix errno 、 errstr
$extra_parameters	列 文字 配列 パラメータ あるい
$searchresult	情報 配列 検索 結果 な 詳細
$secure	場合 接続 れる セキュア ます クライアント 送信 な さ https クッキー 、 よう true のみ
$trace	__ た false :: ます construct する プロセス と同じ とき 終了 ウォッチャー evchild だけ 、 アクティブ
$headers	暗号化 た れる データ 前 れ headers 付加 さ 配列 、 ヘッダ 後
$new_mbox	新しい 名 メールボックス
$destfp	データ ファイルハンドル た エンコード 書き込む
$properties	ます 接続 削除 制御 情報 配列 プロパティ する 連想 表す 必要 ポラロイドプロパティ な 指定 詳細 オプション 、 際 パラメータ 操作
$sinkobject	必要 インスタンス sinkobject する ディスパッチ れる 名前 インターフェイス 持つ 同じ さ あり 指定 メソッド クラス ます 要求 、
$weight	おける 数 容器 ます 割り サーバー 内 重み 指定 全 プール 当てる て に対し
$walk_to_top	かどう 全て レイヤ する か な トップレベル 有効 apache 設定 変数 て に対し
$smooth_threshold	除去 ノイズ する ヒストグラム
$x_rounding	x 丸め 方向
$default_host	名 ホスト デフォルト
mongodb	新しい ます データベースオブジェクト 返し
$hue	画像 + - 1 0 色相
$fuzz	画像 あいまい 値 さ fuzz 量 あらわす
$infos	情報 する 関連 イテレータ
$category	カテゴリ
sdo_das_xml_document	場合 た _das _document _xml 返し ます sdo 成功 オブジェクト
$autoload_function	関数 解除 たい 登録 autoload
$with_cas	する cas 値 かどう か トークン 要求
$attrsonly	場合 1 型 ます たい 取得 設定 属性 のみ
$wrkstnname	接続 へ ホストデータベースサーバー _wrkstnname ます クライアント 、 - 終端 名 ポインタ する db 送信 文字 sql 2 列 _attr 使用 ヌル _info 際 ワークステーション として
$fill	表す あるい imagickpixel 色 置き換える 文字列 塗りつぶし オブジェクト
$offset(integer)	開始 する 読み込み 移動 位置 前
$file	場合 ユーザー へ バイナリパッチファイル file フルパス 書き込み リスト 単語 たとえ れ アーキクチャ 列 号 格納 コール いる ドキュメント セット ファイル 関数 て phar 調べる _bdiff とき ある fopen た パス ます 値 さ 依存 _rabdiff フォントファイル する 名 個人 上 名前 ソースファイル 可能 返す 実際 それぞれ 表す ば 現在 あるい nobody _string 必要 作成 ファイルハンドル 文字 あり 指定 オプション line php パラメータ バイナリ xdiff 開始 行番 記述子 保存 返り ディスク 形式 保存先 引数 追加 アーカイブ たい 出力 実行 元 相対 、 データベースファイル
$priority	優先度 順位 ウォッチャー レベル づける 関連 優先 度
$read_write	場合 ライトフィルターチェィン stream ストリーム れ オープンモード いる 書き出し用 て 伴う ます + デフォルト か 開か _filter _append リードフィルタチェイン フィルタ 用 あるい 読み込み a 追加 r つまり w 、
$systemid	サブセット システム 外部 id
$errstr	場合 接続 れ 失敗 格納 参照く た 説明 errno 、 さ 2 システムレベル 番目 表す 文字列 パラメータ エラーメッセージ ださい 設定 ます errstr
$opened_path	_use 場合 stream ば れ ん リソース / 実際 て た opened なけれ ませ さ オープン い path 成功 フルパス ファイル 設定 、 なり options _path
$serial	書 れる ます 番号 さ 発行 証明 指定 オプション 、 シリアル
$new	ます 接続 新しい あるい する か 指定 開く 使用 、 既存
$format(string)	た フォーマット strftime れ 同じ いる もの （ さ ） date 使用 : て 例 い
$matte	場合 false 無効 true する 有効 ます 、 マットチャネル
$image2	パレットイメージリンクリソース
$image1	イメージリンクリソース truecolor
$pkey	サブシステム 公開鍵 リソース
$streamid	チャネルストリーム 2 ssh
$new_setting	false オフ 表し ます 、 オン true
$envs	envs 配列 プログラム 渡す 環境 、 変数
$onoff	かし 場合 デバッグ false れ オートコミットステータス 自動 有効 警告 なっ あり ます さ て か 変更 ない onoff コミット する い 指定 オプション オン true パラメータ 可能 不可 使用 出力 、 なり オフ
$packet	パケット wddx
$munglist	_self 含む script _filename および request _name _uri 配列 、 php
$classname	表す 名 クラス 文字列
arrayiterator	ます 返し イテレータ arrayobject
$shadingid	ps た シェーディング 作成 _shading 事前 id
$quality	あり 圧縮 最低 ます 範囲 小さい 指定 品質 ファイル 1 0 最高 オプション 、 レベル quality 最大
$source	xml パース 圧縮 れる する rng imagick さ iv gmagick スキーマ 元 文字列 ソース 解凍 オブジェクト 含む
$html_table_options	列 &gt する 、& タグ 引数 lt オプション 文字 ; ;table
$slabid	場合 た cachedump slab する 指定 取得 ダンプ 設定 、 使用 type ます
$retval	ます 値 さ 設定 れ オプション 、 として
$column_number	番号 行 始まる ます たい カラム インデックス 0 指定 処理 数値
$second	数え た 秒 分 0 」 「秒 minute
$rendering_intent	レンダリング 画像 方向
$bz	ファイルポインタ
$pair	色 番号 前景 情報 たい 色ペア 取得 な アクティブ 背景 、 設定 として
reflectionclass	ます reflectionclass 返し オブジェクト
$pipes	ファイルポインタ た あたる パイプ 生成 さ 終端 れ 配列 php 側
$arg1	img 輝度 レベル _filter : _brightness
$definition	定義 する 配列 引数
$table-type	リスト た 区切っ テーブル カンマ 識別子 型
$process_identifier	_pgrp prio あるい _process か のいずれ 、 _user
$new_file2	番目 3 へ パス ファイル
$new_file1	番目 2 へ パス ファイル
$event_base	な 有効 イベントベースリソース
$linebreak	時 改行 出力 形式
$i5_libl	表す 解決 ライブラリ する ファイル 文字 参照 用いる 一覧 際
$azimuth	ます 定義 方向 光源
$errfile	ます エラー た 名前 文字列 errfile ファイル 発生 3 格納 オプション 番目 、 パラメータ
imagick	場合 画像 wand imagick 自身 成功 た 含む 抽出 新しい ます クリップマスク 返し メソッド シーケンス オブジェクト 現在 自分 一部 マージ 使用 true インスタンス 、 として 新規
$ang2	終了角
$layer_method	定数 のい ずれ か imagick _* :: layermethod
$trusted_password	ユーザー た する 指定 文字列 キー パスワード _user 対応 trusted
$imap_stream	ストリーム 返す imap _open
$clip_mask	imagick 含む オブジェクト クリップマスク
$cipher	定数 のい あらわす あるい 文字列 ずれ か 名 暗号 、 mcrypt アルゴリズム _
$use_include_path	場合 さい がっ ディレクティブ 探し ファイル て use た 行う 又 もし 1 0 3 2 番目 ; include オプションパラメータ ある ３ 使用 する _include 9 &# 指定 オプション たい こと true でき くだ 内容 により 検索 引数 設定 ます 、 _path
$name	プロトコル プレースホルダ 変数 関数 か シーケンスオブジェクト 替え 返さ 返し ローカル メソッド データベース 再定義 除い 名前 一致 作成 2 条件 name 並べ 参照 設定 実行 うち 調べ リスト 以下 中 できる モジュール クッキー 属性 て ハンドラ た exif ます ずれ さ 名称 番目 静的 い xslt あるい 子要 _get コール 検索 ヘッダ ノード 次 、 クロージャ 定数 ユーザー sql 拡張 もの ps 行う 値 タグ 名 ば たい コレクション 取得 要素 命令 ひとつ _parameter 内容 べき カラム セッション ださい 処理 使用 :datetime 応じ リフレクション プロファイル れ 要素名 参照く id 素 ある 集約 れる 空間 有し エクスポート soap たとえ する 指定 文字列 パラメータ のい 使う プロパティ 追加 oracle について
$open_data	場合 た データ オープン 返し ます 、 成功
$databases	素 データベース 表す url ます 各要 文字列 複数 ひとつ 指定 databases あるい
$targetpath	ディレクトリ ローカルパス チェックアウト 先
$filtertype	のい filtertype ずれ か 以下 、
$script_name	スクリプト 名
$array1_sort_order	ソート array 引数 順 先ほど
$pfmfile	pfa pfb パス する / ファイル へ 指定 オプション 、
$verifier_token	1
$inotify_instance	返す リソース _init inotify
$return	場合 結果 発行 関数 た ます _r さ 返し なく print する return たい 取得 エクスポート れ true パラメータ ハイライト 引数 設定 コード 、 使い
$tuple	配列 連想 れ 返さ パラメータ ます データ として
$close()	た コールバック デストラクタ ます さ write コール れ クラス 、 なもの close よう 後 実行
$sortfilter	キー ソート 属性 使う として
$imagetype	サムネイル 画像 れ れる ます さ 返さ タイプ 格納
$message	場合 翻訳 渡さ 記録 存在 れ 実際 メッセージ れる 説明 ます さ メール 表す たい する 送信 置く ログメッセージ ログ キュー 文字列 イベント エラーメッセージ 追加 について 本文
$first_num	最初 範囲 番号 内 ページ
$var_name	列 表す あるい 文字 名 配列 、 変数
$seed	シード する 指定 値 オプション
$pointsize	ポイント 数 テキスト
$trans_time	行う ページ 移動 処理 秒数
$code	チェック な 対象 有効 コード php 関数
$color	定数 背景 調べ 画像 オプション 番号 imagecolorallocate imagick 小数 塗りつぶし マット id 枠線 gmagickpixel た 含む ずれ 輪郭 か 背景色 浮動 チャネル オブジェクト 定義 表す する あるい 色文 たい 作成 指定 文字列 字列 色 のい 再 使う 点数
$internal_date	internaldate た ます さ 追加 設定 れ メッセージ いる 、 て パラメータ
$msglist	番号 れ nbsp メッセージ た & msglist ます ;rfc さ 0 なく 6 よう 範囲 ;& 2 記述 ただ raquo 、 示し
$vert_bar	付け られる 垂直 フォーム 関連 スクロールバー
$action	アクション 名 soap 移動先
$faultcode	エラーコード soapfault
$db2_attr_case	case せ 変換 返し 名 ずに カラム 小文字 db 文字 渡す _lower _natural 2 結果 ます 、 セット 字小 _ 大文
$extracerts	書 場合 ため ca サイン れ 証 他 証明 未認 た 含める ます さ 名 名前 する 指定 使用 記述 一連 extracerts ファイル 、 なり として
$machine	マシン 名 オプション
$invert	場合 色 ます ペイント 変更 対象 マッチ 任意 ない 、 ピクセル true
$envrion	読み込む 的 か な 設定 最終 、 として セクション
$return_var	場合 た return ます する 存在 れ 引数 書か 実行 _var 、 変数 返す コマンド ステータス
$resolver_function	callable とる 三つ 引数
$rigidity	ます 導入 seam ない バイアス 直線
$perms	パーミッション キュー
$summaryonly	か 含める 情報 れる て 配列 かどう 加え 返さ キャッシュエントリ ユーザーキャッシュ 概要 、 個々 ファイルキャッシュ
$role	5 有効 interbase 以降 のみ
$read	ソケット かどう れ 有効 いる 実際 て なっ た 終端 - さ か 言う ブロック 挙げ ない どう い read 配列 文字 られ （ 可能 記述子 でも ファイル 厳密 読み込み 、
domdocument	domdocument 新しい ます 結果 返し オブジェクト
$dbname	データベース 名
$cursor_def	する quot ます & スクロール また ホールド カーソル オプション 、 ; こと でき パラメータ
$space	空間 値 する デフォルト 変更 フォント 占める こと 可能
$sizelimit	数 ます する 取得 設定 エントリ 制限
$log_function	呼ば れる 関数 て コールバック 対応 イベント
$other_options	する 他 追加 指定 オプション こと 可能
$img_effect_replace	ます 同じ 渡す 置換 imagealphablending 使用 ピクセル true
$suffix	場合 サフィックス suffix れる ます カット たい さ 返さ 名 れ オプション ベース 、 取り除き 終わる
$list	する 形式 一覧
$oauth_auth_type_uri	ます uri 追加 パラメータ oauth リクエスト
recursivecallbackfilteriterator	ます 返し 子 recursivecallbackfilteriterator 含む
$ch	返す curl _init ハンドル
$stmtname	につける 名前 する 実行 プリペアドステートメント
$ray	弧 半径
$consumer_key	提供 する consumer key サービスプロバイダ
$cx	x 中心 座標
$cy	y 座標 中心
$x-step	際 方向 並べる パターン 水平 ピクセル 間隔 単位
$local_file	場合 する へ パス 上書き がす 存在 さ ファイル ローカルファイル れ ます （ ） でに 、
$bootstrap	_abstract _bootstrap yaf インスタンス
$xshear	x 軸方 角度 押しつぶす 向
$gc($lifetime)	内部 破棄 古い 定期 ます 的 ガベージコレクタコールバック 実行 、 セッションデータ php
$node_namespace	xml 名前 空間 ノード
$varname	こと 全て ん 名前 する ませ て 変更 あり 設定 ini オプション なわけ 使用 変数 _set 可能
$serialized	arrayiterator た シリアライズ 文字列 さ 列表 文字 現 ストレージ れ 表現 arrayobject オブジェクト もの
$intattr	整数 配列 属性
$new_data	含む バイナリデータ 2 文字列 番目 データ
$c4	場合 ます 値 colorspace 指定 さ black cmyk 設定 れ 、 成分 のみ
$matcheddn	dn 場合 へ た する 参照 マッチ 格納 あっ 、 変数 内 リクエスト
$c3	blue 場合 かと ます 値 colorspace yellow cmyk のいずれ rgb によっ 、 なり て 成分
$c1	場合 のいずれ id グレースケール ます 値 て rgb パターン スポット red 成分 によっ あるい cyan gray 色 かと colorspace cmyk 、 なり
sammessage	場合 エラー た ます 発生 返し メソッド 、 false
$crypted	暗号化 た ます れ さ 結果 格納
$is_null	か null かどう パラメータ
$note_name	記号 名前
$notation_name	xml _handler よう 示す 用 名前 フォーマット ださい エンティティ _decl 法 参照く _notation 、 前記 _set 表記
$retry_count	_count retry ます 値 - 永遠 1 再試行 デフォルト （ ）
$assoc_array	行 そして フィールド 挿入 マッチ いる table て なっ 変換 れる 値 さ 名 もつ する 配列 たい 取得 キー 内容 テーブル 削除 _name 対象 値に 、 なる データ
$intattrlength	整数 属性 数
$opened	た 閉じ 、 false true 状態 開い
$yshear	y 押しつぶす 軸方 角度 向
$mailbox	おける へ 構成 れ パス 名前 する サーバー mailbox さ 名 部分 使用 、 メールボックス ます
$haystack	needle 調べ 最後 配列 登場 する 場所 検索 最初 現れる 対象 たい 位置 文字列 全体 探す なる 行う 見つける 入力
$tightness	文字間 tightness により 空白 制御 ます 量 でき
$constant	定数 演算子 名 値
$null_as	をど rows 表現 か よう 中 sql 、 null する
$md	記述子 mqmd メッセージ
$mh	_multi 返す curl _init マルチハンドル
$extr_prefix_if_exists	場合 接頭 変数 現在 バージョン ます シンボルテーブル 生成 同じ 辞 存在 する だ のみ ない つけ て い
$ticks_per_second	た 画像 値 ticks 表し さ second per 表示 時間 せる
$ms	ミリ 秒数 待つ カーソル レスポンス
$jpeg_file_name	へ 画像 jpeg パス
$char_space	新しい 文字 間隔 ページ
$data_length	実際 長さ バッファ
$realm	定義 接続 認証 領域 ます
$categorize	ます なり 関数 渡す 返す 配列 、 よう 多次 元
$dst_image	コピー 先 リンクリソース 画像
$wordwrap	します quot & する エミュレート 設定 処理 ワードラップ 、 ; true パラメータ
$case_insensitivity	case 場合 ず ます 大文字 せ _insensitivity 区別 小文字 比較 、 true
$fetchtype	指定 型 返り値 ます
$row_b	二番目 行
$signum	シグナル 番号
$in_fd	ファイルディスクリプタ 入力元 ストリーム ソケットリソース あるい 、
simplexmliterator	要素 含む 現在 子要素 simplexmliterator 返し ます オブジェクト
$extr_if_exists	場合 シンボルテーブル 現在 ます する 存在 既 上書き のみ
$get_as_float	ます float 返す する なく 指定 microtime 文字列 、 よう true なり
$deref	時 エイリアス ます 検索 指定 扱い について
$extr_prefix_same	場合 なり た 新しい 衝突 ます につけた prefix あっ 、 変数 前
$function	調べ 名前 な マッチ 関数 て 入力 ある あり ます 既存 性 名 メソッド 配列 とし に対し 返す 指定 たい あるい する 必要 一部 コール コールバック 使用 php すべて パラメータ 可能 列 要素 odbc 文字 、 コマンドライン 有効
domelement	場合 false れ 何らか ノード null た 新しい ます さ 見つ 返し あるい 発生 クラス なかっ インスタンス エラー 要素 domelement 追加 、
$julianday	ユリウス 表す 日 値 積算 整数
$errcontext	エラー た errcontext 配列 場所 発生 指す 5 オプション 番目 、 アクティブシンボルテーブル パラメータ
$start_element_handler	_handler あり つの とる 名前 _element 必要 start 3 という ます 次 、 関数 パラメータ
$ns_prefixes	ため 空間 名前 プレフィックス ノード 配列 絞り込む
$width_height_type	_chars _type のいずれ _height _pixels term か _unit width 2 ssh あるい 、 _
$target	不透 画像 imagickpixel ターゲット シンボリックリンク て メッセージ ます 有し 変更 2 リンク あらわす pi オブジェクト い 表す する あるい たい 明度 指定 キュー 文字列 識別子 命令 パラメータ 色 第 target 削除 対象 処理 、 なる
$sequence	シーケンス ます 指定 メッセージ
$clob_handle	_create fbsql ハンドル clob _clob 返す
$pri	順位 優先 リクエスト
$referrals	照会 へ れる 配列 する 結果 文字 列 格納 参照 変数 すべ て 含ま
$is_dst	時 1 ある かどう - dst サマータイム 場合 か さ そう 時に 0 れ ます ない 、 セット 不明 パラメータ
$maxrows	行数 読み込む
$clob_data	データ clob
$hash	接続 た 作っ ます する 作成 サーバー ハッシュ 設定 実行 _hash キー 使用 password id コマンド
$number_frames	する 生成 中間 数 画像
$armor	armor ます 値 形式 渡す 以外 出力 有効 ゼロ 整数 、 関数 デフォルト
$additional_parameter	へ additional 渡す 引数 _parameter 、 mta コマンドライン
$dev	場合 新しく デバイスファイル あるい 番号 _s 指定 ファイルタイプ _ifblk 、 ます _ifchr マイナー メジャー eio 作る
$var1	変数
$y_rounding	y 丸め 方向
$preg_flags	正規 フラグ 表現
callable	場合 定義 エラー た 例外 ます 前 null さ また 発生 返し れ ハンドラ evcheck 、 名前 時 成功 オブジェクト
$font_size	大きさ フォント
$tcp_server	ip サーバー ファイル unix tcp あるい ドメインソケット など
$process_sections	得る た 含む process 多次 する 含ま れ 元 返し 名 設定 _sections 配列 ます 、 でき こと true パラメータ セクション
$warning	スロー する 警告
$comment	追加 する コメント
$accessible	なり ます する 指定 アクセス できる 、 よう true
$binmode	binary なり れる 形式 db バイナリデータ 渡す 返さ 2 まま ます 、 よう _
$val	定義 調べる 現在 ます 値 丸める パラメータ
$basenode	示す dom 対象 作る domdocument オブジェクト domnode
$parent	ブックマーク た 親と 新しい 作成 さ 事前 れ 、 なる 関数
$command	する れる たい エスケープ さ site 送信 クエリ 実行 コマンド
$cast_as	_select 場合 た stream _stream _as _for さ 以外 コール れ _cast 、 用途 がそれ
$scene	シーン 番号 画像
$locking	形式 する 設定 ロック
$field_name	フィールド 名前
$ending	デリミタ 文字列 オプション
$field_offset	場合 _field sybase 取り込ま によりまだ 次 さ フィールド ない 指定 れ オフセット ます 数値 、 い て フィールドオフセット _fetch
$options	指示 gt _quot 数 連想 フラグ _uid デフォルト :: _recursive 関数 pgsql とおり 含む 今世紀 説明 ペア _unescaped _lckglb 項目 ストリーム _basename よう 返す 内部 除く 組 配列 する 渡す わせ クラス オプション integer こと _century 含ま _unicode _error 制御 適用 = アクター _zero 引数 設定 _* _mkdir なる なり 場合 接続 sequence な できる 参照く 型 て コマンド _lckrec 変換 た エンコーディング ます クライアント ませ さ マスク か 3 _dirname _default _extension _number あるい 舞い 組合 _fraction _null 文字 組み合わせ _string _ 可能 _connect 作る 形式 _version _slashes 使え _output _filename 次 、 options として 定数 encoding 振る _pretty _object api 来世 もの 調節 _numeric _exec 名前 はじまる _check 属性 rdbxo & 閾値 値 もし インデックス json 名 _partial 書き ステートメント msg 例 _no _conv バージョン ビット コレクション _ignore 取得 _not ingres z _escape _apos 以下 文 動作 _tag ださい ビットマスク 処理 使用 _dml _on レコードロック など 紀 連結 uid stream れ ひとつ 判断 ん libxml 受け _print ; いる _async メッセージ 際 あり pathinfo uri - actor 渡せる tokyotyrant なく 5 年 一覧 9 コンストラクタ でき _boundary soap _amp ft 現在 こまれ 取る _hex 集約 指定 グローバルロック 文字列 date _opts php メールボックス パラメータ 2 _preserve 要素 同じ or 追加 _force のいずれか flags 桁 idna とり se もその
$fontid	ps _findfont する フォント 使用 、 返す id
$document_element_namespace_uri	要素 空間 名前 名 ドキュメント 部分 うち 、
$server	サーバー mysql
$elevation	ます 定義 方向 光源
$faultstring	soapfault エラーメッセージ
$image	含む インスタンス 画像 返す imagecreatetruecolor 作成 haruimage な リソース 有効 文字列 のよう 関数 データ
$old_password	旧 パスワード
$colorspace	定数 gray す 画像 色空間 pattern colorspace spot 中 か cmyk のいずれ rgb 色数 、 減ら
$mongoclientconn	データベース 接続
gmagick	場合 画像 垂直 れ 加え gmagick ノイズ 向上 シミュレート て 枠線 た 注記 ます 描か 輪郭 返し 自分 つけ 後 オブジェクト 定義 自身 反転 木炭画 均等化 成功 コメント 抽出 クリア 品質 追加 切り取っ 強調
$protocol	domain protocol ソケット プロトコル 接続 れ 字列 中 化文 通信 メッセージングサーバー た れる ます さ 上 属する する 使わ 指定 使用 特定 際 ファミリー 、 構造
$objdesc	記述子 オブジェクト mqod
$textrendering	か 見せる よう テキスト
$extr_prefix_invalid	付け 接頭 無効 ます また 辞 prefix 名 数値 変数 のみ
$function_name	表す たい 名前 する 上書き コール 文字列 名 関数 soap
$open	場合 ブックマーク た 表示 れ ます 形 さ ビューア 上 ゼロ pdf ない 、 open 開い
$gmin	最小値 緑
$encryption_key	キー 暗号 オプション
$contextengineid	コンテキスト engineid
$path_from	url ファイル 現在
$charattrlength	文字 属性 長さ バッファ
$num	数 的 番号 れ な 挿入 格納 切り取る た レコード ます さ 人為 エントリ 順番 データベース する 表し 取得 指定 要素 、
$array1_sort_flags	ソート array 引数 方法 先ほど
$x_server	アドレス x サーバー
$backup_original_files	かどう する ファイル か バックアップ 元
$compression	定数 場合 ため ば gz そして なけれ :: ん compression ます ませ ずれ か アーカイブ ない 解除 bzip あるい する 全体 のいずれか 指定 bz2 圧縮 none のい による 行わ zlib phar 行う 、 なり
$case_sensitive	定数 ・ れ ます 大文字 デフォルト 名 さ 区別 小文字 、
$new_location	新しい url エンドポイント
$beta	be 角度 gradient of 度単 midpoint will 指定 位置 終了 the where 位
$location	url 先 リクエスト
$password	場合 時 接続 ユーザー プレーンテキスト たり れ な 認証 ランダム null た パスワード 新しい ます 生成 さ エントリ 認証用 データベース 表す 省略 する 指定 文字列 キー なかっ password 暗号 接続用 化 username 設定 、 なり 使う
$column	取得 表す する 番号 始まる ます 文字列 カラム 結果 インデックス 0 リソース 名 指定 位置 あるい 、 セット 内
$glue	字列 デフォルト 空文
$socket	ソケット ば ん 事前 ソケットリソース 有効 た なけれ ませ _create あるい する 作成 送信 data socket な 記述子 _accept リモートソケット 、 なり
$add_empty	返り値 追加 ます 存在 キー ない null として
$algo	定数 パスワードアルゴリズム パスワード 表す ハッシュ アルゴリズム 使う
$face	fdfdownap fdfrolloverap および か fdfnormalap のいずれ 使用 、 可能
$left_operand	表す 文字列 左 オペランド
$pub_key_id	resource _publickey - openssl _get 返す鍵
$sem_identifier	セマフォ セマフォリソース 得 ます _get リソース られ セマフォリソースハンドル 、 _identifier sem によって 返す id
$errorcb	とき た 記述子 する 起動 発生 エラー コールバック
$map	表す マップ 並び順 文字列 nis ピクセル
$collection	データベース 除く 指す 名前 コレクション 参照 名
$wait	た やっ かどう くる か カーソル 待 せる 、 データ て さらに
$modulus	表す 法 文字列
$phonemes	長さ れる ます 返さ 文字 最大 phonemes キー 、 metaphone 制限 パラメータ
$pkcs12	ストア 認証 内容
$startterm	位置 開始 する 項目 スキャン
$cas_token	変数 た cas たれ する な 割り当て トークン 格納 アイテム 既存 値 一意
$dialect	方言 接続 関する サポート もの れる ます 値 、 クライアント さ 最高 デフォルト 時 dialect 全て sql 命令 選択 ライブラリ 実行 うち なり 位
$old_value	古い 指す 値 ユーザーキャッシュ key 変数 内
$delete_old_session	する た 古い 関連付け 削除 セッション か られ かどう
$optval	値 オプション
$maxlength(integer)	バイト 読み込む 最大 数
$recurse	かどう する か 再帰 処理 ディレクトリ
$gmagickdraw	含む レンダリング gmagickdraw する 設定 テキスト 描画 操作 オブジェクト 画像
$iterator	調べ な イテレータ 新しい 対象 アタッチ イタレータ 元 処理 カウント たい コピー 作成 クラス デタッチ 順次 追加 traversable フィルタリング 使用 なる 制限 する
$title	新しい する プロセス タイトル スレッド 使用 として
$input_parameters	要素 れる 文 配列 値 バインドパラメータ さ 同数 中 実行 sql 、 なる
recursiveiterator	parentiterator 現在 ます 返し エントリ イテレータ
$one_way	_way ませ する one 1 ん 返し 設定 メソッド 、
$new_cache_expire	場合 置換 た 期限 現在 ます 、 _cache れ 指定 さ _expire new キャッシュ 有効
$elementid	要素 id
$padding	1 _pkcs _padding _sslv あるい openssl padding 3 2 指定 _no oaep 、 _ 可能
$strict	場合 false れ な 中 in array 型 厳格 入力 か た エンコーディング ます さ アルファベット strict 3 外 4 6 番目 確認 haystack 返す 行う identical 三番目 範囲 needle 文字 base 指定 含まれる オプション true パラメータ 要素 _array _search 検出 どう 設定 探し 、
$array	初期化 調べ 存在 変数 関数 入力 数える 行う 値 連想 対象 か 名 var _array う インポート する 配列 たい キー かど 引数 取り出す 処理 ます 値として 、 なる
$rmax	赤 値 最大
$msg	バッファ た する 取得 保持 オブジェクト メッセージ
$param_val	値 パラメータ
$ns	空間 名前 プレフィックス uri あるい
$filepath	相対パス 含む パス あるい ファイル 取り出す 名 絶対 ディレクトリ
$coordinate_array	座標 配列
mongoclient	データベース ます 返し
boolean	場合 false ため かどう な boolean 失敗 マッチ 成功 せ リセット た ます 値 再計 さ ハッシュ か 返し var 表す 算 する 必要 指定 パスワード true 以外 状態 opcode algo 、 キャッシュ options として
$channeltype	定数 か のい ずれ チャネルモード な チャネル 使用 可能
$final_callback	ユーザー 集約 最後 適用 あるい する 指定 処理 コールバック 名前 、 定義 php 関数 として
$targetencoding	出力用 エンコーディング
$img_effect_normal	_effect _alphablend img 同じ
$lob_mode	か 以下 のい ずれ
$callback	時 ユーザー 各要 文字列 結果 ひとつ 終了 マッチ グループリクエスト carry 参照く 関数 て subject 素 前回 とき た $ callback ます 二つ 対象 さ イベント 名前 リクエスト 呼ば 定義 通常 一致 れ れる 配列 あるい する 取る 発生 文字 コール ウォッチャー コールバック 、 php すべて パラメータ 列 要素 適用 反復 指定 検索 受け 引数 item ださい 処理 mixed 使用 終わっ 保持 とり として
gmp	場合 false 数 割り 結果 な ランダム できる 整数 php た ます - 返し 逆 部分 ない 5 gmp 正 加算 存在 平方根 切る こと 成功 a b べき 乗 両方 、
$output_headers	れ 配列 する 書き込ま ヘッダ 指定 レスポンス ます 、 soap
$shortnames	shortnames 付け 添字 配列 中 設定 ます 、 方法 データ
$filehandle	ファイルハンドル fopen 返す 画像 書き出す
$strong	使い random エントロピー ます する / 設定 dev 、 true として
$constraints	列 複合 演算子 含む 値 比較 文字 名 、 ドメイン 拘束
$acctstr	接続 へ ・ ホストデータベースサーバー ます クライアント 、 - 終端 アカウンティング ポインタ する db 送信 ストリング 文字 sql 2 列 _attr 使用 ヌル _info 際 として _acctstr
$size	場合 数 ば iv ん フォント フォントサイズ extract 固定 size 長さ $ 新しい ます 値 ませ ずれ か 部分 項目 配列 バケツリスト 各 ピクセル 返す _type コレクション 表し 基づく トークン 指定 サイズ 最大 のい 丸める バイト なけれ 次 大きさ なり
$binary	1 バイト バイナリ guid 6
$width	場合 幅 画像 数 端末 枠 れ 明るく 格納 仮想 行 弧 枠線 サムネイル 代入 長さ レコード れる ます 値 さ 元 返さ ページ 矩形 5 4 テンプレート 6 9 パターン : 単位 変更後 する 範囲 コピー 抽出 ポイント サイズ テキスト 線 a ピクセル エリア 楕円 設定 例 切り取る 円
$charset	場合 接続 _charset 文字列 れ ひとつ のいずれ デフォルト セット iconv た ます charset さ か 3 名 mime 9 _xxx 後 データベース string する 変換 文字 指定 結果 オプション なかっ パラメータ z エンコード な fribidi 検索 使用 に関する str 、 際 使う 有効
$point_size	ポイントサイズ
$env	ため 変数 コマンド ペア 値 連想 / env 名前 でき 渡し 組 配列 する 渡す 環境 こと 対象 設定 実行 ます 、 なる
$end	end 続き 角度 ます 値 達する シーケンス 終点
$out_fd	ファイルディスクリプタ ストリーム ソケットリソース 出力先 あるい 、
$fields	データベース 列 各配 絞り込め 配列 値 オプション フォーマット おける ひとつ フィールド ます 、 記述 返す
$newnode	新しい ノード
$gmo	オプション mqgmo メッセージ get
$session_name	名 セッション
$parameter-type	定数 バインド 力両 _out 変数 許可 入力 _inout param か 2 パラメータ あるい する db 指定 方 sql php _ 入出 _in 出力 際
$qmanagername	キューマネージャ 名
$timeout	接続 へ 秒単 ソケット タイムアウト サポート connect 秒数 おら て 応答 なっ 待ち ます 値 奨 デフォルト 0 上書き 5 時間 い システムコール オブジェクト 操作 時 全て ず する 以降 秒単位 受信 指定 非推 オプション マイクロ パラメータ 際 デーモン 秒 サーバー 使用 最初 処理 timeout 、 なる ネットワーク 位
$blackpoint	黒 画像 点
$join	ませ のい ん なけれ 値 ば ずれ か 以下 なり
$recipcerts	x
$escape	ます フィールド 一文字 escape エスケープ 1 文字 指定 オプション 、 だけ のみ
$keys	フィールド 主キー 含む ペア 値 、 インデックス あるい あらわす たい 配列 する 文字 key 文字列 キー 列 削除 ファイル -value 要求 使用 として
$opt	定数 のい ます ずれ か 以下 、 なり
$short_format	か 使う どう 形式 短い
$property_value	新しい 値
$secret	対する サーバーホスト 秘密 ます 渡さ れ secret 鍵 共有 、 パラメータ
$addr	アドレス 表す ipv 4 文字列
$pub_key_ids	配列 リソース 公開鍵 id
$filename	being jpeg gd さ relaxng ディレクトリ セット saved xml 含む コマンドヒストリ 読み込も アーカイブ オープン 情報 フォントファイル 外観 データベース れる 名前 する 作成 2 書き込ま 設定 い where 有効 場合 へ 調べ 画像 dump まだ な webp 解決 ストリームリソース て コマンド た ます / filename ダンプ 3 ドキュメント 先 ; phar う 実行 あるい がここ 表示 相対 読み込む zip フルパス チェック 複数 パース 対象 コード 、 データ 調べる raw wbmp xpm & ハッシュ gif 名 rpm : 表す たい 取得 読み込み 結果 pwl png ハイライト fdf ファイル 出力 mp sqlite is れ 書き出す postscript ini シンボリックリンク いる メッセージ bzcompress 属性 パス virtual html 配列 ない 完全 保存 リクエスト スキーム 監視 指定 文字列 php パラメータ exe 指す quot uri xbm スキーマ the
$file_extensions	場合 区切り た 拡張子 現在 ます なし カンマ 引数 返し コール 一覧 、
$repos_url	表す へ 履歴 パス url たい リポジトリ 取得 文字列 アイテム 内
$degrees	度数 画像 角度 効果 渦巻 さ 回転 せる 程度
$sx	開始 矩形 座標 位置 x
$sy	y 開始 矩形 位置 座標
$retry_interval	頻度 接続 再試行 た 行う サーバー 失敗 ます 設定 際
$closure	無名 する バインド 関数
$lifetime	セッションクッキー 有効 期限
$fill_opacity	塗りつぶし 不透 明度
$pattern	表現 拡張 小文字 階層 ます 大文字 名 パターン ない 8 行う 表す 配列 する 指定 文字列 メールボックス 最大 開始 要素 プロパティ 検索 posix 区別 正規 なる
$sh	ハンドル _init _share 共有 curl 返す
$normalize_array	正規 色 化 値 ます
$sd	開始 角度
$text_leading	値 する ページ 行間 設定 隔
$readcb	とき 読み込む する 起動 コールバック データ
$entity_name	エンティティ 宣言 名前 する しよ う
$localname	とき パス パラメータ 名前 する 指定 アーカイブ ファイル 取得 名 ノード 移動先 格納 ます ローカル 属性 内 xslt
int	gt 行 ・ ふたつ リソース gd パーミッション 描画 経過 setmaxlinelen 変数 row レコード とき iterator バッチ umask ポート 返さ 0 返し 機能 項目 返す 正 内部 渡さ 圧縮後 インターレース gz 手法 のいずれか クラス fam なかっ 秒数 サポート 持っ 単 参照 設定 だっ スタック 移動後 オーナー 前進 :: 定義 色合 _into 存在 まっ イテレータ モジュール 何か 度 入力 ブックマーク _warning ます + 場所 カレンダー また ドキュメント 率 _moredata あらわす ; 列比 public 直近 送信 &# ステートメントハンドル キー カレント _nreqs _connect inotify _key 子要素 セキュリティ 形式 _version mnogosearch 最初 等しけれ パーサ すなわち _depth ユーザー なおし filepro win サイン 深さ _intrans unix api 構造体 apc 上 ベースライン to もし 遅延 チャネル _xxx たく ブロック モード ビット たい 取得 正常 与え _base _inerror 最も テキスト 追加 サーバー ファイル can 待機 _err マットチャネル 内 quickhashstringinthash フランス sqlite 無関係 ファイルサイズ 失敗 いる にいちばん 実際 いれ 位取り 収める レンダリング 連想 1 変更 エポック オフセット 共有 スロー 速度 現在 フォーマット _operand variant 発生 fd あっ pspell 時刻 成功 先頭 のみ a メモリ エラー のい 近い 最後 プロパティ st 正の 要求 等しい 常 月 書き込ん 展開後 数 ファイルストリーム _sigtimedwait 配置 セット 関数 方式 日付 style ページレイアウト 含む 説明 _desc 終端 curlm 読み込ん 修飾子 main _b _a ベクトル 添字 再帰 所有 利用 number 9 られ not 振る arrayobject 最終 lzf _select name auto odbc スクロール スレッド フォント アイテム なり 場合 エラーコード 画像 書き込ま シンボルテーブル dbplus コンポーネント year mongoid 占有 ev 記録 event ftp たら opened gmpnumber _reporting デフォルト pgsql _cmp 両者 シグナル インポート lob ディレクトリリンク _event コール 表示 行番 ++ バッファリングハンドラ 不正 コード signature 指定 垂直 snmp バイナリデータ 発行 小さけれ メモリブロック ノード _next 整数 array 革命 ソケット ジャンル 合計 インデックス 2 逆 _bad バイト ネストレベル 時 インスタンス ヒット completed needle アルファ var プロファイリングレベル 値か 相当 _dev udm _recv 色空間 以下 文 enabled 親 posix 処理 str クエリ _active ログレベル 長整 false や ため できる れ 組み込ま 他 ソケットリソース ストレージ evchild アルゴリズム null だ れる 対応 - gravity レベル 切断 前 リクエスト 付け realpath exec グループ ）、 作られ _loop ] 圧縮 pharfileinfo シーン テーブル エンコーダ シール に関する カーソル 同様 探し _id 日数 解凍 プロトコル ユリウス $string ストリーム 初期 言語 サイクル dbx 更新 有効 pcntl filename クライアントライブラリ xml _address 消去 新しく 始まり 新しい written メガバイト メソッド slob ピクセル ステータス ばその handle する db 以降 現在ログ ディスク db2 暦 含ま 一意 bytes 書き込み yperr 下側 距離 正しい _parse トランザクション 正しく _finished 接続 へ _sigwaitinfo dump カラム 仮想 ば 起こっ な 中 _failed radius result 小文字 型 て subject せ た _transaction lstat 生成 ずれ さ 非 か 3 アクセス 各色 元 い 大きな ページ タイムスタンプ プリペアドステートメント 受信 ゼロ 相対 セグメント c 大きい その幅 pdo 対象 イベントループ _api スクリプト 大きさ レンダリングモード 化 として otherwise イテレータインスタンス フォントスタイル アタッチ グラフィックスモード ファイルシステムオブジェクト 解像 号 反復 inode 警告 _connection _request lt ハッシュ オープン シーク ステートメント リンク linkinfo 大きけれ 前者 blob 表す 最適 もしく mktime ncurses コレクション 必要 ループ pdostatement 作ら 識別子 有する 変更前 高さ により そう _only 文字数 出力 error 量 property 、子プロセス eio データベースファイル 変化 署名 ip is 結果 iv decoration その月 呼出 ascii id メッセージ if descent connection data アーカイブ 部分 名前 ない でき オペランド 用 maxdb パレット oid 方向 証明書 能 行数 別 パス 収集 php 列 指し 指す 初 _idle phar ページモード the について left マップ 返り値 clob 生き 情報 フラグ そして フィールド 以外 終了 深度 mysql 主キー こと 示す 例外 成功時 回数 者 積算 パターン 祭 時間 haystack システムコール 負 オブジェクト データベース 配列 gmagickdraw 作成 値と integer 最大 insert 色 _error 制御 記述子 較関 imagick プロセス 引数 実効 t output キャッシュ 制限 未満 カウント ファイルポインタ right 格納 端末 適切 スケール _str _getpriority コマンド 変換 開始行 数字 クライアント リビジョン エントリ 現れる 後者 ピクセルメソッド づけ be あるい 舞い ステートメントリソース おける 黒 文字 位置 offset _increment 復活 _ 可能 session 登録 socket column of & 検索 優先 、 白 方法 データ 状態 長 定数 _noerr 意図 _countable image sql （ ラージオブジェクト 比較 応答 ディレクトリエントリ 通り 精度 errno 値 色機 小さい サイズ _send 見つかっ 日 forward それぞれ 、( 番号 バージョン 一行 期化 要素 true _struct scrollable アルファチャネル _or ポーリング 目的 実行 [$ 使用 出現 _ok 書き出し 幅 uid int parser pid an file におい 実装 ある fpassthru 長さ no なけれ invalid field 5 年 によっ ポインタ 現れ 単位 splfileobject stat 負の ビットフィールド 無し 監視 関連 暗号 含まれる 文字列 数値 ） 処理後 メールボックス イベント パラメータ e eof イメージ アイドル 削除 mask quickhashintset oracle 子
$extensions	た 8js 一覧 registerextension 拡張 :: v 登録
$arguments	配列 渡す 引数 歪め 関数 方式
$user_compare_function	比較 ユーザー 関数 定義
$allowable_tags	て こと ます タグ 3 2 ない 取り除き 取り除か たく 使用 する 必要 取り除く 指定 オプション 番目 でき パラメータ により 引数 オプションパラメータ 、
$genre	表す 名 ジャンル 文字列
$ok	インスタンス とき 使い mongo ます たい 送信 限り な 問い合わせ レプリカセット 、 可能 mongoclient セカンダリメンバ
$thumbnail_geometry	サムネイル gt 画像 & + 1 0 3 2 枠線 ; x 各 サイズ 例 4
$path	情報 有効 ディレクトリ セット 関数 メタデータ 新しい マウント 0 ローカル ファイルシステム local 先 bin コピー 作成 渡す 設定 インポート なる なり domain へ 調べ #! 存在 な クッキー # た ます / か 3 上 ; 元 処理 あるい &# path セッションデータ アイテム 一行目 形式 リポジトリ 対象 スクリプト 、 状態 リモート ノード 短い & perl オープン usr リンク : 例 作業 たい 必要 さ 取得 バイナリ 動作 削除 サーバー ファイル 指す 実行 配下 内 データベース や shebang れ への シンボリックリンク ドメイン ある あり 反復 開き 9 する 全て 指定 ファイルパス url パス 追加
$mode_directory	暗号化 ます _directory する 指定 mode 位置 モジュール 際 使い
$module_name	ユーザー 長さ string 名 最高 4 選ん 8 モジュール 、 バイト だ
bool	行 :: しない 変数 許可 これら とき 実装 0 返し 機能 ストリーム 解放 返す 内部 文法 string クラス なかっ それが 暗号 magic 参照 設定 quick 際 リスト 存在 まだ まっ イテレータ モジュール 何か ハンドル _quotes _ispell ます ませ また ドキュメント ロケール なもの _identifier ; public 送信 新しく 鍵 タイムアウト apache カレント だっ 子要素 形式 ヘッダ _name weakref cert パーサ 英字 _disable private 何らか boolean 格納 use 秘密 & もし たく ポインタ ビルド 正常 字 memcache _base サーバー ファイル -debug 内 tar クリア イテレーション バインド 失敗 個以上 シンボリックリンク いる _errors いれ 空や 1 変更 検証 コード 現在 省略 到達 バイナリダンプ 発生 という fd あっ 成功 せい a 進ん エラー 最後 プロパティ 等しい 常 捕捉 _init ディレクトリ 関数 日付 含め 終端 html 持っ 添字 持つ 制御 間違っ 推奨 ない られ オプション not コメント _write こと できる _free name always 非数 _enable 入れ アイテム によって 場合 画像 namespaceuri event エンコーディング _loopbreak 到着 デフォルト asp コール 表示 shm _hash 指定 ture 義 number サポート ノード 整数 のすべて うまく php 2 statement つけ 時 _del needle 一部 読み込み ingres すべて udm 開始 スカラ カラー headers protected 処理 server ストリームアルゴリズム 持続 false や 小文字 たり れ 他 ん 異 ストレージ _print _detach アルゴリズム null だ 色定 - 見つ 前 ロード たとえ object _field オン class レコード _is 応じる 追加 カーソル ブロックアルゴリズム オフ セルフテスト text 兄弟 _priority session 有効 グローバル 非 か 通過 アクティブ メソッド ファイルシステム アクセス get する すれ 静的 closure 空白 resource 書き込み かつ crc slaveokay 正しい トランザクション 正しく 接続 へ にまだ ば な result ステータスコード にもう 型 て キャッシュデータ # た さ filename スペル 3 先 元 い ゼロ _registered 受け 問題 化 として key color だけ _add キー 警告 行う オープン ステートメント リンク 進数 通常 enable 無効 表し 必要 セッション そう 出力 _set そし はすべて 的 判断 かつその など 実際 メッセージ アーカイブ 名前 9 コンストラクタ でき http 確保 シグナル 見つから 集約 _data setcookie クローン インスタンス phar 空間 プログラマ 無限 返り値 ユーザー フラグ そして フィールド 以外 サブイテレータ 終了 mysql メタデータ _buffer オブジェクト データベース 読込 平方数 配列 作成 汚染 jste 更新 行わ プロセス 引数 メール _nullable キャッシュ 大 端末 既 _sent 属性 コマンド autocommit 変換 数字 / エントリ mode 定義 あるい 文字 位置 使っ リセット 可能 なり 登録 zip チェック でも 保持 、 データ 状態 定数 デストラクタ float 単語 拡張 ラージオブジェクト おり 応答 lob val 値 タグ 見つかっ var function true 削除 実行 使用 parser ひとつ file timezone ある あり 受け入れ パス なけれ ライブラリ virtual 権限 bool に対応 取る 出来 含まれる 文字列 （ ） パラメータ 要素 とれ _gpc 子
$notification_code	定数 通知 stream _notify ひとつ _*
$op	パイプライン 二番目 演算子 評価 最初
$lob_from	lob する コピー
$lcid	識別子 影響 ます する な 有効 ロケール 文字列 比較 使用
$entire_row	ます 値 querysingle カラム 結果 最初 返し クエリ デフォルト 、 返す
$outfilename	場合 書 へ 署名 れ 証明 変数 メッセージ あり た パス outfilename ます さ pem 保存 名前 する 必要 指定 形式 ファイル 出力 、 人
$zend_extensions	ます zend 返し 拡張 モジュール のみ
$stream_filter	する 削除 ストリームフィルタ
$http_method	http httpメソッド する メソッド 利用 リクエスト
