multipart	multipart/* conversion set type encoding transfer messages invalid class content subparts base prohibited multipart mime claimed found message parameter boundary
gluinfo	interface information glu library
charset	map given illegal charset character email sets properties
protocol	indicates http protocol error
iterator	concurrently temporarily constant iterator runlist results run given :class replaced abstractruniterator creating replacing iterators filtered iterate multiple iterates default multicall iteration value range without values exceptions runiterator,
buffered	file-ish object data loaded new
violation	claimed subparts message multipart found
text	decorative simple text displayed underlines) rendering layouts textlayout (e top-level glyph scrollabletextlayout documents group displayable texture glyphs foreground elements and/or lay editing scrolling viewport scrollable g large suitable display interactive
fpsdisplay	window's framerate display
morsel	value one key pair hold class
stdmethod	return hresult com method value
tcpserver	server socket-based classes various base class
quoter	bytes mapping 0 range 256 strings (in
marshaller	python chunk params xml-rpc data generate structure
manager	framebuffers manages set context
suspend	manager acts use context like
xlib	probably exception x11-specific programming
rts	avoids refactoring namespace creating tools
albuffer	doesn't deleted detaches free source mac least x os buffers
addinfourl	file info() methods add geturl() open class
font	glyphs exception errors classification generic abstract able related produce module font typically class
layout	decorative text displayed underlines) rendering layouts textlayout (e top-level glyph scrollabletextlayout documents group texture glyphs foreground elements and/or lay editing scrolling viewport scrollable g large suitable display interactive
features	pattern contains set features generates
base64padding	incorrect encoded length base64 sequence
xmlrpcdoc	xml-rpc documentation generates server
group	decorative partial played text underlines) paused sources layouts elements textlayout top-level glyph (e scrollabletextlayout given group opengl support texture state shared glyphs rendering foreground used simultaneously sprite read data class binds none g looping default batch queue players common enables order
xmlrpcserver	specialization simple create documentation allows simplexmlrpcserver server html user xml-rpc multipath
tablet	used tablet distinct devices event cursor tablets interface high-level dispatcher
decay	envelope decaying linearly
cinstance	python instance objective-c wrapper
jar	cookies cookiejar want sequence may backup "set-cookie3" saves lines use collection warning file loaded http lwpcookiejar save saved class browser's
texture	sequence text image within rendering layouts video images loaded glyph containing group dimensions texture regions samples memory drawn glyphs textures atlases separate collection 24-bit regular grid tiled interface framebuffer efficiently presented region rectangular binds depth enables typically
platform	operating-system-level implementation abstract platform depends functionality class
window	exception errors closed application platform-independent determine class variable window _platform_event_names window-related subclass file sets print root events
py2fixer	code lib2to3 py2 py3 hook uses import translation source-to-source class
dict	insertion remembers dictionary order
location	abstract resource location filesystem
mimenon	messages multipart/* base mime type class
hooks	use acts like restores saves modules state sys manager context
atlas	within collection texture images drawn glyphs
compat32	policy + backward compatibility particular
cgixmlrpcrequest	cgi simple documentation handler passed xml-rpc data requests
darwin	:ivariables
local	context-manager like prevents py3 modules library standard source imported folder python-future local configparser
lwpcookie	lwpcookiejar saves lines "set-cookie3" sequence
logger	print events file
bin	atlases texture collection
non	non-ascii ascii-printable local_part contains range outside characters found ascii
newint	python py2 object int 3 backport
triangle	triangle generated procedurally waveform
string	rendered quickly glyphs immutable string
format	words format video details file input problem audio png
adsrenvelope	suspend decay envelope four attack part release
safe	handles transaction xml-rpc https server
multi	attribute results multipath specialization create texture method used boxcar object simplexmlrpcserver coordinate user serverproxy iterates calls multicall allows server exceptions xml-rpc ->
auth	protocol defined rfc 2069 authentication improves basic digest
base64characters	encoded alphabet base64 characters sequence
listener	listener positional audio properties
default	implements cookies used returning rules system standard cursor default operating accepting mouse
parse	errors parsing headers base error message class
grid	regions containing image texture access placed regular grid allowing easy imaginary
mozilla	cookies file may use warning want browser's save backup class
not	named resource close corresponding never search start path claimed found boundary
cominterface	dummy struct type pointers serve com
datetime	month day[, required hour[, second[, arguments year microsecond[,tzinfo]]]]]) datetime(year minute[, day
misplaced	middle header 'unix-from' block found
color	solid attribute image vertex creates color framebuffer filled secondary
secondary	color attribute secondary
htmldoc	used server generate pydoc html document class
newdict	python py2 object 3 dict backport
forking	mix-in handle process request new class
resource	found named resource search path
htmldecoder	documents string iterator. bytes header. possible octets maximum length html a.k.a. unicode decoder line element array must
header	declared continuation defect parsing header single colon blank consists message whose 'unix-from' whitespace leading valid details gives 5322 timestamp header_factory obsolete base uses registry line syntax class must none middle value rfc headers error found block first
button	control whose boolean value
list	use runs addresses contiguous within list vertices parsed rfc indexedvertexdomain addresslist values indexed vertexdomain encapsulates 2822
alobject	openal base class objects
server	point given used document uri -> html logical class pydoc connection classes [,options] base xml-rpc server generate
solid	creates solid image color filled
mode	requested exception settings could screen met resolution display indicating
email	+ provisional
scrollable	scrollabletextlayout scrollable group text rendering top-level display viewport
found	named resource close corresponding never search start path claimed found boundary
newbytes	python py2 object bytes 3 backport
domain	indexed vertex management set lists
square	waveform generated square procedurally pulse
mimeapplication	mime generating documents application/* class
tileable	tiled texture efficiently
sequence	textures dimensions sequence abstract interface images
bytes	feedparser decoded accepts generates tree could object bytes results decoding header contained version str message standard approach parsed feed like
frame	single animation frame
simple	mix-in head http get simple supports strings request commands class values handler simplecookie cookie requests server dispatches xml-rpc setting
request	wfile stream handler self request sockets datagram classes rfile base class define
pulse	stream object pulseaudio server connection asynchronous basic operation audio
relative	whose represents value relative previous change axis
streaming	source played queued decoded
video	video details
coord	coordinate attribute fog texture
close	close start boundary corresponding found
operation	operation asynchronous pulseaudio
generator	representation generates tree object bytes server version text output message xml-rpc documentation
event	raised abstract depends file event platform generic class application handler print main events run buffer interface data dispatcher exception could attached implementation audio loop
mimeimage	generating documents image/* mime type class
glyph	quickly within creating abstract larger texture immutable located single rendered images drawn glyphs class string glyph
canvas	canvas dispatcher opengl abstract area event tablets particular configuration drawing
gdk	gdkpixbuf gdkpixbufloader around object wrapper animation gdkpixbufiter
sub	file-ish object data loaded new
clock	scheduled functions calculating display clock framerate calling current values fps limiting class
pattern	solid abstract creation class creates color checker create tileable image filled
unmarshaller	xml based data end messages event start incoming xml-rpc unmarshal response
exclude	context-manager like prevents py3 modules library standard source imported folder python-future local configparser
uniform	interface textures dimensions sequence
content	set encoding transfer invalid content multipart
printable	ascii-printable range outside characters found ascii
state	simple state keys tracks handler keyboard
fog	coordinate attribute fog
absolute	whose represents value measurement device axis physical
mimetext	generating documents text/* mime type class
newobject	methods python object magical compatibility next 2 provides : class
reader	python pure png decoder
invariant	claimed subparts message multipart found
boundary	corresponding never find start terminating multipart couldn't close claimed found boundary parameter message
cbound	represents bound method imp objective-c passed parameter id first
metaclass	_platform_event_names pointers subclass creates variable window sets interface com class
method	represents parameter bound id imp objective-c passed com method first
element	within positioned formatted element arbitrary inline document
body	whitespace leading colon blank found line
foreground	decorative foreground elements group g text underlines) rendering layouts glyphs glyph (e
noise	random waveform white noise
required	header none value must
linear	envelope decaying linearly
addclosehook	hook add file close open class
missing	none whitespace leading value header colon blank found line must
newlist	python py2 object list 3 backport
screen	fullscreen exception monitor requested settings windows resolution screen virtual met could supports display indicating
weak	referenced set objects weakly
free	freetype object typographic face
binary	binary data wrapper
glinfo	interface information single gl context
olddict	python py2 object 3 dict backport
compressed	driver representing image uploading direct compressed suitable data
key	simple state keys tracks handler keyboard
address	addresses list rfc addresslist encapsulates parsed 2822
interface	creates interface pointers com
udpserver	udp class server
sine	waveform generated procedurally sinusoid
dispatcher	generic interface event dispatcher
formatted	simple text maintains implementation formatting document
obj	represents use create unbound instance python class bound wrapper id existing imp objective-c subclass passed first parameter method really
socket	adding sockets socket stream implementation _socket subclass makefile() i/o raw method
thread	cleanly provides exits interrupted thread sleep shutdown termination interpreter method
policy	implements cookies returned get server + object messages formatted controls interpreted framework rules basic policy accepting returning accepted provisional standard defines
fault	indicates xml-rpc package fault
region	elements presented buffer vertex region separate vbo texture rectangular necessarily mapped array data contiguous
tremolo	modulation tremolo envelope amplitude
label	plain base text class label
datagram	wfile self datagram rfile sockets define
range	range :class iterator
base	set methods parser parsers result message element parsed xhtml containing container support application window handler provides basic policy shared sgml/html platform-independent used http netloc framework objects base class morsels request object server headers classes common
separator	whitespace leading colon blank found line
context	opengl object pulseaudio server connection context basic drawing
unformatted	text style document uniform
cookie	cookies set want cookiejar warning file loaded saved defines use container returning may setting save supports http returned get rules collection standard simplecookie browser's accepting accepted class implements morsels server values cookie backup strings
processor	process http responses error
silence	waveform silent
first	continuation message header line first
feed	feed like bytes parser accepts feedparser feed-style email
addrlist	parser ben class escoto address
writer	python pure png encoder
apple	interface control high-level remote apple
mimemessage	documents mime message/* representing class
encoding	set encoding transfer invalid content multipart
csubclass	use create subclass existing objective-c class
continuation	continuation message header line first
image	sequence color uploading abstract creation direct cursor single images tileable bit access stencil data create :class unsigned imaginary checker easy image filled string buffer object driver regular grid compressed represented framebuffer representing class png created solid bytes user-defined creates placed depth regions mouse suitable allowing
rename	hooks py2 py3 mapping module etc names equivalents import class
addbase	addinfo base class addclosehook
fancy	errors handle handlers perhaps derived class
loader	load files resource around object wrapper program gdkpixbufloader disk
decoration	decorative elements group g underlines) rendering glyph (e
date	whose string integer header 'datetime timestamp 8601 value datetime concrete single iso wrapper consists time date tuple type generate localtime
set	referenced set objects weakly
asciilocal	local_part non-ascii contains characters
renderer	images abstract glyph class creating
path	specialization create allows simplexmlrpcserver server user xml-rpc multipath
import	hooks py2 py3 mapping module etc names equivalents import class
array	elements implementation region vertex necessarily ctypes mapped array data contiguous
open	player buffers doesn't needs 0 least 1 source version deleted free openal mac objects interpolate device class detaches compatible base x audio os
caret	marker visible pyglet insertion text
basestring	basestring python py3 2 backport type minimal
player10	1 needs 0 interpolate compatible player openal version
silent	buffer audio packets silent
xmlrpcrequest	simple documentation request handler xml-rpc class
source	helper played defined waveforms video information use and/or staticsource implementation support source memory metadata decoded read completely base looping data class sources default procedurally generated queue audio queued
transfer	set encoding transfer invalid content multipart
mimeaudio	generating documents mime class audio/*
readable	simple interface arrays strings file-like
newstr	python py2 object 3 backport str
decode	text document decoding occurred error
start	claimed start boundary never found
checker	create checker tileable image
handler	wfile stream defined determine keyboard protocol sockets digest datagram improves self state simple authentication handler passed basic closed define cgi head http complete get keys tracks base window post data class commands documentation request server rfc 2069 classes rfile requests xml-rpc
call	iterates used calls boxcar multicall object results server exceptions -> serverproxy method
memory	fulfil allocation use staticsource helper default large implementation enough buffer class
white	random waveform white noise
type	freetype object typographic face
is	continuation message header line first
const	constant creating runlist value without iterate
flat	flat envelope setting amplitude basic providing
zip	iterators iterate run multiple concurrently
sprite	group sprite instance image on-screen shared rendering
sawtooth	waveform generated procedurally sawtooth
xmlrpcdispatcher	mix-in requests xml-rpc dispatches class
envelope	flat 'unix-from' tremolo envelopes decaying middle modulation setting envelope proceduralsource header base block amplitude basic found providing class linearly
defect	alphabet declared set encoding continuation defect syntax header colon multipart blank claimed close message range ascii incorrect 'unix-from' whitespace leading base64 outside invalid content start contained valid details boundary parameter gives decoded non-ascii corresponding 5322 ascii-printable contains never sequence obsolete base uses characters subparts encoded line class local_part middle could bytes rfc length transfer found block first
tzinfo	info zone abstract base time classes class
flag	attribute flag edge
part	local_part non-ascii contains characters
ftpwrapper	ftp used cache connections open_ftp() open class
httprequest	head http get simple request commands handler base class
line	" "disallow (allowance==true) continuation rule (allowance==false) header single path followed line first message "allow
buf	gdkpixbuf gdkpixbufloader around object wrapper animation gdkpixbufiter
message	errors package object defect email base basic message parsing class
info	information truetype face source single metadata
tex	coordinate attribute texture
exception	fulfil named programming image raised related font mouse event allocator size errors space generic decoding enough handler window-related resolution text probably document screen indicating available requested buffer sufficient exception free occurred allocation met x11-specific module path configuration cursor-related search resource root could attached large error found typically display
oldstr	py3 string python object 2 forward 8-bit port
truetype	truetype information single face
undecodable	header contained bytes could decoded
alaudio	1 needs 0 interpolate compatible player openal version
batch	manage vertex lists rendering batched collection
value	header none value must
cursor	exception used tablet created distinct mouse abstract system user-defined cursor default errors operating root image cursor-related
commethod	interface binds com method
decoder	abstract document decoder
mimemultipart	messages multipart/* base mime type class
time	string zone tuple 'datetime 8601 wrapper datetime iso value time integer generate localtime
str	encoding bytes results standard str approach parsed
error	raised protocol file parsing parse indicates multipart couldn't message find conversion errors illegal charset response terminating input boundary email http format given broken base prohibited words class png exception package headers client error problem
static	decoded use staticsource helper default source completely memory implementation class
display	available supporting exception requested clock screens one current values fps device display indicating
loop	run application implementation abstract platform depends main class loop
procedural	defined procedurally waveforms generated base class
control	device input single value provided
newrange	cpython see python 3's object pure-python range backport
htmllabel	text html formatted label
cmethod	represents unbound imp objective-c method really
ordered	partial dictionary remembers insertion group order
io	i/o raw sockets stream implementation
stream	wfile stream self pulseaudio rfile audio sockets define
decoded	rfc described generates text 1952 object method decode encoded gzip representation message response file-like
attribute	vector normal buffer attribute abstract programs vertex shader texture color flag edge used fog mapped coordinate generic accessor secondary
abstract	sequence attribute abstract pyglet images properties representing runlist accessor positional text document image used buffer driver listener base interface byte data class region iteration players range classes mapped audio
parser	feed set methods bytes parser parse single parsers questions xhtml support feedparser provides answer sgml/html email used read robots base class like accepts common feed-style
incremental	suitable text displayed large and/or editing scrolling documents interactive
htmlparse	parse exception errors raised
pix	gdkpixbuf gdkpixbufloader around object wrapper animation gdkpixbufiter
player	sound audio group refilling thread players driver played worker paused player base video simultaneously high-level class
proxy	given point uri logical server connection [,options] xml-rpc ->
exit	window closed determine
httperror	raised http responses process acts non-error also error return occurs like
file	file set cookiejar methods read saved questions object robots parse file-ish single location provides filesystem answer new data class loaded
in	mix-in handle thread process request multipart boundary claimed new message parameter class
cgihttprequest	head http complete get commands server post
addinfo	info() method add file open class
null	given used group default none batch class
mouse	exception errors created default root abstract system user-defined cursor used operating mouse image cursor-related
indirect	necessarily region elements mapped data contiguous
allocator	fulfil requested algorithm space buffer large sufficient area free rectangular allocation implementation enough image allocator size
urllocation	location network
result	containing methods encoding netloc bytes results standard objects result str element shared decoding approach parsed
mix	mix-in handle thread process request new class
conversion	conversion prohibited multipart
threading	mix-in handle thread request new class
generic	used programs generic attribute vertex shader
digitar	guitar-like generated procedurally waveform
netloc	containing methods netloc element objects result shared parsed
feature	version python pattern feature minimum x 2 name
invalid	incorrect set details encoding transfer base64 sequence invalid content header length valid multipart characters alphabet encoded message gives
newopen	python wrapper open() 3 part key interface providing
imports	context-manager like prevents py3 modules library standard source imported folder python-future local configparser
instance	interface binds com method
run	concurrently temporarily constant iterator list contiguous run given runlist replaced abstractruniterator creating replacing iterators filtered iterate multiple runs default iteration value range without values runiterator,
animation	information sequence frame wrapper timing single animation gdkpixbufiter images
transport	transaction http server handles https xml-rpc
overridden	given temporarily iterator replacing value range runiterator,
cclass	python objective-c class wrapper
indexed	management list within vertex vertices lists indexedvertexdomain set indexed
filtered	abstractruniterator default replaced value values filtered iterate
axis	whose physical represents value relative measurement device previous change axis
config	available requested exception opengl graphics canvas particular configuration indicating
newmemoryview	pretty lame python 3 2 backport 7 x
ziplocation	file within location zip
timedelta	represent difference two objects datetime
normal	attribute vector normal
buffer	set color vbo abstract framebuffer single manages lightweight byte stencil silent opengl events store buffer framebuffers backed bit data region packets system-memory depth context mapped representation audio
worker	players worker refilling thread
class	parser ben class escoto address
object	opengl region mapped vbo system-memory lightweight backed representation store
vertex	set attribute within lightweight vertexdomain array use management opengl implementation indexedvertexdomain indexed store vertex lists ctypes backed region list vertices system-memory vbo mapped coordinate representation
obsolete	declared obsolete syntax rfc header uses 5322
httpdigest	protocol defined rfc 2069 authentication improves basic digest
urlopener	errors handle handlers perhaps derived urls open class
registry	header registry header_factory
mixin	containing methods encoding netloc bytes results standard objects result str element shared decoding approach parsed
response	rfc described package object method decode indicates 1952 gzip encoded broken response file-like
device	device input
such	available requested exception could screen met configuration resolution display indicating
mimebase	base mime class specializations
data	suitable string driver representing image bytes unsigned packet direct single compressed represented audio data uploading
fm	waveform generated procedurally fm
pool	doesn't deleted detaches free source mac least x os buffers
aldevice	device openal audio
no	available requested exception resolution screen display met could multipart claimed message configuration parameter boundary indicating
remote	interface control high-level remote apple
hiddevice	:ivariables
doc	handler documentation request server html passed requests xml-rpc data class
mappable	system-memory backed vbo store
counter	hashable sometimes subclass bag objects dict counting called
mask	buffer single stencil bit
robot	set methods read questions robots parse single provides answer class
rule	" "disallow (allowance==true) rule (allowance==false) single path followed line "allow
face	freetype object typographic face
folder	context-manager like prevents py3 modules library standard source imported folder python-future local configparser
depth	buffer depth texture 24-bit samples typically
edge	attribute flag edge
htmlparser	functions tags markup handler call find
texture3d	image slice texture one
media	cleanly provides exits interrupted thread sleep shutdown termination interpreter method
gzip	rfc described object method decode 1952 gzip encoded response file-like
entry	classification rulelines one zero user-agents entry font
joystick	high-level devices includes interface analogue joystick-like
audio	silent stream buffer packets object driver connection packet pulseaudio players single base server details basic asynchronous operation audio data class
inline	within positioned formatted element arbitrary inline document
document	classes formatting style used maintains simple text abstract decoder uniform occurred decoding implementation base label error interface document class pyglet
