rom	(radius filter 2 catmull-rom 0) =
chain	glsl function functions code generates sequence may performs list independently subclass called call composed basetransform order transformations
nlocator	locations intervals nice select n
text	glsl insert parameters plain visual displays text inline
glproxy	api 0 2 proxy base gl subclasses class es
manager	different reuse helper pyos_inputhook create manage possible texturefont instances gui toolkits
vispy	optionally prepends stream caller two recording handler allowing useful additions formatter optional matching
emulated3d	parameters two texture three dimensional emulating
font	given set name parameters create gather texturefont font possible relative instances helper reuse glyphs size
hook	doesn't different toolkits anything implementation pyos_inputhook gui manage vispy specific inputhook 3 base hooks need loaded ipython x null class input
isosurface	scalar array displays isosurface 3d
bunch	datasets container dictionnary-like keys object exposes attributes
clipper	clips output visual region rectangular
group	<vispy set emittergroup manage :class related instances eventemitters
scrolling	strips end option many vertex equal one length add displays new line data lines
cache	managing cache chaintransforms class utility
texture	represent set three dimensional scalar topological font size given emulating group parameters two texture regions glyphs used multiple larger data relative name gather values small
console	text failsafe console parameters fast
simple	datasets container dictionnary-like keys object exposes attributes
program	function basis api object attached shader collection instances single program shaders emulates modularprogram using linked modularprograms
dict	insertion remembers dictionary order
fig	create parameters window figure
blocker	represents used eventemitter manager (i context block
sttransform	order translate performing transform scale
input	doesn't different toolkits anything implementation pyos_inputhook gui manage vispy specific inputhook 3 base hooks need loaded ipython x null class input
main	function functions code multiple string api defined variables allows subclass gl 0 single 2 proxy main es
rectangle	rounded parameters corners 2d displays optional rectangle
fly	fly style interaction flight provides simulator explore camera way resembles using data 3d
cube	cuboid visual cube displays parameters
texture2d	dimensional parameters two texture
magnify	panzoomcamera magnifytransform transform lens implementing camera combined magnifying
format	file format words input problem png
grid	spaced divide widget surface displays size x scale area system coordinates internal widgets cartesian across regularly draw mesh grid proportionally child lines sets coordinate position z automatically
knot	representation torus link knot
compound	sub-visuals visual entirely consisting
camera	point simulator perspective orthographic mouse around style magnifytransform cameras camera combined way 3d panzoomcamera supporting flight provides arcballcamera orbits implementing explore base using data class maintaining fly turntablecamera interaction center pan/zoom 2d resembles view projections
shading	shading material phong reflection
ticker	parameters tick class determine marks
spline16	(radius filter 2 0) = spline16
compiler	function glsl convert used code instances ready-to-use variable compiler
rotate	origin cos matrix 0], equivalent effect system rotating 0 -sin coordinate rotation [cos sin
bar	generating command-line parameters widget subclass actually colorbar visual renders containing progressbar displaying class
qt	canvas stuff qt opengl inside widget vispy containing convenience base functionality embedding scenecanvas qwidget class backend
level	temporarily logging parameters level manager context sets
fruchterman	fruchterman-reingold implementation adapted networkx
list	strongly represents statements anything whose typed arraylist list interpreted data numpy type
zoom	interaction parameters pan-zoom pan/zoom transform 2d implementing camera mouse
item	represent object created within collection specific item accessing demand
texture1d	dimensional parameters texture one
arrow	draw end arrow arrowvisual shapes also visual arrowheadvisual put heads line several optional special
debug	2 debugging visualize api process triangulation 0 version proxy es debug aid gl stepwise
x	[1 angle matrix x-axis skew effect coordinates transformation 1 0 0], skewing x along equivalent tan
mouse	represents attribute object occurred class note scenecanvas input mouse event
dir	used creating temp testing modules designed auto-destroying class dir
view	widget rendered provides databuffer subscene sub-region instance visual base another rectangular class view
dummy	dummy process activated processed gl backend
frame	buffer frame object
globject	generic represents gl object gpu
vis	implementation vispy inputhook 3 loaded ipython x
gaussian	gaussian (radius filter 2 0) =
module	lazy loading urllib_error urllib_request namespace create six moved urllib_robotparser urllib python 3 objects urllib_response resembles urllib_parse moves
hanning	filter (radius hanning 1 0) =
turntable	center point view orbits camera 3d class maintaining around
meta	submodules six importer meta import path moves
husl	hue spaced colormap space defined n points husl evenly
kaiser	1 kaiser (radius filter 0) =
bicubic	(radius filter 2 bicubic 0) =
cat	(radius filter 2 catmull-rom 0) =
contour	lines draw grid across surface
colormap	control [0 colormap defining 1] colors --> rgba_color scheme \in several representing class interpolation
bilinear	bilinear 1 (radius filter 0) =
index	buffer index data parameters
canvas	context basecanvasbackend(vispy_canvas context_type) abstract fake scene wxpython pyglet scenecanvas contents backend canvas draws parameters opengl allow vispy backends functionality provides without events widget qwidget gloo containing template base shown interface using class osmesa qt emit inside sdl2 element capability convenience stuff glfw embedding egl representation app gui automatically
scale	sy matrix equivalent 0] scaling 0 x one [sx unit
matrix	affine transformation parameters class
tube	piecewise-linear path tube displays around
markers	marker symbols visual displaying
label	widget parameters label
importer	submodules six importer meta import path moves
reader	python pure png decoder
progress	generating parameters class command-line progressbar
formatter	optionally formatter prepends caller
bessel	bessel (radius 2383) filter 3 =
base3drotation	turntablecamera base class arcballcamera
mesh	storing cartesian parameters coordinates visual mesh operating displays x grid z data class 3d
core	colorbar visual renders subclass actually
widget	pixel colorbar widget takes parameters space intended use containing rectangular 2d frame coordinate facilitate plotting axis
linear	vertical region 2d infinite plots horizontal
enum	integer enum meaningfull repr
component	draw reflection material lines surface phong grid shading across
hsl	spaced colormap space defined n color points circular evenly
modular	function basis shader instances program shaders using
quaternion	normalize=true) convenient z=0 x=0 mathematically y=0 quaternion way quaternion(w=1
base	glsl represent --> set 0 basecanvasbackend(vispy_canvas visuals series abstract topological 1] interface scalar parsers superclass part gl es defines queue functions baseapplicationbackend() fit opengl gloo texture oriented application backends functionality provides hooks basetransform backend used colormap complementary python camera object mapping glir visual base proxy values canvas pair 2 \in representing class input [0 qt context_type) api attached basetimerbackend(vispy_timer) timer capability stuff rgba_color toolkits specific coordinate subclasses clas view
proxy	dummy process main version api processed activated 0 2 proxy debug gl es backend
key	represent certain object class note key attribute input event identity
spline36	(radius filter 3 spline36 0) =
path	paths submodules antigrain accurate six collection caps geometry importer meta antialiased fast provides import path moves miter
picking	used color filter visuals picking id
emitter	<vispy used set emittergroup deprecated message manage list eventemitter events :class callbacks warning subclass allow eventemitters encapsulates instances event related
rect	area system rectangular 2d coordinate representation
box	box widget rendered subscene rectangular visual displays provides
obj	represents unbound imp objective-c method really
items	lazy loading moved objects
region	vertical region 2d infinite plots horizontal
shader	glsl program functions objects fragment wrapping variables vertex may api shaders emulates mainfunction included expressions base class multiprogram
timer	used parameters schedule backends abstract basetimerbackend(vispy_timer) timer class future provides interface repeating events
filter	used color filter visuals picking id
plane	visual plane displays
context	osmesa context around wrapper destroy
graph	graphs visual displaying networks
glcontext	necessary parameters opengl object context encapsulating data
expression	glsl insert plain (shaderobjects base text inline expressions class
maker	given ability create object functions signature
fake	canvas gloo app vispy without allow fake using
writer	python pure png encoder
render	stencil render format buffer object color depth base class
point	raw point antigrain fast geometry points collection provides
color	widget containing parameters color visual colors subclass actually colorbar single renders array displaying
hermite	1 hermite (radius filter 0) =
image	comparison graphical image object :class tests subclass visual interface auditing displaying create png
scene	certain scene subclass scenecanvas marker mouse event contents canvas draws parameters vispy qwidget node parent occurred class scenegraph represents branches inside serves convenience embedding automatically
system	information draw coordinate needed visual systems transformsystem encapsulates
variable	variable representation global shader parameters
raises	test exception raising class helper
lanczos	(radius filter 4 lanczos 0) =
ordered	insertion remembers dictionary order
array	strongly whose anything parameters typed arraylist list interpreted colors data numpy array type
ellipse	2d displays parameters ellipse
robotparser	lazy loading six moved urllib_robotparser objects moves
backend	basecanvasbackend(vispy_canvas context_type) abstract wxpython pyglet backend canvas baseapplicationbackend() opengl application backends functionality template events provides shown base interface class osmesa qt sdl2 basetimerbackend(vispy_timer) timer capability stuff glfw egl emit
plot	plot widget facilitate parameters optional surface visual regular grid displays x line displaying plotting markers
use	temporarily logging parameters level manager context sets
log	temporarily logging parameters perfoming level axes three transform manager context sets transformation logarithmic
segment	raw antigrain (& accurate collection caps geometry ugly) antialiased fast provides line segment segments
skew	[1 angle matrix x-axis skew y-axis effect coordinates transformation 1 0 0], skewing x along equivalent tan
py	implementation vispy inputhook 3 loaded ipython x
readable	simple interface arrays strings file-like
transform	glsl chaintransforms perfoming sequence defined three subclass magnifying utility affine functions transformations parameters needed managing cache transform coordinates maps identity performs theta encapsulates defines = transformation python systems polar draw complementary r*cos effect mapping lens transformsystem visual base axes definitions pair provided class logarithmic applied pan-zoom list information r basetransform coordinate x z order
fast	paths antigrain accurate collection caps geometry antialiased fast provides path miter
sinc	(radius filter 4 0) = sinc
spectrogram	spectrogram calculate parameters show
handler	useful stream two recording handler allowing additions optional matching
call	function essentially container call signature representation along
osmesa	osmesa context around wrapper destroy
statement	represents list statements
translate	distances [1 matrix tx ty respectively equivalent coordinates 1 0 x translation translate ty],
function	glsl composed ability code defined list variables single re-using generates functions container create composing subclass call function used multiple string may object independently objects along given class essentially allows called signature representation order
hue	hue given colormap defined value solely
head	end shapes arrowheadvisual put line several
tester	comparison graphical image tests interface auditing
moved	lazy loading moved objects
blackman	(radius filter 4 blackman 0) =
histogram	parameters histogram visual displays data calculates
volume	volume displays parameters 3d
atlas	multiple larger texture regions small group data
visual	rounded show cuboid sub-visuals symbols scalar subclass spaced displaying networks isosurface calculate parameters also coordinates actually add program text rectangle regularly cube around views grid drawn using tri corners arrowvisual 2d arrow x entirely view visuals displays special pixel-width shapes scale tube axes markers arrowheadvisual shared consisting 3d vertical base put plots optional box many region shader length plane simple image one another path marker array ellipse plot cartesian heads contains system spectrogram borders option histogram volume visual line levels colorbar renders indicating z display superclass isocurve orientation surface equal sphere single axis different end polygon instance new several draw strips vertex mesh regular infinite horizontal data class isocurves piecewise-linear lines vertices graphs coordinate calculates
varying	dtype varyings inherit allowing another varying variable representation
line	plot parameters vertical optional markers 2d visual infinite plots line displaying horizontal
resize	attribute object class note input event resize
reingold	fruchterman-reingold implementation adapted networkx
arcball	center point view orbits camera 3d class maintaining around
multi	fragment vertex wrapping collection single api shaders emulates mainfunction modularprogram modularprograms multiprogram
temp	used creating temp testing modules designed auto-destroying class dir
raw	point (& segments fast raw points collection provides line segment ugly)
profiler	directed simple time profiler intervals hierarchical allowing measurement
error	lazy loading file format six moved objects words input problem moves urllib_error png
mitchell	mitchell-netravali (radius filter 2 0) =
anchor	node scene transform system parts coordinate derives anchor
perspective	projections supporting cameras base perspective orthographic class 3d
nearest	nearest (radius filter 0 5) = (=none)
cmethod	represents unbound imp objective-c method really
isocurve	2d scalar array isocurve displays
stream	useful stream two recording handler allowing additions optional matching
transformable	transformable element svg
request	lazy loading urllib_request six moved objects moves
parser	queue commands gloo attached class glir base interpreting using gl parsers clas
share	available commands actual views becomes queues contains execute glir visual context collected shared data class
surface	plot parameters surface regular grid displays x
urllib	lazy loading urllib_error urllib_request namespace create six moved urllib_robotparser urllib python 3 objects urllib_response resembles urllib_parse moves
parse	lazy loading six moved objects urllib_parse moves
sphere	sphere visual displays parameters
single	hue given colormap defined value solely
warning	used deprecated subclass warning eventemitter allow message events
null	doesn't anything transform coordinates effect need inputhook null identity
border	pixel-width subclass 2d visual borders display
axis	visual containing widget parameters axis
queue	available queue commands object actual becomes queues contains attached execute one glir instance context collected representation class
functions	functions fit gloo series object oriented part provides gl class
moves	lazy loading urllib_error urllib_request namespace create six moved urllib_robotparser urllib python 3 objects urllib_response resembles urllib_parse moves
polygon	handling polygon parameters 2d regular displays data class
magnify1dtransform	1-dimensional expands transform analog magnifytransform
six	submodules moved urllib_robotparser meta moves loading urllib_error create six namespace importer urllib 3 urllib_parse import lazy python objects path urllib_request urllib_response resembles
event	attribute manager (i scenecanvas mouse event canvas describing occur note resize input encapsulates type events indicating draw used object occurred eventemitter callbacks key configuration class change represents list reacted sent context block
application	wraps baseapplicationbackend() instance abstract vispy application backends gui provides interface representation class native
quadric	1 (radius filter 5) quadric =
config	application-wide used container settings global vispy indicating configuration event change
pan	interaction parameters pan-zoom pan/zoom transform 2d implementing camera mouse
texture3d	dimensional parameters three texture
node	base representing class object scene
polar	polar r*cos transform maps r x theta z =
draw	canvas draw class type event sent
gloo	functions fit gloo series object oriented part provides gl class
buffer	render color attribute frame databuffer size index stencil parameters generic gpu type sub-region elements format buffer object vertex aware base data class depth view
max	locations intervals nice select n
isoline	tri different vertices levels mesh data isocurves
object	glsl program functions objects may variables base included expressions class
vertex	buffer attribute vertex data
collection	point antigrain dtype accurate raw paths container segment miter fast ugly) provides several (& collection caps antialiased path line data structure geometry items points segments
triangulation	debugging delaunay based implementation [1]_ triangulation process visualize aid constrained stepwise
regular	regular displays parameters polygon
infinite	vertical 2d infinite plots horizontal line
data	storing handling polygon parameters buffer type view databuffer sub-region aware mesh operating gpu size data class elements 3d
response	lazy loading six moved objects urllib_response moves
sub	node branches parent certain serves subclass marker scenegraph
glir	one parsers gl contains instance collected available gloo becomes object execute glir base interpreting using class commands actual queues attached queue context representation clas
glshared	contexts representation different "namespace" shared
agg	paths miter point antigrain accurate collection caps geometry points antialiased fast provides path segment segments
torus	representation torus link knot
lines	regularly scale spaced option many end lines system equal vertex length strips grid displays add coordinate new line one data
element	generic svg element
xyzaxis	orientation simple axes system coordinate 3d indicating axis
hamming	1 (radius filter hamming 0) =
y	[1 angle matrix 0], skew y-axis effect coordinates transformation 1 0 skewing along equivalent tan
