filecmp	比較 ディレクトリ および ファイル の
code	expat エラー れ 内部 です 1 特定 6 http いる 番号 インタプリタ さ クラス 2 定義 おける て に ステータスコード の rfc 基底
dist	distribution クラス
imageop	する データ の を 操作 画像 生
resources	and manager resource handles constants
dollar	、 ます ヘッダ set -cookie ' で 名前 クッキー の '$ 始まる し 無視 : を
maxlevel	表現 的 な の 制限 を 再帰 場合 深さ 作る
month	両 含む 値 から 端値 です の 1 を 2 まで
_pack_	できる インスタンス する 構造 オブション よう に の 体 を フィールド 小整数 アライメント 上書き
prefix	、 なけれ を ファイル 以前 ます サブパス zip 名前 中 モジュール です なり 部分 する あれ が 字列 に 空文 コロン の ば 検索 tagname
runpy	python と 実行 位置 モジュール の 特定
systemid	definition に対する サブセット identifier 義 ( system です 文書 ) システム の 識別子 型定 document type 外部
pty	擬似 端末 ユーティリティ
qdoffscreen	offscreen constants quickdraw
osa	osa carbon interface
gdbm	による dbm の 再実装 gnu
childerr	、 エラー そう 場合 際 標準 ます から ファイルオブジェクト プロセス なり する コンストラクタ 子 た none で 提供 に は の を 渡し 出力 ない capturestderr
const	、 動作 する その です の を 格納 定数 ため
icons	carbon manager constants icon
mimify	メールメッセージ 電子 mime 処理 の
copy_reg	登録 サポート する を 関数 pickle
pprint	整然 出力 化 の データ
easydialogs	基本 ダイアログ な 的 macintosh
htmllib	器 html 解析 の 文書
tail	エレメント する のに 的 データ に な tail は れ 使わ 結びつけ を 保持 られ アトリビュート ます 付加 た
quickdraw	constants quickdraw
sound	sound manager constants
install_scripts	パッケージ から を インストール スクリプトファイル
string	あるい 文字 search な 列 列操 です れ は 一般 た に渡さ 作 match 的
quicktime	quicktime constants
wave	wav 読み 書き ファイル の
util	関数 その ユーティリティ の 他
expectedfailures	た 要素 フォーマット タプル リスト と から の testcase 文字列 を 例外 し なる 2 情報 トレースバック
subprocess	管理 サブプロセス
minute	内 値 ) ( です の 0 range 6
testsrun	に です の 実行 し これ 総数 テスト た まで
skipinitialspace	、 ます 続く に 直後 は の 空白 delimiter さ 場合 無視 れ true
unixccompiler	unix c コンパイラ
sorttestmethodsusing	する で メソッド て ) 全 ソート 名 loadtestsfrom の および を *( 使用 比較 関数 際 gettestcasenames に
cmd	サポート distutils の 抽象 クラス コマンドインタープリタ 行指向 コマンド
list	a b に list manager です ある および ファイル サブディレクトリ
msvccompiler	microsoft コンパイラ
maxlong	長整数 文字 表現 おける 値 の 数 最大
imaplib	imap プロトコルクライアント 4
shlex	字句 な 解析 単純
tagname	要素 です 型名
evt	manager event
multiprocessing	並列 プロセスベース インタフェース の 処理 ” “
dummy_threading	threading 代替 モジュール の
dis	python アセンブラ 逆 バイトコード の
asyncore	非同 期 ソケットハンドラ
compileall	python を バイトコンパイル ライブラリ
syslog	syslog unix ライブラリルーチン 群
second	内 値 ) ( です の 0 range 6
dir_util	操作 ディレクトリツリー の
value	、 実際 text れ nodevalue 文字列 を value 別名 送信 ます 値 ( 形式 クッキー です . これ )、 その 属性 持ち する 要素 エンコード cookie この た あるい インスタンス none に は の さ
groupindex	、 辞書 定義 で ( 番号 名 れ です ?p <id >) さ へ グループ の 任意 記号 た マッピング
errors	、 や distutils エラー 文字列 を unicode エンコーディング トレースバック から です 2 リスト なる 情報 用い フォーマット タプル エラーハンドラ られる この し エンコーダ た 設定 要素 と に デコーダ の testcase 例外
statvfs	群 で os れる 使わ .statvfs 定数
build_py	パッケージ /. 構築 中 の を .py ファイル pyc
py_compile	python コンパイル ソースファイル の
pipes	シェルパイプライン へ インタフェース の
tarfile	する tar 書き アーカイブファイル を 読み
subdirs	オブジェクト 辞書 dircmp _dirs 名 です の を ファイル た に対応付け common
fpformat	点数 変換 の 浮動 小数
version	__ メソッド になり 利用 クライアント 際 意味 値 ( 返さ れる です 4 処理 _server い プロトコル python 番号 が ssl クラス 2 server rfc true へ 系 デフォルト や ） れ 列 使用 プロトコルバージョン capability 性 変数 + 形式 最新 version あり ある し _string _ uuid で に _version は 可能 origin 、 作成 （ , ソフトウェアバージョン 整数 tlsv サポート " バージョン 使わ ユーザエージェント た 展開 オブジェクト する オープン いる この simplehttp none て な の アーカイブ だけ 文字 必要 入っ pkzip を 場合 レスポンスセット ます また ) から 1 5 応答 http variant 指定 さ 列属 設定 url /" リクエスト サーバ
threading	の スレッドインタフェース 高水 準
failureexception	する メソッド が です 指定 を 例外 クラス test 送出 属性
body	、 _encoding 値 ます と が です の header は この し エンコーディング ため メッセージ を 記述 同じ 本体
bdist	構築 バイナリインストーラ の
colorpicker	ダイアログ 色選 択
optparse	器 コマンドラインオプション 解析
nargs	1 ( : デフォルト )
bdist_wininst	windows 構築 の インストーラ
groups	に です ある 数 キャプチャグループ の パターン
address	、 リスナーオブジェクト 示す値 要求 許す 待ち 入っ を タプル 使用 再使 port アドレス い 行う ます 参照 プロトコルファミリ ) ( 形式 中 , です とる か ソケット する http いる う かど が 属し host し クライアント マネージャ て の 用 サーバ
path	、 要求 クッキ パス マッチ 例 共通 名 れ 入っ れる 環境 文字列 を '/ ') ます 禁止 名操 ( クッキー _launchers import : 時 い ディレクトリー が /rocket 実行 さ し 作 た 設定 格納 で acme て に uri の 制限 検索 リクエスト ない
install_headers	パッケージ c ++ から ヘッダファイル /c を インストール
buildtools	仲間 と の buildapplet その ヘルパーモジュール
smtpd	サーバー smtp
faultcode	失敗 の 文字列 を 示す タイプ
_name	コンストラクタ 名前 に れ の 渡さ ライブラリ た
queue	、 要求 サイズ 待ち れ キュークラス を リスト 順序 ます ) 返し から 専用 れる です これ 同期 格納 属性 読み込み イベント が 実行 さ た で の queue 行列 (
userlist	クラスラッパー ため リストオブジェクト の
delimiter	文字 分割 のに から する です られる 1 間 を フィールド 列 なる 用い
doctest	する 的 対話 例 な 実行 を テスト
aetypes	オブジェクト appleevent
action	" ( ") : デフォルト store
install_lib	パッケージ から を インストール ライブラリファイル
shouldstop	ます と テスト stop が れる により 実行 さ し 停止 の true 設定
changes	ます 変更 返し て 開始 なさ れ が 以来 を さ た データベース 接続 削除 ・ の 挿入 行 総数
options	辞書 false に対応付け また て は オプションフラグ を です true いる
base64	2 1 データ 化 符号 , の rfc 3 base 5 4 6 8 :
secure	ます ば 返し な クッキー の 安全 を のみ 真 接続 その 返せる が なら
family	いる プロトコルファミリ て が です 属し サーバ の ソケット
extra	フィールドデータ 拡張
win	window manager
bdist_dumb	構築 インストーラ ” を “ダム
bdist_msi	する を バイナリパッケージ installer ビルド microsoft
names	、 内 名 れ 利用 を 関数 できる ます 名前 変数 モジュール プログラム でき 格納 する い う あろ sys 実行 さ し た で 環境 と て は の 制限 ない 組み込み os
reserved	領域 予約
total	ます 変更 返し て 開始 なさ れ が 以来 を さ た データベース 接続 削除 ・ の 挿入 行 総数
select	/o 完了 する i の 待機 を 処理
use	、 で は フラグ です デフォルト 真
cookiejar	オブジェクト いる て クッキー 入っ の です .cookiejar cookielib
super	、 オブジェクト 直接 いる て う とし です しよ し について クラス 基底 対象 記述 の class リスト 群
binascii	変換 で データ と の 間 バイナリデータ ascii
restype	する 外部 型 指定 結果 の を 関数 代入 ctypes に ため
handler	基底 sax ハンドラ クラス の
tokenize	python トークナイザ ソース ため の
stripspaces	制御 する 解釈 内 フラグ データメンバ です は の 空白 を この ウィンドウ 方法 ため 領域
lastchild	、 ノード に が です ある 子 の この 場合 その 末尾
type	、 _dgram 一般的 型 ファイルタイプ を 関数 型名 圧縮 が 送信 ます " _checker 値 ( 形式 です content ") : type ソケット 辞書 する 時 http string 付ける 指定 エラーレスポンス -type 対応 アーカイブメンバ し クライアント ; socket ヘッダ チェック で _stream と に な もの は の 2つ .sock 使う サーバ デフォルト
fractions	数 有理
posixfile	ロック オブジェクト サポート 類似 する を 機構 ファイル
simplexmlrpcserver	基本 xml 的 -rpc な サーバー
site	フック サイト 設定 固有 の
flag	フラグビット 列 zip
webbrowser	な ウェブブラウザコントローラー 便利
logging	機能 python 用 ロギング の 環境 設定
netscape	ます いる て こと プロトコル を し 実装 示し netscape
unicodedata	データベース unicode
anydbm	汎用 dbm アクセスインタフェース 形式 の データベース へ
hour	内 値 ) ( です の range 2 4
flp	デザイン する 保存 れ forms を さ 関数 ロード た
quoting	、 制御 ます て か writer れる 生成 reader を さ また し クオート によっ がいつ 認識
modulefinder	スクリプト する いる で て 中 れ モジュール 使わ を 検索
array	アレイ 数値 よい 効率 の
rfile	、 指し ます い 入力 て 部 データ が 入っ の を は おり 先頭 ストリーム その ファイルポインタ オプション
install	パッケージ インストール の
shelve	python オブジェクト 永続 化 の
fnmatch	パターンマッチ unix 名 ファイル の
fancy_getopt	getopt ラッパ の モジュール 標準
pickle	python オブジェクト 化 整列 の
example	オブジェクト 失敗 です し example た
exitcode	終了 コード です の 子 プロセス
prompt	表示 に れる プロンプト を さ 入力 求める ため
socketserver	ネットワークサーバ 構築 フレームワーク ため の
simplehttpserver	リクエストハンドラ な http 簡潔
sdist	物 構築 ソース 配布 の
lastindex	インデックス マッチ に です 最後 の グループ 整数 し 取り込み た
aepack	変換 python 変数 間 の appleevent データコンテナ と
imputil	import ユーティリティ
tag	文字 エレメント 表す 列 言い データ と ( 型 が です の ) 、 を この 種類 替える 示す
numbers	数 基底 抽象 クラス の
want	、 を 場合 際 期待 トレースバック 標準 ソースコード ( です 実行例 する 生じ が 実行 し た と に は の ) 例外 出力
sndhdr	識別 サウンドファイル の
publicid	definition に対する サブセット identifier 義 ( 公開 です 文書 ) の 識別子 型定 document type public 外部
abc	基底 抽象 クラス
charset	文字 、 変換 必要 を 最初 ます れる です する によって 前 指定 あり が さ 本体 それ セット あるい ヘッダ 電子 に は の メール 使う メッセージ
nextsibling	持ち 、 にくる ノード と 親 です 直後 を この 同じ
videoreader	quicktime ムービー 読み込み の
dumbdbm	可搬 dbm 性 ある 実装 の
menus	menu manager constants
telnetlib	クライアント telnet
csv	書き 読み csv ファイル の
config	パッケージ 環境 設定 ロギング の
fp	オブジェクト インスタンス 類似 また に です れ は の 渡さ ファイル 化 際 た
map	辞書 する 名拡 サフィックス 符号 するる に 化型 型指定子 張子 です に対応付ける 拡張子 を mime ファイル マッピング 型 マップ
snd	sound manager
description	、 ます クエリ 読み込み 名 専用 結果 は の を この し 提供 カラム 最後 属性
typed	も 型 取る れ を ” リスト アクション ます 値 ) ( “typed その はここ が さ ここ に は つまり オプション
variant	する 内部 variant レイアウト の を 決定 uuid
binhex	デコード 形式 binhex および の エンコード 4 ファイル
date	最終 日時 アーカイブメンバ 更新 の
data	文字 実際 し userdict 保存 入っ 以降 より 空白 文字列 を 列 化 圧縮 コメント 最初 辞書 binary リストオブジェクト また ユニコードオブジェクト れる です 使わ た 処理 バイト テキストノード する カプセル いる フィルタ データ python が 後 命令 による クラス バイナリデータ ため インスタンス 固有 て に は の userlist 内容 userstring 末尾
fm	manager font インターフェース
types	、 非標 名拡 型 張子 ファイルタイプ を 組み込み ファイル タプル 準 許さ マップ 辞書 ます 名前 です モジュール 一般 使わ れ 格納 する いる するる が い ある こと mime し types 型名 で て に は の ロード マッピング
gl	で インターフェース モジュール library れる 使わ graphics gl 定数
argparse	、 サブコマンド 引数 の パーサー コマンドラインオプション
drop	、 や 後 場合 が れ ます ) ( 真 削除 : 行頭 行末 ある さ true に の スペース ラップ デフォルト
udata	ユーザー 定義 値
stdin	、 使わ ます 入力 ファイルオブジェクト に stdin 引数 は の pipe 子 プロセス この 場合 なり れる が 属性
needsfree_	、 を 自身 メモリブロック ます 読み出し 変数 専用 データインスタンス 割り なり が ctypes この それ true 当て た 持つ に は の とき られ
callback	、 的 呼ば 引数 追加 呼び出し 標準 " あっ 後ろ コールバック れる です と アクション キーワード オブジェクト する 指定 位置 が ある この た で に対し に な の callback 可能 渡さ とき 4つ オプション
sha	1 sha - メッセージダイジェストアルゴリズム
environ	wsgi 含まれる に の 環境 リクエスト 変数 全て デフォルト
allow	示す値 う 許す 用 かど が です の を か 再使 サーバ アドレス
childnodes	内 いる て ノード 収め に です この なる から リスト られ
rlcompleter	向け readline 関数 補完 gnu
tty	制御 端末 群 の 関数 ため
help	manager help
maxstring	文字 表現 おける に の 制限 数 文字列
functools	オブジェクト 高階 と の 可能 関数 操作 呼び出し
jpeg	行う 書き jpeg の を ファイル 読み
ttk	widgets tk themed
uname	元 名 保存 です の を し ファイルメンバ た ユーザ
whichdb	する dbm 推測 ど モジュール が を たか 作っ データベース の
sgmllib	パーザ な sgml 単純
le	6 _mid 持つ で _low ） （ time , _version 1 文字列 を リトルエンディアン _hi バイト の uuid
uuid	準拠 1 uuid オブジェクト に rfc 2 4 し た
tempfile	一時 的 な の ファイル ディレクトリ 生成 や
__class__	いる て が です 属し クラス クラスインスタンス
platform	する 参照 固有 中 の 実行 を プラットフォーム 情報
sunaudiodev	オーディオハードウェア で sun れる の 使わ へ 定数 アクセス sunaudiodev
_b	、 型 を 自身 共有 持た メモリブロック ます 読み出し 変数 専用 データインスタンス た なり オブジェクト する データ が あり こと ctypes この それ ず true 当て 割り 持つ インスタンス 一部 は の とき 基底 に られ
pulldom	サポート 的 dom 構築 な ツリー の 部分
skipped	インスタンス ます し 理由 と から の testcase 文字列 2 保持 タプル なる を リスト 要素
etree	xml elementtree api
nok	、 れ 利用 を 関数 ます 名前 プログラム でき 格納 する い う あろ 実行 さ し た で 環境 て は の 制限 ない 組み込み
crypt	パスワード する チェック の unix を 関数 ため
autogil	グローバルインタープリタ イベントループ 中 取り扱い の
framework	対話 型 ・ フレームワーク アプリケーション
buffering	有効 バッファリング か 行 が どう
day	与え おける 月 から 値 です 日数 1 の られ と まで に た 年
multiprocess	wsgi 値 で 変数 .multiprocess れる 使わ 環境
name	文字 、 場合 時 名 れ 生成 デバイスファイル 文字列 を 関数 ファイル 列 open ます 値 名前 ( 宣言 クッキー です 識別 ファイルオブジェクト アーカイブメンバー プロセス ため なり のみ その 用い する 含む いる が られる さ られ クラス 使っ た 与え 要素 で て に doctype 型名 の ) doctest ルート
always	ます その 値 ) ( 型 取る が れ を さ リスト に アクション も はここ オプション つまり
directories	、 を '/ ', htbin 標準 ます 値 -bin 記述 cgi いる 含ん こと この し [ スクリプト で '] であり は 示す ディレクトリ
level	ます 深さ おける パート また に です の 現在 分離 を は し 取得 入れ子 設定 レベル
maxother	メソッド サイズ 型 れ 利用 を 化 できる ます 使わ 特定 コントロール オブジェクト する repr が この ため 書式 に は の 制限 ない
token	使わ python 木 に れる です 共 トークンバッファ と 解析 定数
mode	、 れ "w ファイル /o " ビット のどれ です 許可 モード コンストラクタ ", か rw た で i に の r 渡さ
timeout	、 none タイムアウト (秒 に 望ま は ない を 場合 時間 )、 もしく
debug	制御 する 値 distutils 使用 整数 の デバッグ を です 出力 デバッグモード ため レベル
macostools	する 集 に を ファイル 便利 操作 ルーチン
turtle	タートルグラフィックス tk ため の
domain	、 的 しく いれ 明示 を どの '. 真 ます に対する 規則 ドメイン クッキー です フラグ 厳 ( 始まっ する ドット 程度 ') か が 指定 ドメインマッチング し netscape た で て に 指示 の ば 返し サーバ
dialect	writer 表現 で 形式 専用 れる です の 使わ 読み取り 記述 パーサ
iterdump	ます する フォーマット イテレータ で 返し ダンプ の を データベース sql test ため
chunk	チャンクデータ iff 読み込み の
namespaceuri	関連 名前 に 要素名 です られ 付け た 空間
tabnanny	あいまい インデント な 検出 の
year	両 含む 値 maxyear から 端値 です の を minyear まで
unexpectedsuccesses	インスタンス リスト い 失敗 て ながら しまっ が 付い の testcase 成功 た し 意図 マーク
globs	する 名前 ( いわゆる です ) 実行 変数 実行例 を グローバル 空間
metavar	文字 ) ( から 列 : デフォルト オプション
__methods__	、 を 組み込み 取得 . リスト から 撤廃 バージョン 2 なる : 属性 オブジェクト する く ださい 使っ で て に は の 関数 dir
whitespace	、 文字 行末 や れ 空白 場合 真 ます 群 ) ( れる です のみ 削除 : 行頭 あれ 見なさ が 後 さ この ある true 値 分割 で と に 読み飛ば は の スペース ば ラップ デフォルト トークン
dircache	一覧 れ キャッシュ の さ ディレクトリ 生成 た
rfc2965	ます いる プロトコル こと て rfc 2 5 し 6 9 実装 示し を
res	and manager resource handles
rfc822	準拠 メールヘッダ 読み出し の rfc 2 8
factory	__ 制御 メソッド text 型 れ を どの ます 返す データ 使わ でき か 属性 オブジェクト missing によって この 使っ _ で て は
content	送信 -type する 時 http ます に ヘッダ エラーレスポンス content を し 使う 指定 クライアント
re	あるい matchobject search 正規 で メソッド インスタンス です は 生成 オブジェクト を この し 操作 た 表現 match
lineno	文字 や 文 検出 例 行番 れ を といっ ファイル 列 ます 改行 数 ) ( 加え 中 です filename 1 lineno 場所 テスト 属性 file 含む いる ast エラー さらに 遭遇 が あり 行 実行 さ この し ソース class た .stmt サブクラス おける で て に インスタンス もの は の _offset doctest 号 指定 .expr 始まっ col def 始まる
max	最も 、 datetime できる (maxyear =none ) ( , です 1 3 2 5 日付 9 表現 tzinfo 新しい date で time
aetools	osa クライアント サポート の
got	出力 実行例 実際 です の
applesingle	デコーダー applesingle
math	関数 数学
dirs	a b に です の および 両方 ある サブディレクトリ
nofill	、 文字 する 値 で 空白 に 縮約 は の たく フラグ ブール を ます し とき ない 偽 真
stderr	、 使わ ます stderr ファイルオブジェクト に エラー 引数 は の pipe 子 プロセス この 場合 出力 なり れる が 属性
osaconst	osa carbon interface constants
docstring	文字 現す テスト docstring です 自体 を 取り出し 列 た
args	、 partial 的 引数 追加 タプル 際 呼び出し 標準 ます 後ろ コールバック れる です その キーワード オブジェクト する 時 コンストラクタ 位置 前 指定 れ さ られ た 与え 最左 で と に な の callback 渡さ 例外 4つ
reason	理由 応答 文 から 返さ エラー れる です の この サーバ 原因
cookie	状態 http 管理 の
uu	デコード と 形式 の エンコード uuencode
md5	md 5 メッセージダイジェストアルゴリズム
macos	機能 インタプリタ の mac へ os アクセス
indent	文字 、 一行目 例 入っ より 空白 文字列 列 プロンプト 最初 '' 目 ) ( れる です すべ 実行例 いる られる 先頭 前 が 一行 ある 実行 付け 行 すなわち : 折り返し て 行わ に の 数 出力 インデント 以外 デフォルト
thread	コントロール マルチスレッド の
launch	services carbon launch
traceback	_exception 表示 スタックトレース 取得 log で また メソッド フレーム れる です の 数 さ は 出力 に 含まれる デフォルト トレースバック 最大
cgihttpserver	cgi 機能 http 付き 実行 機構 リクエスト 処理
filter	名前 カーネルフィルタ の
length	ノード シーケンス 中 です の 数 長さ リスト 属性
tochild	する ファイルオブジェクト 提供 です の 子 を プロセス 入力 へ
w	ウイジェット に 上 framework 作られ た
mimewriter	汎用 mime ファイルライター
user	フック の ユーザー 設定
ndim	元 表す メモリ です が 整数 多次 配列 を 示す 何次 か
returncode	、 的 れ poll ます ) ( から プロセス 間接 wait 終了 か communicate が 子 さ ステータス た 設定 入り に の
suffix	辞書 する サフィックス に を マップ
encoding	、 _encoding 名 れ header 文字列 を ファイル 列 エンコーディング ます 値 また です 使わ バイト 記述 する いる が エンコード この し 使っ メッセージ ため で デコード と に て は の とき ストリーム 同じ 本体
nodevalue	持ち ます 参照 詳しく 異なる dom ノード 型 て は くだ し 仕様 を この ごと さい ; 意味 に 属性
system	する zip 作成 文字列 システム アーカイブ を し 記述 た
codeop	python する を コード コンパイル
fpectl	制御 点例 の 外 浮動 小数
defects	、 れ 途中 defects リスト ます ) ( 検出 点 属性 する い defect さ し 問題 障害 で て は の を 保持 メッセージ 解析 たすべて
rawinput	、 で は フラグ です デフォルト 真
message	ます 応答 書式 返す に 化文 エラー する の 字列 を し 指定 クライアント 構築 ため
build_ext	パッケージ 構築 中 の を 拡張
size	バッファ 要求 サイズ 計算 文字列 を ファイル データ 圧縮 真 struct ) ( 単位 待ち れる です 使わ 圧縮後 バイト する 時 format buffer 前 が による し _text た とそれ に対応 で に の queue 行列 もの
dep_util	チェック 依存 関係 の
strict	、 ドメインマッチング も set しく マッチ パス uri 要求 を どの クッキ トランザクション ます に対する ' 規則 クッキー です フラグ 厳 2 5 6 9 : する -cookie 程度 か 無視 が 適用 禁止 始まる し netscape た に関する ヘッダ で 不可能 て に対し 検証 な 指示 の rfc 名前 '$ 設定 ない に
fl	で グラフィカルユーザーインターフェース 定数 使用 モジュール の forms さ ライブラリ fl れる ため
returns	、 ます する ゼロ 渡さ と に が 整数 の 文字列 を ハンドラ この unicode れ 関数 以外 属性
wrapper	、 .file wsgi 端末 また ファクトリ curses none は の ハンドラ です プログラム _wrapper ため
checker	辞書 付ける _checker チェック で 型 です もの 型名 を 関数 は 対応 type に
bits	フラグビット 列 zip
store	“store も ます ここ に れ は さ ” リスト アクション
currentlinenumber	、 号 行番 の 現在 入力 へ パーサ
escapedquotes	、 文字 する 解釈 定義 で のうち エスケープ れ です quotes を さ escape た 群
xdrlib	デコード データ および の エンコード xdr
lists	manager list constants
lastcmd	コマンドプリフィックス で 最後 の ない 空
internalsubset	文字 ドキュメント サブセット 内部 な 完全 の を 与える 列 です
拡張	改善 プロファイラ の
icopen	置き open と の internet 換え config
copy	コピー 浅い および 深い 操作
hashlib	および セキュアハッシュ メッセージダイジェスト
target	文字 命令 です の 空白 内容 処理 最初 まで
keyword	python キーワードチェック
isolation	ます また は の 現在 分離 を し 取得 設定 レベル
stringprep	文字 の インターネット 列調 製 ため
headers	key 、 /https クラス エラー れ れる 文字列 を ペア が 辞書 ます -value 読み出さ ) 変数 関連 変更 です 使わ 呼び出し と 拡張 なっ 含ま グローバルヘッダ リスト http い 入れ エラーレスポンス 行 指定 限り 含む さ られ し 付け セット た messageclass インスタンス ヘッダ で て 、( に の pax setitem リクエスト 全体 ない 保持 順番 原因
coregraphics	coregraphics constants
posix	、 最 も 内 的 れ 利用 を 関数 一般 できる ます 値 名前 _format モジュール です プログラム 格納 する い format 実行 さ この し 環境 true た 群 システムコール ustar で て と に な は の 制限 こと posix os 同じ
winsound	windows 用 音声 インタフェース の 再生
file_util	1 操作 ファイル の
register	index する package python に モジュール を 登録
wfile	ます 応答 い が に て する 入っ の を 出力 クライアント ストリーム 書き込む ため 返送
encodings	名拡 符号 名 張子 を ファイル 化 辞書 ) ドメイン - 国際 ( 8 する 化型 印付き utf おける に bom アプリケーション idna マッピング
getpass	パスワード 可搬 性 ある 機構 入力 の
raw	rawiobase インスタンス 返し ます ) bufferediobase が の を ( 扱う ストリーム 根底 生
parsers	xml な expat を 高速 解析 使っ た
__main__	環境 スクリプト トップレベル の
itemsize	つの 要素 表現 内部 に れる です の 1 数 メモリビュー それぞれ 長 バイト アレイ 使わ
symtable	表 の 記号 コンパイラ へ アクセス
pyclbr	python クラスブラウザサポート
configparser	構文 器 の ファイル 解析 設定
paths	なけれ 受け パス ん を タプル リスト xml ませ 値 -rpc なり 正当 部分 属性 する 付ける この で url な は の ば リクエスト
bz2	bzip の 2 ライブラリ 圧縮 互換
min	、 最 も 最小 datetime を できる 値 =none ) ( , です 1 0 日付 9 オブジェクト 表現 timedelta tzinfo (- date 表す で 古い の time (minyear
check	パッケージ する チェック の を メタデータ
builtin	、 れ 利用 を 関数 できる ます 名前 モジュール 安全 プログラム でき 格納 する い う あろ 実行 さ し インポート た で 環境 に て は の 制限 ない 組み込み
internal	内部 属性
build	パッケージ 全 構築 中 の を ファイル
bdist_packager	パッケージ ベースクラス 抽象 の
quotechar	文字 、 や を といっ 列 クオート 際 特殊 改行 から です 1 フィールド なる quotechar 用い する 含む か られる た に delimiter
folders	folder manager constants
trace	python と の ステートメント 実行 追跡 トレース
warnings	制御 警告 の
buffer	、 バッファ も 呼ば サイズ .stderr 扱う れ 利用 間 を は xmlparser 真 まで ます バッファリング バイナリバッファ ) ( から 返さ れる です 使わ なり バイト 内容 設定 オブジェクト する 時 buffer とき stoptest が sys 保持 この _text .stdout よう た 値 インスタンス starttest 根底 に な textiobase expat の 数 可能 真に と さ bufferediobase true
glob	パス 形式 名 の unix 展開 パターン
denominator	プロパティ 抽象
compress	アーカイブメンバ データ サイズ 形式 の 圧縮 圧縮後
firstchild	、 ノード に が です ある 子 の この 場合 先頭 その
unused	文字 データ です 後 入っ の より た 列 バイト 圧縮 末尾 が
gzip	gzip サポート ファイル の
microsecond	内 値 ) ( です の 1 0 range
carbonevents	carbon manager 定数 event
dialogs	manager constants dialog
domainliberal	、 れ 厳密 ます 性 0 ) ( です すべ フラグ オフ が さ netscape て と に 上述 の ドメイン 同じ つまり
future_builtins	python 3 ビルトイン の
exc	、 予期 例 入っ 生成 を 場合 期待 について 返す れる です 情報 する が sys .exc 実行 さ し _info た タプル で と もの の 例外 ない メッセージ 同じ
dom	サポート な 的 オブジェクトモデル ) ( 構築 dom ツリー 文書 api 軽量 の 部分 実装
url	、 説明 リンク エラー を コメント また から クッキー する この た なっ あるい none 働き と uri は の url サーバ 原因
doc	表示 する 場合 が に れ の 文書化 さ ヘッダ セクション 出力 ある ヘルプ た コマンド
urn	1 uuid で urn れる の rfc 2 さ 4 規定
request	文字 ます 要求 い て ) ( サイズ です 待ち が 入っ バージョン queue 行列 リクエスト 列 の
filelist	クラス filelist
linecache	ランダムアクセス に する テキストライン
clean	パッケージ 消去 ビルドエリア を の
subsequent	すべ 以外 先頭 折り返し れる て ) ( に 出力 付け が の '' 文字列 られる 一行目 : デフォルト 行 行わ
dbhash	dbm データベースライブラリ 形式 インタフェース の bsd へ
hmac	鍵付 き の ハッシュ 化 認証 メッセージ ため
dot	、 的 明示 を '. 真 ます 返し ') 始まっ いれ ドット 指定 が し ( た で て に ば ドメイン サーバ
test_support	テスト 関数 ユーティリティ ため の
wsgi	、 _once wsgi 値 で .file 変数 ファクトリ また れる は .multiprocess 使わ 環境 です none .run _wrapper .multithread
dbm	dbm な インタフェース の シンプル unix
text	、 バッファ も 的 制御 text 型 expat れ 結びつけ を どの xmlparser ます のに 値 返す 使っ から 返さ 使わ なり 内容 でき 属性 オブジェクト する データ か が エレメント 保持 この アトリビュート よう た で て と に な は の 真に 付加 られ
random	乱数 擬似 を する 生成
weakref	弱参 照
datetime	基本 的 型 な および 日付 時間
notations	定義 与える namednodemap を です の 記法
keywords	オブジェクト 時 partial に れる です の 渡さ キーワード 引数 呼び出し
base_	、 型 を 自身 共有 持た メモリブロック ます オブジェクト する データ が あり こと ctypes それ ず インスタンス 一部 は の 基底
xml	的 expat ツリー api 高速 パーサ sax xml サポート オブジェクトモデル ) ( インタフェース 文書 2 ユーティリティ 部分 ハンドラ クラス 実装 elementtree 使っ た dom 構築 な の を 基底 軽量 解析
launchservices	services carbon constants launch
menu	menu manager
writer	行う インスタンス 取り writer です を formatter とやり
controls	control manager constants
entities	定義 外部 エンティティ 与える の を です namednodemap
only	a b に です ある および だけ ファイル サブディレクトリ
bastion	オブジェクト 制限 に対する アクセス の
rexec	制限 実行 フレームワーク の
tzinfo	、 も 引数 datetime 場合 ます なり tzinfo オブジェクト コンストラクタ れ 何 られ た 与え none として に は 渡さ time なかっ
smtplib	smtp プロトコルクライアント
build_clib	パッケージ c 構築 中 の を ライブラリ
dl	オブジェクト c の 関数 共有 呼び出し
nntplib	nntp プロトコルクライアント
zipfile	アーカイブ 処理 zip の
repr	実装 もう repr 一つ の
ssl	tls する tlsv に対する ) ( /ssl は の 1 ssl ソケットオブジェクト です 使用 バージョン デフォルト ラッパー
actions	なけれ も 型 取る れ actions ん を ” “typed アクション ます ませ 値 ) ( リスト なり その “store い はここ が さ 全て て ここ に は の ば オプション つまり
hotshot	・ ロギング プロファイラ ハイパフォーマンス
new	オブジェクト 作成 内部 ランタイム の
faultstring	診断 含む 失敗 の 文字列 を メッセージ
cookielib	http 用 の cookie 処理 クライアント
cstringio	stringio れ さ 高速 化 た
resource	リソース 状態 情報 の 使用
carbonevt	carbon manager event
bisect	配列 アルゴリズム 二 分法
fields	、 も を です タプル 取得 uuid 派生 整数 2 フィールド これ 属性 つの 個別 6 し た 持つ で として と は の 可能
bytes	文字 ） （ 文字列 を 列 uuid , 整数 1 フィールド 6 _hi つの _mid _low バイト が リトルエンディアン 持つ ビッグエンディアン で _version の バイトオーダー time
xmlreader	xml パーサ インタフェース の
pydoc	と ドキュメント オンラインヘルプシステム 生成
crc	前 - の crc 3 2 ファイル 圧縮 チェックサム
msilib	書き 読み の microsoft インストーラーファイル
common	、 非標 名拡 型 エラー 張子 間 を ファイル 準 両方 報告 サブディレクトリ タイプ れ 名前 一般 です 使わ なる マップ 辞書 する .stat か が あり ある mime よう a b で て に な は の 異 および いる ディレクトリ os
instream	文字 インスタンス 読み出し て が です を shlex 入力 ストリーム いる
failfast	、 失敗 エラー れ 呼び出さ ます 始め れる 終了 時 テスト stop が 実行 さ し true 設定 と に は の もしく
ccompiler	ccompiler ベースクラス
set	、 set クッキ パス マッチ 要求 を ます 禁止 ' 名前 クッキー 無視 : -cookie が 始まる し た 設定 ヘッダ で に uri の '$ ない
locale	サービス 国際 化
fflags	フラグ 依存 フィルタ の
frame	テキスト と フレーム スクロールバーウィジェット を 取り囲む
popen2	/o 持つ子プロセス i な 生成 可能 を ストリーム アクセス
module	オブジェクト し て 名前 が です の モジュール を 関数 クラス 対象 記述 定義 いる
atexit	終了 ハンドラ
num	だ 読ん から です ソースイテレータ 行数
calendar	的 群 な カレンダー 一般 関数 に関する
htmlparser	な の シンプル および html パーザ xhtml
mailcap	mailcap 操作 ファイル の
timeit	断片 コード な の 実行 計測 時間 小さ
dlg	manager dialog
plistlib	解析 と . mac ファイル 生成 x の os plist
pattern	オブジェクト 文字 から が です れ re さ コンパイル 列 それ た パターン
urllib	リソース url の による へ 任意 アクセス
filename	ます する 名前 中 指定 名 クッキー の アーカイブ を 保存 ファイル し デフォルト
errorcode	する コード エラー による を です 数値 特定
macros	辞書 に対応付け て 名 です の マクロ 文字列 を リスト いる
written	文字 ブロック する 書き込ま 値 に 前 れる 整数 数 を 保持 です ストリーム
__bases__	タプル から クラスオブジェクト の です クラス なる 基底
mutex	制御 排他
closed	閉じ ブール を 場合 かどう ます 値 です ファイルオブジェクト なり い か が 現在 られ true た 真偽 て に 状態 の 示す ストリーム デバイス
colorsys	系間 変換 の 色体
unixfrom	、 ます なけれ その from なり で に 空文 が は 行 字列 ば unix そう 場合 メッセージ ある
formatter	汎用 いる て に 関連 です の 化機 られ 出力 パーザ フォーマッタインスタンス 付け 構 書式
email	パッケージ 電子 と の mime メール 処理 ため
fcntl	fcntl システムコール および ioctl
ftplib	ftp プロトコルクライアント
responses	もつ 要素 二つ 表す に対応付け ます 変数 は の を この タプル 整数 エラーコード
parent	有効 な です openerdirector
mailbox	形式 な の メールボックス 操作 様々
strides	、 ndim 必要 を です タプル のに 整数 配列 バイト する アクセス 要素 次元 表す それぞれ て に対し に な の 数 長さ
ctypes	python の 外部 関数 ライブラリ ため
key	名前 cookie の
carbon	and control apple foundation list interface manager parsers file osa font event help for media window handles generators editor text folder 定数 events quickdraw core offscreen multilingual descriptors quicktime component corefounation drag accssors graphics services carbon constants icon sound textedit resource launch drop appearance ヘルプ coregraphics dialog menu interfacebuilder
nav	呼出 navservices し の
build_scripts	パッケージ スクリプト 構築 中 の を
messageclass	2 ます ヘッダ 解釈 http し 類似 指定 する の rfc を クラス 8 message . ため
minidom	軽量 な 実装 dom
currentcolumnnumber	、 カラム 番号 の 現在 入力 へ パーサ
commands	実行 ユーティリティ コマンド
delayload	、 lazy ) で 読み込み あれ ( に します クッキー ば を 読み込む さい ディスク 遅延 から 真
wsgiref	準拠 wsgi と チェッカー ユーティリティ 実装 リファレンス
itertools	ループ イテレータ 的 な 効率 の 実行 関数 生成 ため
folder	folder manager
attributes	、 ノード 型 を です 報告 リスト 辞書 ます ) れる 整数 (xml namednodemap 属性 オブジェクト する さ この し ゼロ で と に は の なく 以外
unverifiable	ます も 不可能 て 規則 に対し 検証 な クッキー の rfc 適用 2 5 し 6 9 を netscape トランザクション に関する
pdb	python デバッガ
comment	、 文字 各 説明 リンク を ファイル 列 コメント に対する アーカイブメンバ zip から クッキー です する られ 付け た あるい none url は の 働き サーバ この
domainrfc2965match	、 ます する 要求 クッキー 完全 の rfc ドメインマッチング 2 を 5 し 6 9 さい 設定
cm	manager component
lastgroup	名前 マッチ に 最後 の グループ です し 取り込み た
codecs	と レジストリ codec クラス 基底
cg	core graphics
pos	search 値 か れ です の pos た に渡さ match regexobject
cd	cd sgi システム へ -rom の アクセス
header	表示 セクション オフセット れ 場合 バイト ヘルプ コマンド ファイルヘッダ する が ある 文書化 さ た ヘッダ で に 表し の 数 出力 へ
rpc	なけれ 受け パス ん を タプル リスト xml ませ 値 -rpc なり 正当 部分 属性 する 付ける この で url な は の ば リクエスト
dummy_thread	代替 モジュール thread の
httplib	http プロトコルクライアント
localname	、 以降 なけれ 名前 なり ます あれ 全体 に コロン が の ば tagname 部分
diff	a 、 b し に が です ある ない および ファイル 一致 両方
robotparser	ため パーザ robots .txt の
pkgutil	パッケージ 拡張 ユーティリティ
wordchars	文字 バッファ する 蓄積 列 複数 から て です を 構成 し なる ため いく よう に トークン な
imp	import アクセス する 内部 へ
create	バージョン する zip 作成 文字列 システム pkzip アーカイブ を この し 記述 の た
json	json エンコーダ および デコーダ
ah	apple ヘルプ
macerrors	macos エラー の
parser	python 解析木 に する アクセス
imag	プロパティ 抽象
imgfile	sgi サポート imglib ファイル の
termios	制御 端末 の posix スタイル
al	使わ 機能 で al モジュール オーディオ sgi の 定数 れる
multithread	wsgi 値 で 変数 れる 使わ 環境 .multithread
utf_8_sig	- utf bom 印付き 8
external	外部 ファイル 属性
func	オブジェクト また は 可能 関数 です 呼び出し
linkname	、 オブジェクト 存在 で ます 名前 と lnktype 名 は の ターゲットファイル symtype だけ し これ に tarinfo タイプ
last	ます 終了 なり で あっ イベント に 見つかっ が 最後 コネクション を アドレス ファイル 場合 真と です 受け付け メッセージ マーカ た
_fields	、 各 そこ ノード を ます 持っ 名前 し 属性 い 具象 クラス 子 保持 おり _ て fields に は の すべて
pickletools	者 群 の ツール 開発 pickle ため
pixmapwrapper	オブジェクト pixmap ラッパー の
ident	、 なけれ れ スレッド を 識別子 ’ ‘ 値 また 開始 です 特定 する い イベント が さ ため none て は の ば
__members__	、 を 組み込み 取得 . リスト から 撤廃 バージョン 2 なる : 属性 オブジェクト する く ださい 使っ で て に は の 関数 dir
zlib	gzip 圧縮 の 互換
appearance	定数 manager appearance
curval	あるい 値 プログレスバー ) ( 型 です 整数 の 現在 長整 は 数型
hstderror	、 メンバ すれ _usestdhandles エラー 指定 です が ば の を プロセス この 処理 dwflags startf 標準
choices	"choice 文字 " て に対し 型 なる が です 選べる 肢 選択 の 列 と ユーザ リスト オプション
sax	xml サポート インタフェース の 2 ハンドラ ユーティリティ クラス 基底 パーサ sax
error	ステータス エラー する を 送信 ます 返す れる です content 使わ 応答 時 http 化文 指定 エラーレスポンス 字列 し クライアント ため -type ヘッダ 書式 で に の 使う 構築
multifile	だ サポート 群 個別 の 含ん を ファイル 部分
errmsg	診断 エラーメッセージ 文字列 は また
spawn	の 生成 サブプロセス
errcheck	オブジェクト ます また python に 代入 は の 可能 を 関数 この し 他 呼び出し 属性
hstdinput	、 メンバ すれ _usestdhandles 処理 指定 です が ば の を プロセス この 入力 dwflags startf 標準
stdout	、 使わ ます ファイルオブジェクト なり stdout に 引数 は の pipe 子 プロセス この 場合 出力 れる が 属性
expat	xml な expat を 高速 解析 使っ た
poplib	3 プロトコルクライアント pop
maxdict	オブジェクト に対する 表現 型 指定 れ 制限 数 について さ エントリ の た
io	コアツール ストリーム を 扱う
gname	元 名 保存 です の を グループ し ファイルメンバ た ユーザ
ic	の インターネット mac へ x os アクセス 設定
shutil	高 な 操作 ファイル レベル
ascii	文字 ascii ユーティリティ に関する
qdoffs	offscreen quickdraw
funny	、 エラー れ 間 を ファイル 両方 報告 タイプ 名前 です なる する .stat か が あり ある さ よう た a b で に な の 異 および ディレクトリ os 比較 なかっ
tkinter	/tk python インタフェース の tcl へ
machelp	manager help constants
pax	辞書 、 ヘッダ 関連 pax に れる ペア の グローバルヘッダ -value 拡張 られ key 付け 含ま た
domainstrict	と です domainstrictnodots 同じ |domainstrictnondomain
hstdoutput	、 メンバ すれ _usestdhandles 指定 です が ば の を プロセス この 処理 出力 dwflags startf 標準
same	a 、 する b に です あり および ファイル 一致 両方
__mro__	探索 メソッド に です れる は の 解決 さ この クラス 基底 タプル 属性
split	、 文字 分割 値 で 空白 あれ が は れ ます ば さ この のみ true トークン
sqlite3	sqlite に対する インタフェース -api db . 0 2 データベース
ossaudiodev	oss オーディオデバイス へ の アクセス 互換
events	manager event constants
status	返さ http コード で から 状態 れる です エラーレスポンス 使わ ステータス サーバ
used	、 バッファ バイト 数 buffer に な が です れ 利用 可能 とき 保持 _text さ た
http	origin 、 れ 場合 列属 レスポンスセット ます 性 バージョン 使わ _server 文字 http が この クライアント true 設定 に は の へ
nodename	持ち ます 参照 詳しく 異なる dom ノード 型 て は くだ し 仕様 を この ごと さい ; 意味 に 属性
typecode	文字 コード に とき 型 です を アレイ 使う 作る
gensuitemodule	osa スタブ 作成 パッケージ
testmethodprefix	テストメソッド 接頭 判断 メソッド 名前 と 名 れる の 文字列 を さ 示す 語
sys	、 内 や メソッド 名 れ 入っ モジュール 利用 を 関数 の できる ます システムパラメータ 変数 形式 , バージョン し version 処理 格納 する い python が sys 実行 さ クラス _string 環境 た で て と な _version server 制限 可能 系 プログラム
ctl	control manager
endpos	search 値 endpos か れ です の た に渡さ match regexobject
characters	文字 ブロック する 書き込ま 値 に 前 れる 整数 数 を 保持 です ストリーム
nis	への ) sun インタフェース yellow の ( nis pages
validate	準拠 wsgi チェッカー
commenters	文字 開始 れる です コメント として さ 列 の 認識
difflib	助ける を 計算 差分 の
urlparse	要素 する て url に を 構成 し 解析
client	、 入っ を タプル port アドレス い ます 参照 ) ( 形式 , とる http いる が host し クライアント て の
flags	オブジェクト れ です が 使わ re さ コンパイル とき 引数 flags た
components	manager component constants
sets	要素 なし な ユニーク の コレクション 順序
userstring	オブジェクト 文字列 クラスラッパー ため の
mhlib	mh の メールボックス 機構 へ アクセス
ae	apple events
errorcolumnnumber	番号 エラー です の 発生 し カラム た
left	a に です ある および だけ ファイル サブディレクトリ
protocol	、 れ を ます サポート 値 から 返さ れる です バージョン 使わ 最新 応答 http いる プロトコル 指定 ある さ この し た て に は の capability サーバ
distutils	各 distutils /c installer ビルドエリア パッケージ 8 サブプロセス python 番号 クラス ソース インストール インストーラ スクリプト デバッグモード バイナリパッケージ と 操作 emx ccompiler な 生成 システム .py ファイル index 機能 borland 形式 pep モジュール / バイナリディストリビューション メタデータ その ビルド 依存 スクリプトファイル distribution c extension package ++ に 例外 ラッパ os redhat 登録 ヘッダファイル シンプル unix 関数 rpm 消去 バージョン 2 ユーティリティ ライブラリファイル 情報 する 拡張 textfile “ダム チェック 全 構築 バイナリインストーラ ロギング の windows ライブラリ 抽象 srpm を コンパイラ ” 標準 配布 から 中 1 getopt コマンド cygwin 他 pyc 設定 /. データファイル 関係 スタイル 物 filelist ディレクトリツリー ベースクラス コア microsoft
audioop	する データ 音声 の を 操作 生
userdict	辞書 オブジェクト クラスラッパー ため の
_handle	に られる の ライブラリ へ システムハンドル アクセス 用い
aifc	書き aiff の および ファイル 読み aifc
quotes	文字 群 符 と れる です 文字列 引用 見なさ
shape	、 長さ 次元 として メモリ です 配列 与える n 形状 を 整数 タプル の ndim
unicode	、 ます する ゼロ 渡さ と に が 整数 の 文字列 を ハンドラ この unicode れ 関数 以外 属性
__dict__	書き込み 型 保存 を マップ 辞書 また ) ( れる です 使わ 属性 オブジェクト する 他 ため に な は の 可能
newlines	、 ます none 改行 で また に が は の し 文字列 を られる タプル どの 指定 読み 換え よう か
struct	する 解釈 データ として れ 文字列 を さ バイナリデータ パック た
source	文字 は none メンバ で ます ソースコード 変数 取り が 入っ の を 標準 です 列 実行例 た この
collections	コンテナ データ 型 な 高性 ・ 能
input	文字 変換 codec python _charset に する 指定 です れる 名 を さ unicode 用 input の セット ため 最初
real	プロパティ 抽象
zipimport	する zip から モジュール アーカイブ を import
reuse	示す値 う 許す 用 かど が です の を か 再使 サーバ アドレス
format	文字 作成 時 エラー する 利用 を 列 ます に対する struct 返す ) モジュール です た オブジェクト 応答 フォーマット 化文 指定 れ 字列 含む さ この し クライアント ため それぞれ 要素 書式 で スタイル 、( に ビュー の 構築
dest	文字 ) ( を 列 使う : デフォルト オプション
ruler	、 ヘルプメッセージ ヘッダ れる に する の 使わ を 文字 表示 区切り行 下 ため
textwrap	テキスト と 折り返し 詰め込み の
cf	core foundation
bsddb	db berkeley インタフェース の ライブラリ へ
accepted	に です 最後 コネクション を アドレス 受け付け た
daemon	、 ます 値 で デーモンフラグ か スレッド あり の デーモンプロセス フラグ ブール を です し ある かどう 設定
install_data	パッケージ データファイル 中 の を インストール
signal	する イベント に を ハンドラ 非同 期 設定
sunau	sun 読み 書き auファイル の
server	__ 要求 になり 入っ ソフトウェアバージョン を の アドレス 行う ます " 値 + 待ち です version い 指定 が この し simplehttp インスタンス て /" は server サーバ
hosts	辞書 account づけ 対応 いる て ) ( から 名 , です ホスト タプル なる login password を に
emxccompiler	2 os emx / コンパイラ
output	文字 、 変換 _charset 必要 を unicode ます 用 です codec する python 名 によって 前 が あり 本体 output それ セット ため あるい ヘッダ 電子 に は の メール 使う メッセージ
quopri	quoted データ 形式 および の エンコード mime デコード -printable
htmlentitydefs	エンティティ html 定義 一般 の
decimal	演算 及び 1 0 進 算術 固定 点数 の 浮動 小数
cfmfile	扱う を モジュール コードフラグメントリソース
bdist_rpm	redhat と 構築 形式 の バイナリディストリビューション を srpm rpm
right	b に です ある および だけ ファイル サブディレクトリ
methods	辞書 メソッド 名 行番 に対応付ける です を 号
documentelement	要素 一無 二 唯 の ドキュメント です ルート
macpath	パス の mac 関数 9 操作 os
mimetypes	する 型 名 を mime ファイル へ マップ
parentnode	、 ます none なり ノード か 親 は の 現在 場合 文書 に
examples	、 対話 例 を ぞれ リスト から れる です なる オブジェクト モード い テスト エンコード 実行 さ し それ おける で て に example
escape	文字 群 と エスケープ れる です 見なさ
findertools	events インターフェース apple finder の
requesthandlerclass	れ インスタンス する 要求 クラス ます 提供 に が です の ごと この 処理 さ ; 生成 ユーザ
miniaeframe	サポート オープンスクリプティングアーキテクチャサーバ の
cpickle	より な pickle 高速
lineterminator	文字 各行 writer に 終端 する が です られる を 列 際 作り出す 用い
bcppcompiler	borland コンパイラ
icn	carbon manager icon
macresource	見つける スクリプト を リソース の
infile	名 です の 現在 ファイル 入力
cgi	、 を '/ ', htbin 標準 ます サポート 値 ) ( -bin 記述 cgi いる 含ん こと この し [ ゲートウェイインタフェース スクリプト で '] であり は の 規格 示す ディレクトリ
core	コア 機能 distutils の
expires	あるい は none 切れる 秒数 経過 ( から あわらす クッキー 整数 日時 エポック の た し )、 期限 を が
run	_once wsgi 値 で 変数 れる 使わ 環境 .run
inspect	オブジェクト する 活動 中 の を 取得 情報
suiteclass	オブジェクト テストスイート する テスト 構築 の 可能 を 呼び出し から リスト
authkey	文字 ) ( バイト です の プロセス 列 キー 認証
textedit	textedit constants
offset	ファイルヘッダ 行内 で 表し オフセット エラー が です の 数 発生 場所 し バイト へ た
__name__	また 名前 型 は の です クラス
elementtree	xml elementtree api
previoussibling	持ち 、 にくる ノード と 親 直前 です を この 同じ
panel	パネルスタック の 拡張 ため curses
cgitb	cgi スクリプト 管理 の 機構 トレースバック
ok	、 内 関数 名 れ れる ファイルタイプ 環境 を 組み込み 許さ いる できる ます 名前 変数 モジュール 安全 プログラム import 格納 利用 する 時 い ディレクトリー が sys 実行 さ し た で て と に の 制限 こと 検索 インポート ロード os
socket	、 _dgram 要求 型 一般的 ソケットオブジェクト レベルネットワークインターフェース 行う .sock 値 待ち です ; ソケット が 低 ため socket _stream と な は の 2つ を 入力 使う サーバ
extension	クラス extension
imghdr	する 形式 の を 決定 画像
numerator	プロパティ 抽象
netrc	の netrc 処理 ファイル
maxlen	、 deque なけれ 最大 で て れ です の 制限 ば さ 長 none い
addresslist	文字 タプル あたり で 一つ から です れる ペア の 構成 さ リスト 列 なる アドレス
extensions	辞書 型指定子 に対応付ける です 拡張子 を mime
discard	ます セッションクッキー で あれ 返し が ば を これ 真
attrib	辞書 エレメント する です の を 保持 アトリビュート
os	名操 wsgi 雑多 パス 含まれる に 共通 の 環境 な リクエスト 作 変数 全て デフォルト オペレーティングシステムインタフェース
marshal	向け オブジェクト 内部 python 整列 化 の 使用
__future__	future 定義 文 の
curses	文字 表示 端末 入力 curses パネルスタック 拡張 の テキスト ハンドラ ユーティリティ プログラム セル 操作 ascii ウィジェット ため に関する
__builtin__	オブジェクト 組み込み
errorlinenumber	号 エラー 行番 です の 発生 し た
device	で モジュール れる 使わ gl 定数
fileinput	だ サポート 。 処理 複数 またい する 行 の を 入力 ストリーム 繰り返し
operator	標準 演算子 形式 関数 の
ibcarbonruntime	carbon constants interfacebuilder
errno	errno の システムシンボル 標準
initial	、 set 的 先頭 れる '' 明示 '$ '. 目 ') ます ) ' 名前 ドメイン クッキー 真 無視 : 始まっ いれ ドット -cookie られる 出力 指定 一行 が 始まる し 付け た 折り返し ヘッダ 返し で て 行わ に 文字列 の ば を ( サーバ デフォルト
hex	文字 進数 uuid で の 1 3 2 列 6
width	折り返し ) ( が れる 0 長さ の 7 行わ : デフォルト 行 最大
gid	元 保存 です の を グループ し ファイルメンバ id た ユーザ
cygwincompiler	cygwin コンパイラ
files	、 れ manager ファイル file 両方 です constants する が あり ある さ し た a b に の および 一致 ない 比較 なかっ
_fields_	する 定義 シーケンス の 構造体 フィールド を
textpad	テキスト プログラム curses の 入力 ウィジェット ため
volume	ファイルヘッダ ボリュームナンバ の
msg	応答 mimetools する 含む インスタンス と 例 メッセージ が です 生成 実行 さ 例外 場合 期待 の を れる .message ヘッダ
pwd	する 提供 の を へ パスワードデータベース アクセス
scrolledtext	する スクロール テキストウィジェット
line	有効 だ バッファリング 読ん から 行 です が ソースイテレータ 行数 か どう
identchars	文字 語として 入れ られる の 文字列 受け 先頭 コマンド
info	、 タプル について 予期 で 返す と もの です が 入っ の sys .exc 同じ 例外 し ない _info 情報 た
nodetype	node する 表現 値 ノード ( 型 整数 の ) を です
attr	外部 ファイル 内部 属性
default	__ メソッド れ 対象 ます 属性 れる です コマンドライン _ 使わ missing によって 指定 が この た 値 に は の とき なかっ オプション
argtypes	指定 する タプル ます 型 取る が 代入 の し を 関数 受け 引数 ctypes に ため
windows	window manager constants
limit	_exception log で メソッド フレーム れる です の 数 さ 出力 に 含まれる デフォルト トレースバック 最大
errorbyteindex	エラー が です の 発生 し バイト た インデクス
maxdiff	、 表示 する 時 し 失敗 ます レポート に 差分 が は の 長さ を この アサーションメソッド コントロール 属性
ibcarbon	carbon interfacebuilder
fromchild	する ファイルオブジェクト 提供 から です の 子 を プロセス 出力
mediadescr	and for media quicktime parsers generators descriptors
mimetools	する の を mime ツール メッセージ 解析 ため
_anonymous_	) ( シーケンス 無名 が の 名前 匿名 フィールド あげ 並べ オプション た られ
ordered	、 ノード 型 を 報告 リスト 辞書 ます ) れる 整数 (xml 属性 する さ この し ゼロ で と に は の なく 以外
uid	元 保存 です の を し ファイルメンバ id た ユーザ
currentbyteindex	、 の 現在 バイトインデックス 入力 へ パーサ
int	ビット で 整数 の 1 2 8 uuid
xmlrpclib	xml -rpc クライアントアクセス
specified	ます いれ 的 て ドメイン に が 指定 ば 明示 を し 返し サーバ 真
pid	ます 入り 返し 番号 が です の 子 を プロセス id
command	登録 ヘッダファイル 各 distutils /c ライブラリファイル 入っ 全 を 抽象 ファイル installer ビルドエリア ” パッケージ ます pyc redhat 配布 ) ( から 形式 中 モジュール index バイナリディストリビューション メタデータ rpm インストーラ ビルド コマンド データファイル する http い 消去 python ++ ライブラリ が 命令 拡張 スクリプトファイル に ソース スクリプト インストール “ダム /. c チェック て windows と 構築 バイナリインストーラ の 物 package バイナリパッケージ リクエスト 設定 ベースクラス .py srpm microsoft
intro	あるい 表示 として れる は バナー 文字列 さ イントロ
contextlib	構文 コンテキスト - の ユーティリティ with ため
file	、 wsgi 許さ し 文 サイズ れ 入っ ファイルタイプ manager を 関数 ファイル file 圧縮 い ます また 名前 ファクトリ モジュール です てる _wrapper する いる .file 前 が こと クラス class none 格納 定義 て は の ロード def
mtime	最終更 時刻 新
archive	、 ん サブパス で zip 紐付け 名 含まれ は の importer ませ られ に た ファイル
fonts	manager font constants
tix	ウィジェット 拡張 tk の
grp	へ グループデータベース アクセス の
extract	する に な 必要 pkzip の アーカイブ を この 展開 際 バージョン
gettext	語対 多言 国際 サービス 化 応 に関する
readonly	表す 読み込み か 専用 が です ブール を メモリ
codec	変換 output python _charset に 名 する です の を unicode 用 input codec ため
coded	送信 する 実際 値 に 形式 れ の エンコード さ cookie た
sysconfig	する python に の システム 構成 情報 アクセス 設定
test	失敗 例 れ 関数 テストパッケージ 用回 です 帰 た ユーティリティ オブジェクト 時 い python テスト が 実行 さ し ため て に の doctest
getopt	c の 言語 コマンドラインオプションパーサ スタイル
dragconst	and drag drop manager constants
ns	、 ドメインマッチング も set しく マッチ パス uri 要求 を どの クッキ トランザクション ます に対する ' 規則 クッキー です フラグ 厳 2 5 6 9 : する -cookie 程度 か 無視 が 適用 禁止 始まる し netscape た に関する ヘッダ で 不可能 て に対し 検証 な 指示 の rfc 名前 '$ 設定 ない に
stat	stat 解釈 返す する の を 内容
text_file	textfile クラス
stringio	する 書き に の 文字列 を ファイル 読み よう
symbol	使わ python 木 に れる 共 と 解析 定数
urllib2	url な 開く の 可能 を 拡張 ライブラリ ため
controlaccessor	control manager accssors
drag	and drag drop manager
asynchat	ソケットコマンド 非同 / 期 レスポンスハンドラ
log	スタイル ロギング な pep の シンプル 2 8
saxutils	sax ユーティリティ
basehttpserver	基本 機能 http 的 な を サーバ 持つ
readline	readline の インタフェース gnu
epilogue	文字 、 境界 最後 を 列 まで epilogue から です 属性 テキスト 含む mime それ preamble で と もの は の メッセージ 以外 末尾 同じ
docxmlrpcserver	xml ドキュメンティング -rpc - セルフ サーバ
eof	する のに 終端 れる です の 使わ を ファイル 決定 トークン
corefounation	corefounation constants
idna	おける ) ドメイン に アプリケーション 名 国際 ( 化 idna
modules	辞書 できる ます い て 名前 名 に 結びつける モジュール の 安全 を 組み込み し インポート 格納
dwflags	、 する メンバ startupinfo : に が です の 使わ か ビットフィールド 特定 プロセス 決定 とき ウィンドウ 生成 を れる
cmath	の 数 関数 複素 数学 ため
time	最終 変換 アーカイブメンバ データ と 更新 日時 へ の アクセス 時刻
failures	た 要素 フォーマット タプル リスト と から の testcase 文字列 を 例外 し なる 2 情報 トレースバック
lastrowid	、 ます rowid 読み込み 提供 に 専用 変更 は の を この し た row 最後 属性
resolution	オブジェクト 、 (days で timedelta 等しく 差 datetime が です 最小 1 ) 間 なら 時間 ない の = (microseconds 日付
mlte	text multilingual editor
once	_once wsgi 値 で 変数 れる 使わ 環境 .run
