zipfile zipinfo extract version	この アーカイブ を 展開 する 際 に 必要 な pkzip の バージョン
cookie morsel coded value	実際 に 送信 する 形式 に エンコード さ れ た cookie の 値
cookielib cookie discard	これ が セッションクッキー で あれ ば 真 を 返し ます
pyclbr function module	関数 記述 オブジェクト が 記述 し て いる 対象 の 関数 を 定義 し て いる モジュール の 名前 です
shlex shlex source	この メンバ 変数 は 標準 で none を 取り ます
rexec rexec ok file types	モジュール が ロード する こと を 許さ れ て いる ファイルタイプ を 格納 し て い ます
optparse option type	( デフォルト : " string ")
zipfile zipinfo date time	アーカイブメンバ の 最終 更新 日時
zipfile zipinfo internal attr	内部 属性
cookielib cookie name	クッキー の 名前 ( 文字列 )
cookielib defaultcookiepolicy domainrfc2965match	クッキー を 設定 する さい 、 rfc 2 9 6 5 の 完全 ドメインマッチング を 要求 し ます
re matchobject re	この matchobject インスタンス を match あるい は search メソッド で 生成 し た 正規 表現 オブジェクト です
basehttpserver request version	リクエスト の バージョン 文字 列 が 入っ て い ます
formatter formatter writer	formatter とやり 取り を 行う writer インスタンス です
email charset charset output charset	文字 セット によって は 、 電子 メール の ヘッダ あるい は メッセージ 本体 に 使う 前 に それ を 変換 する 必要 が あり ます
re regexobject groupindex	( ?p <id >) で 定義 さ れ た 任意 の 記号 グループ 名 の 、 グループ 番号 へ の 辞書 マッピング です
subprocess startupinfo hstdinput	dwflags が startf _usestdhandles を 指定 すれ ば 、 この メンバ が プロセス の 標準 入力 処理 です
cookielib cookiepolicy rfc2965	rfc 2 9 6 5 プロトコル を 実装 し て いる こと を 示し ます
userlist userlist data	userlist クラス の 内容 を 保存 する ため に 使わ れる 実際 の python リストオブジェクト
zipfile zipinfo external attr	外部 ファイル 属性
filecmp dircmp right list	b に ある ファイル および サブディレクトリ です
doctest doctest examples	対話 モード に おける 実行 例 それ ぞれ を エンコード し て い て 、 テスト で 実行 さ れる 、 example オブジェクト から なる リスト です
cgihttpserver cgihttprequesthandler cgi directories	この 値 は 標準 で [ '/ cgi -bin ', '/ htbin '] であり 、 cgi スクリプト を 含ん で いる こと を 示す ディレクトリ を 記述 し ます
xml dom text data	文字列 による テキストノード の 内容 です
optparse option types	types は 型名 の タプル です
unittest testresult expectedfailures	testcase と 例外 の トレースバック 情報 を フォーマット し た 文字列 の 2 要素 タプル から なる リスト
optparse option actions	全て の アクション は actions に リスト さ れ て い なけれ ば なり ませ ん
wsgiref handlers basehandler wsgi run once	wsgi .run _once 環境 変数 で 使わ れる 値
rfc822 addresslist addresslist	アドレス あたり 一つ の 文字 列 ペア で 構成 さ れる タプル から なる リスト です
optparse option nargs	( デフォルト : 1 )
shlex shlex infile	現在 の 入力 ファイル 名 です
pyclbr class super	記述 しよ う とし て いる 対象 クラス の 、 直接 の 基底 クラス 群 について 記述 し て いる class オブジェクト の リスト です
csv dialect lineterminator	writer が 作り出す 各行 を 終端 する 際 に 用い られる 文字 列 です
filecmp dircmp common funny	a および b の 両方 に あり 、 ディレクトリ 間 で タイプ が 異 なる か 、 os .stat が エラー を 報告 する よう な 名前 です
unittest testresult skipped	testcase インスタンス と 理由 の 文字列 の 2 要素 タプル から なる リスト を 保持 し ます
select kevent udata	ユーザー 定義 値
ctypes _simplecdata value	この 属性 は 、 インスタンス の 実際 の 値 を 持ち ます
cookielib cookie version	整数 また は none
datetime datetime microsecond	range ( 1 0 0 0 0 0 0 ) 内 の 値 です
urllib2 basehandler parent	有効 な openerdirector です
datetime time hour	range ( 2 4 ) 内 の 値 です
basehttpserver protocol version	この 値 に は 応答 に 使わ れる http プロトコル の バージョン を 指定 し ます
xml parsers expat xmlparser currentbyteindex	パーサ へ の 入力 の 、 現在 の バイトインデックス
io textiobase newlines	文字列 、 文字列 の タプル 、 また は none で 、 改行 が どの よう に 読み 換え られる か を 指定 し ます
cookielib cookie value	クッキー の 値 ( 文字列 )、 あるい は none
xml dom attr value	その 要素 の text value . これ は nodevalue 属性 の 別名 です
userdict iterableuserdict data	userdict クラス の 内容 を 保存 する ため に 使わ れる 実際 の 辞書
unittest testloader testmethodprefix	テストメソッド の 名前 と 判断 さ れる メソッド 名 の 接頭 語 を 示す 文字列
io textiobase encoding	エンコーディング 名 で 、 ストリーム の バイト 列 を 文字列 に デコード する とき 、 また 文字列 を バイト 列 に エンコード する とき に 使わ れ ます
tarfile tarinfo size	バイト 単位 で の サイズ
optparse option type checker	type _checker は 辞書 で 型名 を 型 チェック 関数 に 対応 付ける もの です
wsgiref handlers basehandler error headers	エラーレスポンス で 使わ れる http ヘッダ です
optparse option default	コマンドライン に 指定 が なかっ た とき に この オプション の 対象 に 使わ れる 値 です
unittest testresult failures	testcase と 例外 の トレースバック 情報 を フォーマット し た 文字列 の 2 要素 タプル から なる リスト
zipfile zipinfo compress type	アーカイブメンバ の 圧縮 形式
email charset charset input charset	最初 に 指定 さ れる 文字 セット です
basehttpserver wfile	クライアント に 返送 する 応答 を 書き込む ため の 出力 ストリーム が 入っ て い ます
cookielib defaultcookiepolicy strict ns set initial dollar	set -cookie : ヘッダ で 、 '$ ' で 始まる 名前 の クッキー を 無視 し ます
htmllib htmlparser nofill	ブール 値 の フラグ で 、 空白 文字 を 縮約 し たく ない とき に は 真 、 縮約 する とき に は 偽 に し ます
shlex shlex whitespace split	この 値 が true で あれ ば 、 トークン は 空白 文字 で のみ で 分割 さ れ ます
doctest unexpectedexception example	失敗 し た example オブジェクト です
unittest testcase maxdiff	この 属性 は 、 アサーションメソッド が 失敗 を レポート する 時 に 表示 する 差分 の 長さ を コントロール し ます
simplehttpserver simplehttprequesthandler extensions map	拡張子 を mime 型指定子 に対応付ける 辞書 です
optparse option callback args	callback に 渡さ れる 標準 的 な 4つ の コールバック 引数 の 後ろ に 追加 する 、 位置 指定 引数 と キーワード 引数
sqlite3 cursor lastrowid	この 読み込み 専用 の 属性 は 、 最後 に 変更 し た row の rowid を 提供 し ます
numbers rational numerator	抽象 プロパティ
xml etree elementtree attrib	エレメント の アトリビュート を 保持 する 辞書 です
zipfile zipinfo volume	ファイルヘッダ の ボリュームナンバ
datetime date max	表現 できる 最も 新しい 日付 で 、 date (maxyear , 1 2 , 3 1 ) です
threading thread daemon	スレッド の デーモンフラグ です
cookie morsel value	クッキー の 値
tarfile tarfile posix	この 値 を true に する こと は 、 format を ustar _format に する こと と 同じ です
cookielib cookiepolicy netscape	netscape プロトコル を 実装 し て いる こと を 示し ます
csv dialect skipinitialspace	true の 場合 、 delimiter の 直後 に 続く 空白 は 無視 さ れ ます
pyclbr class module	クラス 記述 オブジェクト が 記述 し て いる 対象 の クラス を 定義 し て いる モジュール の 名前 です
popen2 popen3 pid	子 プロセス の プロセス 番号 です
optparse option action	( デフォルト : " store ")
basehttpserver server version	サーバ の ソフトウェアバージョン を 指定 し ます
subprocess popen stderr	stderr 引数 が pipe の 場合 、 この 属性 に は 子 プロセス の エラー 出力 に 使わ れる ファイルオブジェクト に なり ます
xml dom namednodemap length	属性 リスト の 長さ です
popen2 popen3 tochild	子 プロセス へ の 入力 を 提供 する ファイルオブジェクト です
xml dom documenttype notations	記法 の 定義 を 与える namednodemap です
cmd cmd intro	イントロ あるい は バナー として 表示 さ れる 文字列
rfc822 message unixfrom	メッセージ に unix from 行 が ある 場合 は その 行 、 そう で なけれ ば 空文 字列 に なり ます
filecmp dircmp same files	a および b 両方 に あり 、 一致 する ファイル です
xml dom documenttype entities	外部 エンティティ の 定義 を 与える namednodemap です
zipfile zipinfo flag bits	zip フラグビット 列
datetime datetime tzinfo	datetime コンストラクタ に tzinfo 引数 として 与え られ た オブジェクト に なり 、 何 も 渡さ れ なかっ た 場合 に は none に なり ます
datetime time min	表現 できる 最 も 古い datetime で 、 time ( 0 , 0 , 0 , 0 ) です
ctypes pydll _handle	ライブラリ へ の アクセス に 用い られる システムハンドル
xml dom node parentnode	現在 の ノード の 親 ノード か 、 文書 ノード の 場合 に は none に なり ます
xml dom node previoussibling	この ノード と 同じ 親 ノード を 持ち 、 直前 にくる ノード です
xml dom nodelist length	シーケンス 中 の ノード の 数 です
object __members__	バージョン 2 . 2 で 撤廃 : オブジェクト の 属性 から なる リスト を 取得 する に は 、 組み込み 関数 dir を 使っ て く ださい
uuid uuid urn	rfc 4 1 2 2 で 規定 さ れる urn で の uuid
struct struct format	この struct オブジェクト を 作成 する 時 に 利用 さ れ た フォーマット 文字 列 です
cookielib cookie domain specified	サーバ が ドメイン を 明示 的 に 指定 し て いれ ば 真 を 返し ます
xml dom node prefix	tagname の コロン が あれ ば 、 コロン 以前 の 部分 に 、 なけれ ば 空文 字列 に なり ます
datetime date min	表現 できる 最 も 古い 日付 で 、 date (minyear , 1 , 1 ) です
subprocess popen returncode	poll か wait ( か 、 間接 的 に communicate ) から 設定 さ れ た 、 子 プロセス の 終了 ステータス が 入り ます
shlex shlex escape	エスケープ 文字 と 見なさ れる 文字 群 です
pyclbr function file	関数 を 定義 し てる def 文 が 入っ て いる ファイル の 名前 です
ctypes _fields_	構造体 の フィールド を 定義 する シーケンス
tarfile tarinfo gid	ファイルメンバ を 保存 し た 元 の ユーザ の グループ id です
multiprocessing managers basemanager address	マネージャ が 使用 する アドレス です
shlex shlex eof	ファイル の 終端 を 決定 する のに 使わ れる トークン です
datetime datetime day	1 から 与え られ た 月 と 年 に おける 日数 まで の 値 です
xml parsers expat xmlparser errorcolumnnumber	エラー の 発生 し た カラム 番号 です
zipfile zipinfo compress size	圧縮後 の データ の サイズ
textwrap textwrapper initial indent	( デフォルト : '' ) 折り返し が 行わ れる 出力 の 一行 目 の 先頭 に 付け られる 文字列
zipimport zipimporter prefix	zip ファイル 中 の モジュール を 検索 する サブパス です
xml dom node nodevalue	この 属性 は ノード 型 ごと に 異なる 意味 を 持ち ます ; 詳しく は dom 仕様 を 参照 し て くだ さい
select kevent data	フィルタ 固有 の データ
numbers rational denominator	抽象 プロパティ
file name	ファイルオブジェクト が open を 使っ て 生成 さ れ た 時 の ファイル の 名前 です
filecmp dircmp common dirs	a および b の 両方 に ある サブディレクトリ です
re regexobject pattern	re オブジェクト が それ から コンパイル さ れ た パターン 文字 列 です
array array typecode	アレイ を 作る とき に 使う 型 コード 文字 です
doctest example exc msg	実行 例 が 例外 を 生成 する と 期待 さ れる 場合 の 例外 メッセージ です
uuid uuid fields	uuid の 6 つの 整数 フィールド を 持つ タプル で 、 これ は 6 つの 個別 の 属性 と 2 つの 派生 し た 属性 として も 取得 可能 です
pyclbr class methods	メソッド 名 を 行番 号 に対応付ける 辞書 です
xml parsers expat xmlparser currentlinenumber	パーサ へ の 入力 の 、 現在 の 行番 号
uuid uuid bytes le	1 6 バイト 文字列 （ time _low , time _mid , time _hi _version を リトルエンディアン で 持つ ） の uuid
optparse option metavar	( デフォルト : オプション 文字 列 から )
cookielib cookie secure	その クッキー を 返せる の が 安全 な 接続 のみ なら ば 真 を 返し ます
cookielib filecookiejar delayload	真 で あれ ば 、 クッキー を 読み込む さい に ディスク から 遅延 読み込み ( lazy ) します
datetime date month	両 端値 を 含む 1 から 1 2 まで の 値 です
urllib2 httpcookieprocessor cookiejar	クッキー の 入っ て いる cookielib .cookiejar オブジェクト です
xml dom node childnodes	この ノード 内 に 収め られ て いる ノード から なる リスト です
re regexobject flags	re オブジェクト が コンパイル さ れ た とき 使わ れ た flags 引数 です
xml dom document documentelement	ドキュメント の 唯 一無 二 の ルート 要素 です
optparse option store actions	“store ” アクション は ここ に も リスト さ れ ます
csv csvwriter dialect	writer で 使わ れる 表現 形式 の 読み取り 専用 の 記述 です
memoryview strides	配列 の それぞれ の 次元 に対し て 、 それぞれ の 要素 に アクセス する のに 必要 な バイト 数 を 表す 、 長さ ndim の 整数 の タプル です
optparse option const	定数 を 格納 する 動作 の ため の 、 その 定数 です
filecmp dircmp right only	b だけ に ある ファイル および サブディレクトリ です
cookielib defaultcookiepolicy strict ns domain	netscape クッキー に対する ドメインマッチング の 規則 を どの 程度 厳 しく する か を 指示 する フラグ です
zipfile zipinfo file size	圧縮 前 の ファイル の サイズ
csv dialect quotechar	delimiter や quotechar といっ た 特殊 文字 を 含む か 、 改行 文字 を 含む フィールド を クオート する 際 に 用い られる 1 文字 から なる 文字 列 です
datetime time max	表現 できる 最も 新しい datetime で 、 time ( 2 3 , 5 9 , 5 9 , 9 9 9 9 9 9 , tzinfo =none ) です
xml parsers expat expaterror lineno	エラー が 検出 さ れ た 場所 の 行番 号 です
textwrap textwrapper drop whitespace	( デフォルト : true ) 真 の 場合 、 ラップ 後 に 行末 や 行頭 に ある スペース が 削除 さ れ ます
collections defaultdict default factory	この 属性 は _ _ missing __ メソッド によって 使わ れ ます
ossaudiodev oss_audio_device mode	ファイル の i /o モード で 、 " r ", " rw ", "w " のどれ か です
memoryview readonly	メモリ が 読み込み 専用 か を 表す ブール です
wsgiref handlers basehandler http version	origin _server が true の 場合 、 この 文字 列属 性 は クライアント へ の レスポンスセット の http バージョン の 設定 に 使わ れ ます
uuid uuid hex	3 2 文字 の 1 6 進数 文字 列 で の uuid
shlex shlex escapedquotes	quotes のうち 、 escape で 定義 さ れ た エスケープ 文字 を 解釈 する 文字 群 です
filecmp dircmp left list	a に ある ファイル および サブディレクトリ です
rexec rexec ok path	import が 制限 さ れ た 環境 で 実行 さ れる 時 に 検索 さ れる ディレクトリー を 格納 し て い ます
shlex shlex wordchars	複数 文字 から なる トークン を 構成 する ため に バッファ に 蓄積 し て いく よう な 文字 から なる 文字 列 です
ctypes _funcptr argtypes	関数 が 受け 取る 引数 の 型 を 指定 する ため に ctypes 型 の タプル を 代入 し ます
exceptions baseexception args	例外 コンストラクタ に 与え られ た 引数 の タプル です
datetime datetime year	両 端値 を 含む minyear から maxyear まで の 値 です
socketserver baseserver timeout	タイムアウト 時間 (秒 )、 もしく は 、 タイムアウト を 望ま ない 場合 に none
memoryview shape	メモリ の 形状 を n 次元 配列 として 与える 、 長さ ndim の 整数 の タプル です
xml dom node firstchild	この ノード に 子 ノード が ある 場合 、 その 先頭 の ノード です
xml parsers expat xmlparser currentcolumnnumber	パーサ へ の 入力 の 、 現在 の カラム 番号
basehttpserver responses	この 変数 は エラーコード を 表す 整数 を 二つ の 要素 を もつ タプル に対応付け ます
multiprocessing process name	プロセス 名 です
basehttpserver headers	messageclass クラス 変数 で 指定 さ れ た クラス の インスタンス を 保持 し て い ます
email charset charset output codec	unicode を output _charset に 変換 する ため の python 用 codec 名 です
unittest testresult buffer	true が 設定 さ れる と 、 sys .stdout と sys .stderr は 、 starttest から stoptest が 呼ば れる まで の 間 バッファリング さ れ ます
io textiobase buffer	textiobase が 扱う 根底 の バイナリバッファ ( bufferediobase インスタンス ) です
cookielib defaultcookiepolicy strict ns set path	要求 し た uri に パス が マッチ し ない クッキ の 設定 を 禁止 し ます
shlex shlex lineno	ソース 行番 号 ( 遭遇 し た 改行 の 数 に 1 を 加え た もの ) です
mimetypes mimetypes types map	ファイル 名拡 張子 を mime 型 に マッピング するる 辞書
unittest testloader suiteclass	テスト の リスト から テストスイート を 構築 する 呼び出し 可能 オブジェクト
email message message epilogue	epilogue 属性 は メッセージ の 最後 の mime 境界 文字 列 から メッセージ 末尾 まで の テキスト を 含む もの で 、 それ 以外 は preamble 属性 と 同じ です
cookielib cookie comment	この クッキー の 働き を 説明 する 、 サーバ から の コメント 文字 列 、 あるい は none
doctest example indent	実行例 の 入っ て いる 文字 列 の インデント 、 すなわち 実行 例 の 最初 の プロンプト より 前 に ある 空白 文字 の 数 です
cookielib defaultcookiepolicy domainliberal	0 と 同じ です ( つまり 、 上述 の netscape の ドメイン 厳密 性 フラグ が すべ て オフ に さ れ ます )
zipfile zipinfo header offset	ファイルヘッダ へ の バイト 数 で 表し た オフセット
select kevent fflags	フィルタ 依存 の フラグ
datetime time minute	range ( 6 0 ) 内 の 値 です
simplexmlrpcserver simplexmlrpcserver rpc paths	この 属性 値 は xml -rpc リクエスト を 受け 付ける url の 正当 な パス 部分 を リスト する タプル で なけれ ば なり ませ ん
ctypes _funcptr errcheck	python 関数 また は 他 の 呼び出し 可能 オブジェクト を この 属性 に 代入 し ます
xml dom documenttype internalsubset	ドキュメント の 完全 な 内部 サブセット を 与える 文字 列 です
xmlrpclib fault faultcode	失敗 の タイプ を 示す 文字列
socketserver baseserver allow reuse address	サーバ が アドレス の 再使 用 を 許す かど う か を 示す値 です
class __name__	クラス また は 型 の 名前 です
csv csvreader dialect	パーサ で 使わ れる 表現 形式 の 読み取り 専用 の 記述 です
tarfile tarinfo pax headers	pax 拡張 ヘッダ に 関連 付け られ た 、 key -value ペア の 辞書
unittest testresult shouldstop	true が 設定 さ れる と stop により テスト の 実行 が 停止 し ます
multiprocessing process daemon	デーモンプロセス で ある かどう か の フラグ で あり 、 ブール 値 を 設定 し ます
xml dom documenttype publicid	文書 型定 義 ( document type definition ) の 外部 サブセット に対する 公開 識別子 ( public identifier ) です
ctypes _cdata _b base_	ctypes 型 データ の インスタンス は 、 それ 自身 の メモリブロック を 持た ず 、 基底 オブジェクト の メモリブロック の 一部 を 共有 する こと が あり ます
shlex shlex commenters	コメント の 開始 として 認識 さ れる 文字 列 です
tarfile tarinfo name	アーカイブメンバー の 名前
io textiobase errors	この エンコーダ や デコーダ の エラー 設定 です
xml dom documenttype systemid	文書 型定 義 ( document type definition ) の 外部 サブセット に対する システム 識別子 ( system identifier ) です
xml parsers expat xmlparser errorbyteindex	エラー が 発生 し た バイト の インデクス です
wsgiref handlers basehandler error status	エラーレスポンス で 使わ れる http ステータス です
cookielib filecookiejar filename	クッキー を 保存 する デフォルト の ファイル 名 を 指定 し ます
cookielib cookie expires	クッキー の 期限 が 切れる 日時 を あわらす 整数 ( エポック から 経過 し た 秒数 )、 あるい は none
sqlite3 connection iterdump	データベース を sql test フォーマット で ダンプ する ため の イテレータ を 返し ます
email charset charset body encoding	header _encoding と 同じ です が 、 この 値 は メッセージ 本体 の ため の エンコーディング を 記述 し ます
optparse option typed actions	“typed ” アクション は ここ に も リスト さ れ ます
cmd cmd doc header	ヘルプ 出力 に 文書化 さ れ た コマンド の セクション が ある 場合 に 表示 する ヘッダ
class __mro__	この 属性 は メソッド の 解決 に 探索 さ れる 基底 クラス の タプル です
imaplib imap4 debug	デバッグ 出力 を 制御 する ため の 整数 値 です
subprocess popen stdout	stdout 引数 が pipe の 場合 、 この 属性 に は 子 プロセス の 出力 に 使わ れる ファイルオブジェクト に なり ます
re matchobject string	match あるい は search に渡さ れ た 文字 列 です
modulefinder modulefinder modules	モジュール 名 を モジュール に 結びつける 辞書
unittest testresult unexpectedsuccesses	意図 し た 失敗 の マーク が 付い て い ながら 成功 し て しまっ た testcase の インスタンス の リスト
urllib2 httperror code	rfc 2 6 1 6 に 定義 さ れ て いる http ステータスコード
datetime datetime month	両 端値 を 含む 1 から 1 2 まで の 値 です
htmllib htmlparser formatter	パーザ に 関連 付け られ て いる フォーマッタインスタンス です
doctest unexpectedexception exc info	予期 し ない 例外 について の 情報 の 入っ た タプル で 、 sys .exc _info が 返す の と 同じ もの です
memoryview format	ビュー の それぞれ の 要素 に対する 、( struct モジュール の スタイル で の ) フォーマット を 含む 文字 列 です
filecmp dircmp diff files	a および b 両方 に ある が 、 一致 し ない ファイル です
xml dom node lastchild	この ノード に 子 ノード が ある 場合 、 その 末尾 の ノード です
file errors	エンコーディング に 用い られる 、 unicode エラーハンドラ です
datetime timedelta resolution	timedelta オブジェクト が 等しく なら ない 最小 の 時間 差 で 、 timedelta (microseconds = 1 ) です
subprocess popen stdin	stdin 引数 が pipe の 場合 、 この 属性 に は 子 プロセス の 入力 に 使わ れる ファイルオブジェクト に なり ます
xml dom node nodetype	ノード ( node ) の 型 を 表現 する 整数 値 です
multiprocessing process authkey	プロセス の 認証 キー です ( バイト 文字 列 です )
tarfile tarinfo mtime	最終更 新 時刻
zipfile zipinfo comment	各 アーカイブメンバ に対する コメント
subprocess popen pid	子 プロセス の プロセス id が 入り ます
doctest example source	実行例 の ソースコード が 入っ た 文字 列 です
doctest doctest globs	実行例 を 実行 する 名前 空間 ( いわゆる グローバル 変数 ) です
tarfile tarinfo linkname	ターゲットファイル 名 の 名前 で 、 これ は タイプ lnktype と symtype の tarinfo オブジェクト に だけ 存在 し ます
cookielib cookie domain initial dot	サーバ が 明示 的 に 指定 し た ドメイン が 、 ドット ( '. ') で 始まっ て いれ ば 真 を 返し ます
doctest doctestfailure example	失敗 し た example オブジェクト です
imaplib imap4 protocol version	サーバ から 返さ れ た capability 応答 に ある 、 サポート さ れ て いる 最新 の プロトコル です
rfc822 message headers	ヘッダ 行 の セット 全体 が 、( setitem を 呼び出し て 変更 さ れ ない 限り ) 読み出さ れ た 順番 に 入れ られ た リスト です
select kevent filter	カーネルフィルタ の 名前
object __dict__	オブジェクト の ( 書き込み 可能 な ) 属性 を 保存 する ため に 使わ れる 辞書 また は 他 の マップ 型 オブジェクト です
textwrap textwrapper width	( デフォルト : 7 0 ) 折り返し が 行わ れる 行 の 最大 の 長さ
optparse option choices	"choice " 型 オプション に対し て ユーザ が 選べる 選択 肢 と なる 文字 列 の リスト です
cookielib cookie path	クッキー の パス 名 ( 文字列 、 例 : '/ acme /rocket _launchers ')
file mode	ファイル の i /o モード です
xml parsers expat xmlparser buffer used	buffer _text が 利用 可能 な とき 、 バッファ に 保持 さ れ た バイト 数 です
re regexobject groups	パターン に ある キャプチャグループ の 数 です
httplib httpresponse version	サーバ が 使用 し た http プロトコルバージョン です
doctest example lineno	この 実行 例 を 含む 文字 列 に おける 実行 例 が 始まる 行番 号 です
multiprocessing connection listener address	リスナーオブジェクト が 使用 中 の アドレス です
datetime date year	両 端値 を 含む minyear から maxyear まで の 値 です
filecmp dircmp funny files	a および b 両方 に ある が 、 比較 さ れ なかっ た ファイル です
shlex shlex quotes	文字列 引用 符 と 見なさ れる 文字 群 です
cmd cmd lastcmd	最後 の 空 で ない コマンドプリフィックス
ctypes _pack_	インスタンス の 構造 体 フィールド の アライメント を 上書き できる よう に する オブション の 小整数
class __bases__	クラスオブジェクト の 基底 クラス から なる タプル です
struct struct size	format に対応 する struct ( とそれ による 文字列 ) の サイズ を 計算 し た もの です
basehttpserver rfile	入力 ストリーム が 入っ て おり 、 その ファイルポインタ は オプション 入力 データ 部 の 先頭 を 指し て い ます
multiprocessing connection listener last accepted	最後 に コネクション を 受け付け た アドレス です
subprocess startupinfo dwflags	特定 の startupinfo の メンバ が 、 プロセス が ウィンドウ を 生成 する とき に 使わ れる か を 決定 する ビットフィールド です :
cookielib cookie comment url	この クッキー の 働き を 説明 する 、 サーバ から の コメント の リンク url 、 あるい は none
easydialogs progressbar curval	プログレスバー の 現在 の 値 ( 整数 型 あるい は 長整 数型 ) です
httplib httpresponse reason	サーバ から 返さ れる 応答 の 理由 文 です
xml dom processinginstruction target	最初 の 空白 文字 まで の 処理 命令 の 内容 です
multiprocessing process pid	プロセス id を 返し ます
csv csvreader line num	ソースイテレータ から 読ん だ 行数 です
re matchobject lastgroup	最後 に マッチ し た 取り込み グループ の 名前 です
xml parsers expat xmlparser ordered attributes	この 属性 を ゼロ 以外 の 整数 に する と 、 報告 さ れる (xml ノード の ) 属性 を 辞書 型 で は なく リスト 型 に し ます
pyclbr function lineno	file で 指定 さ れ た ファイル に おける def 文 の 行番 号 です
filecmp dircmp common	a および b の 両方 に ある ファイル および サブディレクトリ です
multifile multifile level	現在 の パート に おける 入れ子 の 深さ です
csv dialect quoting	クオート がいつ writer によっ て 生成 さ れる か 、 また reader によっ て 認識 さ れる か を 制御 し ます
wsgiref handlers basehandler wsgi file wrapper	wsgi .file _wrapper ファクトリ 、 また は none です
simplehttpserver simplehttprequesthandler server version	この 値 は " simplehttp /" + __ version __ になり ます
wsgiref handlers basehandler traceback limit	デフォルト の log _exception メソッド で 出力 さ れる トレースバック 出力 に 含まれる 最大 の フレーム 数 です
datetime datetime min	表現 できる 最 も 古い datetime で 、 datetime (minyear , 1 , 1 , tzinfo =none ) です
tarfile tarinfo type	ファイルタイプ です
xmlrpclib protocolerror errmsg	エラーメッセージ また は 診断 文字列
uuid uuid bytes	1 6 バイト 文字 列 （ バイトオーダー が ビッグエンディアン の 6 つの 整数 フィールド を 持つ ） の uuid
doctest unexpectedexception test	実行 例 が 失敗 し た 時 に 実行 さ れ て い た doctest オブジェクト です
xml dom node nextsibling	この ノード と 同じ 親 ノード を 持ち 、 直後 にくる ノード です
ctypes _funcptr restype	外部 関数 の 結果 の 型 を 指定 する ため に ctypes 型 を 代入 する
io bufferediobase raw	bufferediobase が 扱う 根底 の 生 ストリーム ( rawiobase インスタンス ) を 返し ます
pyclbr class file	クラス を 定義 し て いる class 文 が 入っ て いる ファイル の 名前 です
re matchobject endpos	regexobject の search か match に渡さ れ た endpos の 値 です
sqlite3 cursor description	この 読み込み 専用 の 属性 は 、 最後 の クエリ の 結果 の カラム 名 を 提供 し ます
tarfile tarinfo gname	ファイルメンバ を 保存 し た 元 の ユーザ の グループ 名 です
socketserver baseserver requesthandlerclass	ユーザ が 提供 する 要求 処理 クラス です ; 要求 ごと に この クラス の インスタンス が 生成 さ れ ます
zipfile zipinfo crc	圧縮 前 の ファイル の crc - 3 2 チェックサム
subprocess startupinfo hstderror	dwflags が startf _usestdhandles を 指定 すれ ば 、 この メンバ が プロセス の 標準 エラー 処理 です
io fileio name	ファイル 名
zipfile zipfile comment	zip ファイル の 付け られ た コメント です
uuid uuid version	uuid の version 番号 （ 1 から 5 、 variant が rfc _ 4 1 2 2 で ある 場合 だけ 意味 が あり ます ）
sqlite3 connection text factory	この 属性 を 使っ て text データ 型 を どの オブジェクト で 返す か を 制御 でき ます
io iobase closed	ストリーム が 閉じ られ て い た 場合 true に なり ます
zipfile zipinfo reserved	予約 領域
basehttpserver messageclass	http ヘッダ を 解釈 する ため の rfc 8 2 2 . message 類似 の クラス を 指定 し ます
repr repr maxlevel	再帰 的 な 表現 を 作る 場合 の 深さ 制限
sqlite3 connection total changes	データベース 接続 が 開始 さ れ て 以来 の 行 の 変更 ・ 挿入 ・ 削除 が なさ れ た 行 の 総数 を 返し ます
xml parsers expat xmlparser returns unicode	この 属性 を ゼロ 以外 の 整数 に する と 、 ハンドラ 関数 に unicode 文字列 が 渡さ れ ます
doctest doctest name	doctest を 識別 する 名前 の 文字 列 です
doctest doctest lineno	filename 中 で doctest の テスト 実行 例 が 始まっ て いる 行 の 行番 号 です
datetime time microsecond	range ( 1 0 0 0 0 0 0 ) 内 の 値 です
netrc netrc macros	マクロ 名 を 文字列 の リスト に対応付け て いる 辞書 です
csv dialect delimiter	フィールド 間 を 分割 する のに 用い られる 1 文字 から なる 文字 列 です
functools partial args	最左 の 位置 引数 で 、 partial オブジェクト の 呼び出し 時 に その 呼び出し の 際 の 位置 引数 の 前 に 追加 さ れ ます
instance __class__	クラスインスタンス が 属し て いる クラス です
xml parsers expat expaterror code	特定 の エラー に おける expat の 内部 エラー 番号 です
curses textpad textbox stripspaces	この データメンバ は ウィンドウ 内 の 空白 領域 の 解釈 方法 を 制御 する ため の フラグ です
cmd cmd ruler	ヘルプメッセージ の ヘッダ の 下 に 、 区切り行 を 表示 する ため に 使わ れる 文字
userstring mutablestring data	userstring クラス の 内容 を 保存 する ため に 使わ れる 実際 の python 文字 列 また は ユニコードオブジェクト
xml dom attr prefix	名前 に コロン が あれ ば コロン 以前 の 部分 に 、 なけれ ば 空文 字列 に なり ます
tarfile tarinfo mode	許可 ビット
memoryview ndim	メモリ が 表す 多次 元 配列 が 何次 元 か を 示す 整数 です
rexec rexec nok builtin names	制限 さ れ た 環境 で 実行 する プログラム で は 利用 でき ない で あろ う 、 組み込み 関数 の 名前 を 格納 し て い ます
ast ast lineno	ast .expr や ast .stmt の サブクラス の インスタンス に は さらに lineno や col _offset といっ た 属性 が あり ます
xml dom node nodename	この 属性 は ノード 型 ごと に 異なる 意味 を 持ち ます ; 詳しく は dom 仕様 を 参照 し て くだ さい
filecmp dircmp common files	a および b の 両方 に ある ファイル です
ast ast _fields	各 具象 クラス は 属性 _ fields を 持っ て おり 、 すべて の 子 ノード の 名前 を そこ に 保持 し て い ます
object __methods__	バージョン 2 . 2 で 撤廃 : オブジェクト の 属性 から なる リスト を 取得 する に は 、 組み込み 関数 dir を 使っ て く ださい
subprocess startupinfo hstdoutput	dwflags が startf _usestdhandles を 指定 すれ ば 、 この メンバ が プロセス の 標準 出力 処理 です
cookielib defaultcookiepolicy strict ns unverifiable	検証 不可能 な トランザクション に関する rfc 2 9 6 5 の 規則 を netscape クッキー に対し て も 適用 し ます
mimetypes mimetypes encodings map	ファイル 名拡 張子 を 符号 化型 に マッピング する 辞書
xmlrpclib binary data	binary インスタンス が カプセル 化 し て いる バイナリデータ
optparse option always typed actions	型 を 取る アクション ( つまり その オプション が 値 を 取る ) はここ に も リスト さ れ ます
xml dom node attributes	属性 オブジェクト の namednodemap です
threading thread ident	‘ スレッド 識別子 ’ 、 また は 、 スレッド が 開始 さ れ て い なけれ ば none です
pyclbr class lineno	file で 指定 さ れ た ファイル に おける class 文 の 行番 号 です
tarfile tarinfo uid	ファイルメンバ を 保存 し た 元 の ユーザ の ユーザ id です
doctest doctest docstring	テスト を 取り出し た docstring 自体 を 現す 文字 列 です
ctypes _cdata _b needsfree_	この 読み出し 専用 の 変数 は 、 ctypes データインスタンス が 、 それ 自身 に 割り 当て られ た メモリブロック を 持つ とき true に なり ます
uuid uuid int	1 2 8 ビット 整数 で の uuid
xml dom attr name	要素 型名 です
basehttpserver server	server インスタンス が 入っ て い ます
io blockingioerror characters written	ブロック 前 に ストリーム に 書き込ま れる 文字 数 を 保持 する 整数 値 です
wsgiref handlers basehandler wsgi multiprocess	wsgi .multiprocess 環境 変数 で 使わ れる 値
wsgiref handlers basehandler os environ	全て の リクエスト の wsgi 環境 に 含まれる デフォルト の 環境 変数
file encoding	この ファイル が 使っ て いる エンコーディング です
repr repr maxstring	文字列 の 表現 に おける 文字 数 の 制限
urllib2 urlerror reason	この エラー の 原因
unittest testresult testsrun	これ まで に 実行 し た テスト の 総数 です
tarfile tarfile pax headers	pax グローバルヘッダ に 含ま れる key -value ペア の 辞書
sched scheduler queue	読み込み 専用 の 属性 で 、 これ から の イベント が 実行 さ れる 順序 で 格納 さ れ た リスト を 返し ます
functools partial keywords	partial オブジェクト の 呼び出し 時 に 渡さ れる キーワード 引数 です
zipimport zipimporter archive	importer に 紐付け られ た zip ファイル の ファイル 名 で 、 サブパス は 含まれ ませ ん
pyclbr class name	クラス の 名前 です
select kevent ident	イベント を 特定 する ため の 値
datetime date day	1 から 与え られ た 月 と 年 に おける 日数 まで の 値 です
collections deque maxlen	deque の 最大 長 で 、 制限 さ れ て い なけれ ば none です
socketserver baseserver address family	サーバ の ソケット が 属し て いる プロトコルファミリ です
rexec rexec ok sys names	制限 さ れ た 環境 で 実行 する プログラム で 利用 できる 、 sys モジュール 内 の 関数 名 と 変数 名 を 格納 し て い ます
memoryview itemsize	メモリビュー の それぞれ の 要素 の バイト 数 です
basehttpserver error message format	クライアント に 返す エラー 応答 を 構築 する ため の 書式 化文 字列 を 指定 し ます
doctest doctestfailure test	実行 例 が 失敗 し た 時 に 実行 さ れ て い た doctest オブジェクト です
scrolledtext scrolledtext frame	テキスト と スクロールバーウィジェット を 取り囲む フレーム
doctest doctestfailure got	実行例 の 実際 の 出力 です
email charset charset input codec	input _charset を unicode に 変換 する ため の python 用 codec 名 です
xmlrpclib protocolerror headers	エラー の 原因 と なっ た http /https リクエスト を 含む 文字列
popen2 popen3 fromchild	子 プロセス から の 出力 を 提供 する ファイルオブジェクト です
rfc822 message fp	インスタンス 化 の 際 に 渡さ れ た ファイル また は ファイル 類似 オブジェクト です
io textiowrapper line buffering	行 バッファリング が 有効 か どう か
uuid uuid variant	uuid の 内部 レイアウト を 決定 する uuid の variant
xml dom comment data	文字列 による コメント の 内容 です
xml dom processinginstruction data	最初 の 空白 文字 以降 の 処理 命令 の 内容 です
zipfile zipinfo create version	この アーカイブ を 作成 し た pkzip の バージョン
xml parsers expat xmlparser errorlinenumber	エラー の 発生 し た 行番 号 です
basehttpserver path	リクエスト さ れ た パス が 入っ て い ます
sqlite3 connection isolation level	現在 の 分離 レベル を 取得 また は 設定 し ます
datetime datetime resolution	等しく ない datetime オブジェクト 間 の 最小 の 差 で 、 timedelta (microseconds = 1 ) です
mimetypes mimetypes suffix map	サフィックス を サフィックス に マップ する 辞書
filecmp dircmp subdirs	common _dirs の ファイル 名 を dircmp オブジェクト に対応付け た 辞書 です
pyclbr function name	関数 の 名前 です
optparse option dest	( デフォルト : オプション 文字 列 を 使う )
multifile multifile last	最後 に 見つかっ た ファイル 終了 イベント が メッセージ 終了 マーカ で あっ た 場合 に 真と なり ます
zipfile zipfile debug	使用 する デバッグ 出力 レベル
xml parsers expat xmlparser buffer text	この 値 を 真に する と 、 xmlparser オブジェクト が expat から 返さ れ た も と の 内容 を バッファ に 保持 する よう に なり ます
numbers complex real	抽象 プロパティ
datetime time second	range ( 6 0 ) 内 の 値 です
repr repr maxother	この 制限 は repr オブジェクト に 利用 できる 特定 の 書式 化 メソッド が ない オブジェクト 型 の サイズ を コントロール する ため に 使わ れ ます
xml dom node namespaceuri	要素名 に 関連 付け られ た 名前 空間 です
numbers complex imag	抽象 プロパティ
cmd cmd identchars	コマンド の 先頭 の 語として 受け 入れ られる 文字 の 文字列
basehttpserver client address	http クライアント の アドレス を 参照 し て いる 、 ( host , port ) の 形式 を とる タプル が 入っ て い ます
popen2 popen3 childerr	コンストラクタ に capturestderr を 渡し た 際 に は 子 プロセス から の 標準 エラー 出力 を 提供 する ファイルオブジェクト で 、 そう で ない 場合 none に なり ます
filecmp dircmp left only	a だけ に ある ファイル および サブディレクトリ です
ctypes pydll _name	コンストラクタ に 渡さ れ た ライブラリ の 名前
xml dom element tagname	要素 型名 です
optparse option callback	アクション が " callback " で ある オプション に対し 、 この オプション が あっ た とき に 呼ば れる 呼び出し 可能 オブジェクト です
cookie morsel key	cookie の 名前
basehttpserver sys version	python 処理 系 の バージョン が , version _string メソッド や server _version クラス 変数 で 利用 可能 な 形式 で 入っ て い ます
unittest testcase failureexception	test メソッド が 送出 する 例外 を 指定 する クラス 属性 です
textwrap textwrapper subsequent indent	( デフォルト : '' ) 一行目 以外 の 折り返し が 行わ れる 出力 の すべ て の 行 の 先頭 に 付け られる 文字列
wsgiref handlers basehandler wsgi multithread	wsgi .multithread 環境 変数 で 使わ れる 値
doctest example want	実行例 の ソースコード を 実行 し た 際 の 期待 する 出力 ( 標準 出力 と 、 例外 が 生じ た 場合 に は トレースバック ) です
socketserver baseserver socket type	サーバ が 使う ソケット の 型 です ; 一般的 な 2つ の 値 は 、 socket .sock _stream と socket .sock _dgram です
xml parsers expat expaterror offset	エラー が 発生 し た 場所 の 行内 で の オフセット です
httplib httpresponse status	サーバ から 返さ れる 状態 コード です
urllib urlopener version	url を オープン する オブジェクト の ユーザエージェント を 指定 する 変数 です
zlib decompress unused data	圧縮 データ の 末尾 より 後 の バイト 列 が 入っ た 文字 列 です
re matchobject pos	regexobject の search か match に渡さ れ た pos の 値 です
xml dom attr localname	名前 に コロン が あれ ば コロン 以降 の 部分 に 、 なけれ ば 名前 全体 に なり ます
socketserver baseserver server address	サーバ が 要求 待ち を 行う アドレス です
xml dom node localname	tagname に コロン が あれ ば 、 コロン 以降 の 部分 に 、 なけれ ば tagname 全体 に なり ます
shlex shlex whitespace	空白 と 見なさ れ 、 読み飛ば さ れる 文字 群 です
tarfile tarinfo uname	ファイルメンバ を 保存 し た 元 の ユーザ の ユーザ 名 です
unittest testloader sorttestmethodsusing	gettestcasenames および 全 て の loadtestsfrom *( ) メソッド で メソッド 名 を ソート する 際 に 使用 する 比較 関数
repr repr maxdict	指定 さ れ た オブジェクト 型 に対する エントリ 表現 の 数 について の 制限
datetime datetime second	range ( 6 0 ) 内 の 値 です
repr repr maxlong	長整数 の 表現 の おける 文字 数 の 最大 値
io fileio mode	コンストラクタ に 渡さ れ た モード です
datetime time tzinfo	time コンストラクタ に tzinfo 引数 として 与え られ た オブジェクト に なり 、 何 も 渡さ れ なかっ た 場合 に は none に なり ます
xml etree elementtree tail	tail アトリビュート は エレメント に 結びつけ られ た 付加 的 な データ を 保持 する のに 使わ れ ます
cookielib defaultcookiepolicy domainstrict	domainstrictnodots |domainstrictnondomain と 同じ です
xml etree elementtree text	text アトリビュート は エレメント に 結びつけ られ た 付加 的 な データ を 保持 する のに 使わ れ ます
rexec rexec ok posix names	制限 さ れ た 環境 で 実行 する プログラム で 利用 できる 、 os モジュール 内 の 関数 の 名前 を 格納 し て い ます
xmlrpclib fault faultstring	失敗 の 診断 メッセージ を 含む 文字列
socketserver baseserver request queue size	要求 待ち 行列 ( queue ) の サイズ です
socketserver baseserver socket	サーバ が 入力 の 要求 待ち を 行う ため の ソケットオブジェクト です
datetime datetime minute	range ( 6 0 ) 内 の 値 です
zipfile zipinfo filename	アーカイブ 中 の ファイル の 名前
zipfile zipinfo create system	zip アーカイブ を 作成 し た システム を 記述 する 文字列
httplib httpresponse msg	応答 ヘッダ を 含む mimetools .message インスタンス です
datetime timedelta min	最小 の 値 を 表す timedelta オブジェクト で 、 timedelta (- 9 9 9 9 9 9 9 9 9 ) です
netrc netrc hosts	ホスト 名 を ( login , account , password ) から なる タプル に 対応 づけ て いる 辞書 です
rexec rexec ok builtin modules	安全 に インポート できる 組み込み モジュール の 名前 を 格納 し て い ます
zipfile zipinfo extra	拡張 フィールドデータ
unittest testresult failfast	true が 設定 さ れる と 、 stop が 始め の 失敗 もしく は エラー の 時 に 呼び出さ れ 、 テスト の 実行 が 終了 し ます
ossaudiodev oss_audio_device name	デバイスファイル の 名前 を 含む 文字 列 です
datetime datetime hour	range ( 2 4 ) 内 の 値 です
mimetypes mimetypes common types	ファイル 名拡 張子 を 非標 準 で は ある が 、 一般 に 使わ れ て いる mime 型 に マップ する 辞書
xml etree elementtree tag	この エレメント が 表す データ の 種類 を 示す 文字 列 です ( 言い 替える と 、 エレメント の 型 です )
unittest testresult errors	testcase と 例外 の トレースバック 情報 を フォーマット し た 文字列 の 2 要素 タプル から なる リスト
multiprocessing process exitcode	子 プロセス の 終了 コード です
basehttpserver command	http 命令 ( リクエスト 形式 ) が 入っ て い ます
array array itemsize	アレイ の 要素 1 つの 内部 表現 に 使わ れる バイト 長 です
ossaudiodev oss_audio_device closed	デバイス が 閉じ られ た かどう か を 示す 真偽 値 です
file closed	現在 の ファイルオブジェクト の 状態 を 示す ブール 値 です
xml parsers expat xmlparser buffer size	buffer _text が 真 の 時 に 使わ れる バッファ の サイズ です
email message message defects	defects 属性 は メッセージ を 解析 する 途中 で 検出 さ れ たすべて の 問題 点 ( defect 、 障害 ) の リスト を 保持 し て い ます
ctypes _anonymous_	無名 ( 匿名 ) フィールド の 名前 が 並べ あげ られ た オプション の シーケンス
ftplib ftp_tls ssl version	使用 する ssl の バージョン ( デフォルト は tlsv 1 ) です
cmd cmd prompt	入力 を 求める ため に 表示 さ れる プロンプト
xml dom documenttype name	doctype 宣言 で ルート 要素 の 名前 が 与え られ て いる 場合 、 その 値 に なり ます
xml parsers expat xmlparser errorcode	エラー を 特定 する 数値 による コード です
xmlrpclib protocolerror url	エラー の 原因 と なっ た uri また は url
threading thread name	識別 の ため に のみ 用い られる 文字 列 です
datetime date resolution	等しく ない 日付 オブジェクト 間 の 最小 の 差 で 、 timedelta (days = 1 ) です
cmd cmd use rawinput	フラグ で 、 デフォルト で は 真 です
doctest example options	オプションフラグ を true また は false に対応付け て いる 辞書 です
shlex shlex token	トークンバッファ です
re matchobject lastindex	最後 に マッチ し た 取り込み グループ の 整数 インデックス です
shlex shlex instream	shlex インスタンス が 文字 を 読み出し て いる 入力 ストリーム です
basehttpserver error content type	エラーレスポンス を クライアント に 送信 する 時 に 使う content -type http ヘッダ を 指定 し ます
functools partial func	呼び出し 可能 オブジェクト また は 関数 です
