weekday	weekday
logger	logger
configparser	configparser
pathname	pathname
wlist	wlist
mktemp	mktemp
delete	delete
ahi	ahi
library	library
filecookiejar	filecookiejar
curs	curs
getcomment	getcomment
coerce	coerce
tests	tests
errno	errno
checkcache	checkcache
left	left
writerow	writerow
pendown	pendown
xhdr	xhdr
testfile	testfile
buffer_size	buffer_size
getservbyport	getservbyport
nl	nl
browser	browser
attr	attr
create	create
sysbeep	sysbeep
logging	logging
text	text
showsyntaxerror	showsyntaxerror
askfileforopen	askfileforopen
subclass	subclass
getdefaultencoding	getdefaultencoding
_value	value
threading_algorithm	threading algorithm
os	os
_quit	quit
notify	notify
isgraph	isgraph
end	end
traceback	traceback
pkg_name	pkg_name
ldgettext	ldgettext
isgenerator	isgenerator
format	format
optionxform	optionxform
alive	alive
sendall	sendall
_getframe	_getframe
ifloordiv	ifloordiv
decoded_seq	decoded seq
getsizes	getsizes
field_names	field_names
fetch	fetch
issym	issym
validate	validate
skippedentity	skippedentity
shouldflush	shouldflush
expovariate	expovariate
tcdrain	tcdrain
how	how
termattrs	termattrs
recvfrom	recvfrom
createlock	createlock
hasattr	hasattr
dom	dom
noload	noload
tofolder	tofolder
newwidth	newwidth
strxfrm	strxfrm
toward	toward
302	302
tolist	tolist
putp	putp
tagname	tagname
incrementalparser	incrementalparser
str2	str2
getlogger	getlogger
sequence_of_strings	sequence of strings
isendwin	isendwin
int	int
subprocess	subprocess
rsplit	rsplit
recent	recent
setsampfmt	setsampfmt
modified	modified
unixfrom	unixfrom
framerate	framerate
help	help
builtin	builtin
parse	parse
testmod	testmod
getvaluebyqname	getvaluebyqname
tmpfile	tmpfile
expectedfailure	expectedfailure
euid	euid
testsource	testsource
kqueue	kqueue
defaulttestresult	defaulttestresult
setparams	setparams
input	input
heapreplace	heapreplace
nntp	nntp
optionflag	optionflag
environmentvarguard	environmentvarguard
relpath	relpath
isascii	isascii
locking	locking
updatescrollbars	updatescrollbars
psize	psize
collections	collections
lstat	lstat
mkstemp	mkstemp
choice	choice
isdigit	isdigit
nchannels	nchannels
copyfileobj	copyfileobj
derwin	derwin
openkey	openkey
coded_value	coded value
httpconnection	httpconnection
xcor	xcor
tokenize	tokenize
getservbyname	getservbyname
urlopen	urlopen
unquote	unquote
touchline	touchline
undo	undo
util	util
endidx	endidx
longest	longest
synchronized	synchronized
swapcase	swapcase
cookiepolicy	cookiepolicy
warnings	warnings
uuid1	uuid1
fragment1	fragment1
keypad	keypad
setprofile	setprofile
folders	folders
object	object
subwin	subwin
getlogin	getlogin
setpath	setpath
noraw	noraw
setrecursionlimit	setrecursionlimit
setpos	setpos
getwindowsversion	getwindowsversion
activate	activate
ext	ext
readscaled	readscaled
itermonthdays2	itermonthdays2
exitonclick	exitonclick
menubar	menubar
decl	decl
rset	rset
tanh	tanh
encoded	encoded
bye	bye
quantum	quantum
convert	convert
finish	finish
fsync	fsync
pkgutil	pkgutil
anydbm	anydbm
decimal	decimal
tmpnam	tmpnam
locked	locked
osfhandle	osfhandle
i	i
__init__	init
elem	elem
obj_or_type	obj_or_type
str	str
expression	expression
slider	slider
visibility	visibility
findlinestarts	findlinestarts
crop	crop
yeardays2calendar	yeardays2calendar
hostname	hostname
memset	memset
new_mailbox	new_mailbox
_exit	exit
test_support	test_support
other	other
iterable	iterable
adderror	adderror
allowremoval	allowremoval
monthdatescalendar	monthdatescalendar
issamenode	issamenode
fabs	fabs
easydialogs	easydialogs
randint	randint
opcodes	opcodes
chmod	chmod
testzip	testzip
levelname	levelname
converter	converter
quopri	quopri
poll	poll
getwriter	getwriter
clearok	clearok
spwd	spwd
walk	walk
read1	read1
a2b	a2b
server_title	server_title
base	base
if	if
cacheftphandler	cacheftphandler
sys	sys
pos	pos
reader	reader
prog	prog
gzip	gzip
epoll	epoll
time	time
knots	knots
nlargest	nlargest
getresuid	getresuid
longname	longname
encodepriority	encodepriority
infile	infile
wave_write	wave write
reduce	reduce
future_builtins	future builtins
fillcolor	fillcolor
parsesequence	parsesequence
or_	or_
openmixer	openmixer
c9	c9
c11	c11
blanklines	blanklines
imageop	imageop
getitimer	getitimer
getbegyx	getbegyx
servicename	servicename
unistr	unistr
mappriority	mappriority
expr	expr
getnode	getnode
back	back
lstrip	lstrip
dropwhile	dropwhile
template	template
window	window
authorizer	authorizer
importer	importer
http	http
or	or
popen2	popen2
global	global
resid	resid
namespaceuri	namespaceuri
interactiveconsole	interactiveconsole
sep	sep
printdir	printdir
prototype	prototype
fetchone	fetchone
runcall	runcall
imgfile	imgfile
cget	cget
layout	layout
begin_y	begin_y
errorhandler	errorhandler
term	term
rfc2231	rfc2231
namespace	namespace
isfifo	isfifo
oss_audio_device	oss audio device
redisplay	redisplay
pyhkey	pyhkey
array	array
contextlib	contextlib
setfillpoint	setfillpoint
ctypes	ctypes
ossaudiodev	ossaudiodev
interval	interval
ip_string	ip_string
der_cert_bytes	der cert bytes
isatty	isatty
any	any
getlast	getlast
make	make
isfile	isfile
compiled	compiled
map	map
factorial	factorial
uuidcreate	uuidcreate
prefix	prefix
irepeat	irepeat
flushkey	flushkey
c4	c4
debuglevel	debuglevel
_value	_value
setregid	setregid
priority	priority
hor	hor
frozenset	frozenset
framework	framework
urljoin	urljoin
exc_info	exc_info
endelementns	endelementns
tell	tell
spawn	spawn
dbhash	dbhash
ismappingtype	ismappingtype
update	update
methodhelp	methodhelp
unused	unused
ftphandler	ftphandler
itervaluerefs	itervaluerefs
pointer	pointer
quote	quote
readframes	readframes
sslsocket	sslsocket
critical	critical
postloop	postloop
shuffle	shuffle
nlines	nlines
issequencetype	issequencetype
new_y	new y
copystat	copystat
plistlib	plistlib
tab	tab
idiv	idiv
splitlines	splitlines
domimplementation	domimplementation
standalone	standalone
assertisnone	assertisnone
architecture	architecture
unpack_item	unpack_item
binary	binary
positioner	positioner
baseserver	baseserver
setchannels	setchannels
oss_mixer_device	oss mixer device
request	request
_makeresult	makeresult
pyclbr	pyclbr
default	default
xover	xover
mro	mro
playabs	playabs
verify	verify
access	access
getsourcelines	getsourcelines
eject	eject
getmaintype	getmaintype
theme	theme
dict	dict
heapmin	heapmin
seq_of_parameters	seq_of_parameters
vformat	vformat
argv	argv
setoption	setoption
change	change
declared	declared
maptypecreator	maptypecreator
yiq	yiq
scale	scale
stringio	stringio
node_or_string	node or string
params	params
abstractproperty	abstractproperty
writesamps	writesamps
support	support
oct	oct
mvwin	mvwin
parseresult	parseresult
wstring	wstring
tee	tee
commands	commands
unescape	unescape
getcontext	getcontext
getpath	getpath
state	state
getgid	getgid
writelines	writelines
cache	cache
blocked_domains	blocked_domains
izip	izip
format_string	format_string
sort	sort
ifmt	ifmt
app	app
p	p
hasfeature	hasfeature
mimetools	mimetools
acos	acos
s_k	s_k
model	model
fieldvalues	fieldvalues
dumps	dumps
astimezone	astimezone
reversed	reversed
lockf	lockf
tempfile	tempfile
redirect	redirect
st2list	st2list
def	def
field	field
addtests	addtests
abort	abort
factor	factor
guess	guess
globals	globals
database	database
num_params	num params
envvar	envvar
search_criterion	search_criterion
audio	audio
msvcrt	msvcrt
ms	ms
303	303
in	in
mgr1	mgr1
popen3	popen3
begin_x	begin_x
sunau	sunau
setrlimit	setrlimit
frees	frees
exc_info	exc info
put	put
reset	reset
_current	current
getdtdhandler	getdtdhandler
mirrored	mirrored
read	read
contains	contains
notationdeclhandler	notationdeclhandler
new_node	new node
clearcache	clearcache
handle	handle
break	break
start_response	start_response
sendcmd	sendcmd
old	old
server_title	server title
setfmt	setfmt
fd	fd
findertools	findertools
getcallargs	getcallargs
getche	getche
get	get
application	application
date	date
assigned	assigned
adler32	adler32
parseflags	parseflags
sub_key	sub_key
tan	tan
irshift	irshift
publicid	publicid
successful	successful
dir2	dir2
is_	is
path_item	path_item
resize	resize
server_name	server name
expect	expect
getsubtype	getsubtype
charset	charset
div	div
urlretrieve	urlretrieve
show	show
toname	toname
tilt	tilt
flushinp	flushinp
forms	forms
python	python
tounicode	tounicode
hypot	hypot
ch	ch
possibilities	possibilities
ifilter	ifilter
stampid	stampid
setencoding	setencoding
storlines	storlines
tostereo	tostereo
interspersed	interspersed
oldattr	oldattr
openfolder	openfolder
getmaxyx	getmaxyx
cd	cd
pathconf	pathconf
clear	clear
title	title
pm	pm
addpackagepath	addpackagepath
pathorfile	pathorfile
hmac	hmac
signed	signed
port	port
fmod	fmod
increment	increment
unknown	unknown
tovideo	tovideo
getmodule	getmodule
filename_or_stream	filename or stream
atexit	atexit
fdopen	fdopen
and_	and
angle	angle
savekey	savekey
terminate	terminate
doupdate	doupdate
getfeature	getfeature
varname	varname
cgixmlrpcrequesthandler	cgixmlrpcrequesthandler
getstatus	getstatus
signalnum	signalnum
referenced	referenced
boundary	boundary
heapify	heapify
csvfile	csvfile
removemessages	removemessages
hkey	hkey
itermonthdates	itermonthdates
byteswap	byteswap
new_x	new_x
document	document
dispatch	dispatch
lsub	lsub
alpha	alpha
slice	slice
notationname	notationname
adapter	adapter
choose	choose
font	font
gl	gl
unicode_char	unicode_char
sendto	sendto
print	print
itertools	itertools
mechanism	mechanism
defaults	defaults
d1	d1
recv	recv
getshapes	getshapes
putheader	putheader
hash	hash
hex	hex
new	new
formats	formats
getdefaultlocale	getdefaultlocale
asinh	asinh
translation	translation
fileinput	fileinput
mailcap	mailcap
dir1	dir1
freeze	freeze
socketpair	socketpair
family	family
md5	md5
fullurl	fullurl
elements	elements
message_parts	message parts
client_address	client_address
cast	cast
stringprep	stringprep
has_internal_subset	has internal subset
alignment	alignment
pair_number	pair_number
getsummaryinformation	getsummaryinformation
align	align
getinfo	getinfo
formatter	formatter
proto	proto
urlsplit	urlsplit
ctlpoints	ctlpoints
getlevelname	getlevelname
geturl	geturl
message_set	message_set
subparsers	subparsers
difflib	difflib
titlestring	titlestring
getsource	getsource
plural	plural
getlocale	getlocale
repl	repl
async_chat	async chat
coded_value	coded_value
insertbefore	insertbefore
bpbynumber	bpbynumber
pattern	pattern
errors	errors
parseurl	parseurl
canonic	canonic
bgn	bgn
saxutils	saxutils
gettype	gettype
predicate	predicate
tcsetattr	tcsetattr
splash	splash
sigma	sigma
listdir	listdir
introspection	introspection
ntransfercmd	ntransfercmd
rlecode	rlecode
what	what
g	g
getdecoder	getdecoder
makefile	makefile
au_read	au read
endtag	endtag
module	module
listen	listen
replace	replace
_name	name
ton	ton
modf	modf
condition	condition
loadlibrary	loadlibrary
magic	magic
inspect	inspect
getpagesize	getpagesize
digest	digest
style	style
controller	controller
resetlocale	resetlocale
askstring	askstring
pprint	pprint
_exit	_exit
expunge	expunge
xgtitle	xgtitle
togglepause	togglepause
auth	auth
getpwall	getpwall
symmetric	symmetric
semaphore	semaphore
opener	opener
tcflush	tcflush
matches	matches
argument	argument
errorstring	errorstring
children	children
success	success
wrap	wrap
fdst	fdst
grey2grey2	grey2grey2
closekey	closekey
ntohl	ntohl
button	button
aetools	aetools
getallmatchingheaders	getallmatchingheaders
_clear	clear
c6	c6
dircache	dircache
fun	fun
pcode	pcode
gnutranslations	gnutranslations
method	method
selector	selector
child	child
spawnl	spawnl
au_write	au_write
_object	object
raw	raw
anywhere	anywhere
combinations	combinations
docs}	docs}
revision	revision
acquire	acquire
location	location
power	power
oss_audio_device	oss_audio_device
abstractbasicauthhandler	abstractbasicauthhandler
lines	lines
dll	dll
lexists	lexists
begin_x	begin x
system	system
setitem	setitem
trace	trace
symlink	symlink
but1	but1
op	op
weibullvariate	weibullvariate
xmlrpclib	xmlrpclib
splitunc	splitunc
setundobuffer	setundobuffer
startmultipartbody	startmultipartbody
getdlopenflags	getdlopenflags
iscode	iscode
tty	tty
prstr	prstr
subnormal	subnormal
tcgetpgrp	tcgetpgrp
computer_name	computer_name
actual	actual
binascii	binascii
fp2	fp2
getenv	getenv
at	at
row	row
newsize	newsize
s	s
locals	locals
xmldeclhandler	xmldeclhandler
speed	speed
docstring	docstring
findfile	findfile
mod_name	mod name
readplistfromstring	readplistfromstring
yeardayscalendar	yeardayscalendar
dup2	dup2
clock	clock
301	301
der	der
aeserver	aeserver
set	set
operator	operator
last	last
setcomptype	setcomptype
sort_criteria	sort_criteria
startdoctypedeclhandler	startdoctypedeclhandler
py_compile	py compile
setmode	setmode
complete	complete
expandtabs	expandtabs
staticmethod	staticmethod
getscrollbarvalues	getscrollbarvalues
getpgrp	getpgrp
mkfifo	mkfifo
runcode	runcode
loader	loader
registerdomimplementation	registerdomimplementation
fromstring	fromstring
elementtree	elementtree
basehandler	basehandler
is_	is_
popitem	popitem
tables	tables
proxyauth	proxyauth
char	char
toprettyxml	toprettyxml
scheduler	scheduler
setfirstweekday	setfirstweekday
num	num
fromfile	fromfile
makedev	makedev
reportflags	reportflags
fillpoint	fillpoint
msg	msg
pformat	pformat
mapping	mapping
uuid3	uuid3
getchildren	getchildren
getattribute	getattribute
filename_or_file	filename_or_file
fetchall	fetchall
setattribute	setattribute
getpreferredencoding	getpreferredencoding
lognormvariate	lognormvariate
textdomain	textdomain
restype	restype
current	current
ic	ic
fd_low	fd low
head	head
getegid	getegid
attributes	attributes
capitalize	capitalize
getexception	getexception
iselement	iselement
uuid	uuid
toxml	toxml
dst	dst
generate	generate
dirs	dirs
functools	functools
getnchannels	getnchannels
doccgixmlrpcrequesthandler	doccgixmlrpcrequesthandler
union	union
compile	compile
conversion	conversion
right)	right)
client_address	client address
connect	connect
accept	accept
emptyline	emptyline
mortem	mortem
resetbuffer	resetbuffer
seq2	seq2
combining	combining
y	y
asyncore	asyncore
popleft	popleft
only	only
hide	hide
asyncevents	asyncevents
repeat	repeat
needed	needed
deleteparser	deleteparser
completion	completion
teletype)	teletype)
count	count
fstatvfs	fstatvfs
sndhdr	sndhdr
getmark	getmark
itermonthdays	itermonthdays
isdir	isdir
article	article
iterfind	iterfind
delims	delims
fontpath	fontpath
groupby	groupby
nodelist	nodelist
unordered	unordered
v1	v1
matching	matching
createdocument	createdocument
setdocumentlocator	setdocumentlocator
column	column
fromunicode	fromunicode
addsitedir	addsitedir
init_or_size	init_or_size
encodedfile	encodedfile
error	error
loads	loads
showturtle	showturtle
field_name	field_name
star	star
fcntl	fcntl
getinputcontext	getinputcontext
netrc	netrc
url	url
same	same
mapname	mapname
from_	from
sigfpe	sigfpe
file_path	file path
radians	radians
openmessage	openmessage
getcwd	getcwd
getattributens	getattributens
newpad	newpad
new_node	new_node
getrlimit	getrlimit
directory	directory
maxpp	maxpp
total	total
getmessage	getmessage
'')	'')
getloggerclass	getloggerclass
pid	pid
formatyear	formatyear
summarize	summarize
etop	etop
insstr	insstr
gettempdir	gettempdir
aggregate	aggregate
fromutc	fromutc
mutually	mutually
syslog	syslog
entityresolver	entityresolver
dirname	dirname
allowed_domains	allowed_domains
haschildnodes	haschildnodes
slave	slave
_write	_write
timetuple	timetuple
betavariate	betavariate
start	start
cmd	cmd
size_or_initializer	size or initializer
execute	execute
startbody	startbody
io	io
getfloatmax	getfloatmax
callable	callable
syncok	syncok
paragraph	paragraph
fsrc	fsrc
detach	detach
parsestring	parsestring
pow	pow
progressbar	progressbar
q	q
async_chat	async_chat
407	407
link	link
roundbutton	roundbutton
standout	standout
strftime	strftime
echo	echo
asin	asin
out_file	out_file
purge	purge
urllib	urllib
httpresponse	httpresponse
plus	plus
createattributens	createattributens
execfile	execfile
has	has
startendtag	startendtag
c12	c12
gcd	gcd
radiogroup	radiogroup
backlog	backlog
floor	floor
getargspec	getargspec
payload	payload
exp	exp
openerdirector	openerdirector
filename	filename
erase	erase
frozen	frozen
getpgid	getpgid
ordereddict	ordereddict
json	json
which	which
insert	insert
common	common
addtest	addtest
typecode_or_type	typecode_or_type
sqlite3	sqlite3
winerror	winerror
line	line
eventmask	eventmask
zlib	zlib
statement	statement
translate	translate
csvwriter	csvwriter
runctx	runctx
vnarray	vnarray
readplist	readplist
fontname	fontname
shlex	shlex
addcleanup	addcleanup
rlock	rlock
tixcommand	tixcommand
listmethods	listmethods
fp1	fp1
getsize	getsize
authreq	authreq
obufcount	obufcount
bsddbobject	bsddbobject
element	element
writexml	writexml
filenames	filenames
wave_read	wave_read
pack	pack
ident	ident
str1	str1
qs	qs
word	word
threshold0	threshold0
startswith	startswith
_current	_current
gensuitemodule	gensuitemodule
getsid	getsid
link_name	link_name
info	info
parts	parts
decomposition	decomposition
setcontenthandler	setcontenthandler
getincrementaldecoder	getincrementaldecoder
fromstringlist	fromstringlist
status	status
noutrefresh	noutrefresh
assertalmostequal	assertalmostequal
frame_lineno	frame_lineno
flt	flt
full	full
thread	thread
keyname	keyname
writable	writable
isleap	isleap
dllcanunloadnow	dllcanunloadnow
heappush	heappush
executable	executable
saxexception	saxexception
realpath	realpath
h_filename	h_filename
nsmallest	nsmallest
trunc	trunc
stoptest	stoptest
or_	or
heading	heading
sharedctypes	sharedctypes
pkg_name	pkg name
queryreflectionkey	queryreflectionkey
index	index
records	records
getsubject	getsubject
pensize	pensize
pickle	pickle
modulefinder	modulefinder
bg	bg
member	member
getaddr	getaddr
answerchallenge	answerchallenge
gettestcasenames	gettestcasenames
uri	uri
folder	folder
bastion	bastion
clearstamps	clearstamps
getmro	getmro
systemid	systemid
putwin	putwin
patterns	patterns
sort_criteria	sort criteria
display	display
starttestrun	starttestrun
_winreg	winreg
infoscrap	infoscrap
lower	lower
exclusive	exclusive
samples	samples
iterators	iterators
bold	bold
add	add
here	here
very	very
menuitem	menuitem
tabs	tabs
reorganize	reorganize
macostools	macostools
addunexpectedsuccess	addunexpectedsuccess
minus	minus
utils	utils
textpad	textpad
italic	italic
urlstring	urlstring
recsrc	recsrc
server_documentation	server_documentation
move	move
mimewriter	mimewriter
imaplib	imaplib
output	output
normpath	normpath
isdaemon	isdaemon
optname	optname
seek	seek
imul	imul
sampfmt	sampfmt
max	max
debug	debug
attrib	attrib
copytree	copytree
normal	normal
getscreen	getscreen
duration	duration
xor	xor
wexitstatus	wexitstatus
setstream	setstream
addch	addch
ehlo	ehlo
warnpy3k	warnpy3k
classes	classes
fchown	fchown
phase	phase
tz	tz
compare	compare
pair_number	pair number
selection	selection
key	key
item	item
attribute	attribute
and_	and_
assertin	assertin
table	table
to_addrs	to addrs
parser	parser
nurbscurve	nurbscurve
getname	getname
makesocket	makesocket
kbhit	kbhit
manager	manager
h	h
fractions	fractions
unregister	unregister
scriptable	scriptable
mac	mac
frame	frame
deleteln	deleteln
sax	sax
formatexception	formatexception
timer	timer
aggregate_class	aggregate_class
instance	instance
sound	sound
c	c
getusersitepackages	getusersitepackages
ismethod	ismethod
base64	base64
callers	callers
finditer	finditer
formatwarning	formatwarning
snan	snan
dump	dump
product	product
rgid	rgid
authenticators	authenticators
serve	serve
callees	callees
loadtestsfrommodule	loadtestsfrommodule
umask	umask
xmlparser	xmlparser
addheader	addheader
readinto	readinto
lseek	lseek
reverse	reverse
getfullname	getfullname
eng	eng
timeout	timeout
typename	typename
contentclick	contentclick
untokenize	untokenize
getmembers	getmembers
iscntrl	iscntrl
kevent	kevent
begin	begin
wsgiref	wsgiref
node_or_string	node_or_string
position	position
to	to
delay	delay
isoweekday	isoweekday
''	''
delslice	delslice
uidl	uidl
makeelement	makeelement
oss_mixer_device	oss_mixer_device
compress	compress
ast	ast
conjugate	conjugate
not_	not
domains	domains
has_internal_subset	has_internal_subset
k	k
ignorablewhitespace	ignorablewhitespace
subelements	subelements
b32encode	b32encode
themename	themename
context	context
sgmlparser	sgmlparser
monthdayscalendar	monthdayscalendar
capture	capture
qnan	qnan
token	token
allowed	allowed
fmt	fmt
formatyearpage	formatyearpage
getresgid	getresgid
fromfd	fromfd
cprofile	cprofile
zipfile	zipfile
setlast	setlast
sorted	sorted
oldchild	oldchild
set2	set2
zfill	zfill
optionparser	optionparser
xlist	xlist
check	check
_makeresult	_makeresult
event	event
not_	not_
createrecord	createrecord
visible	visible
testandset	testandset
getinteger	getinteger
endcdatasectionhandler	endcdatasectionhandler
hashopen	hashopen
n	n
docxmlrpcserver	docxmlrpcserver
launchurl	launchurl
parameters	parameters
command	command
hideturtle	hideturtle
itertext	itertext
setcbreak	setcbreak
tzset	tzset
atof	atof
format_spec	format spec
warning	warning
userptr	userptr
tcsendbreak	tcsendbreak
createparser	createparser
setvalue	setvalue
hdlr	hdlr
isprint	isprint
addcallback	addcallback
bkgdset	bkgdset
locator	locator
weekheader	weekheader
issock	issock
history	history
error_handler	error_handler
pdict	pdict
macoswindowid	macoswindowid
dt	dt
setconfig	setconfig
rindex	rindex
cmpfiles	cmpfiles
branch	branch
basehttpserver	basehttpserver
getcanvas	getcanvas
setdefault	setdefault
nested	nested
pton	pton
elementname	elementname
getuid	getuid
v	v
termname	termname
filt	filt
message	message
feature	feature
getsyx	getsyx
forever	forever
day	day
getclasstree	getclasstree
dither2mono	dither2mono
isroutine	isroutine
__init__	__init__
lambd	lambd
fqname	fqname
documentation	documentation
hqx	hqx
getcompname	getcompname
teardown	teardown
samestat	samestat
randrange	randrange
_flush	_flush
getstatusoutput	getstatusoutput
times	times
submenu	submenu
standard	standard
stats	stats
theyear	theyear
and	and
endelementhandler	endelementhandler
out_file	out file
isspace	isspace
globs	globs
path	path
set1	set1
isterminal	isterminal
polar	polar
qsl	qsl
findfont	findfont
message_num	message num
basecookie	basecookie
ssl	ssl
fpectl	fpectl
nextkey	nextkey
stoplistening	stoplistening
preloop	preloop
beta	beta
getplist	getplist
distb	distb
getacl	getacl
messagebeep	messagebeep
rate	rate
disassemble	disassemble
erasechar	erasechar
issubclass	issubclass
threshold	threshold
capname	capname
b64decode	b64decode
filename_or_stream	filename_or_stream
pass_	pass
rawdata	rawdata
assertregexpmatches	assertregexpmatches
monthrange	monthrange
pack_item	pack_item
sety	sety
setdefaultencoding	setdefaultencoding
cmp	cmp
rows	rows
config	config
t	t
formatmonth	formatmonth
processor	processor
heappop	heappop
message_num	message_num
elementdeclhandler	elementdeclhandler
weakvaluedictionary	weakvaluedictionary
getparyx	getparyx
islice	islice
doctest	doctest
deletevalue	deletevalue
divmod	divmod
lazy	lazy
save	save
getmodulename	getmodulename
sections	sections
salt	salt
c8	c8
play	play
profile	profile
ugettext	ugettext
base_name	base_name
multiply	multiply
getcomptype	getcomptype
iand	iand
lvl	lvl
opt_str	opt str
list	list
geterrorstring	geterrorstring
validator	validator
unsetenv	unsetenv
bufsize	bufsize
kappa	kappa
etiny	etiny
rstrip	rstrip
unctrl	unctrl
shutdown	shutdown
dev	dev
image	image
package	package
multifile	multifile
rfind	rfind
tcflow	tcflow
grey22grey	grey22grey
user	user
seq1	seq1
attrset	attrset
retrlines	retrlines
rcpttos	rcpttos
cfunctype	cfunctype
characters	characters
formattime	formattime
result	result
param	param
tigetstr	tigetstr
subn	subn
rpop	rpop
bitmask	bitmask
on_flag	on flag
doc	doc
copymessage	copymessage
setattributenode	setattributenode
getcontenthandler	getcontenthandler
ftp_tls	ftp_tls
getsystemid	getsystemid
checkfuncname	checkfuncname
getabouttext	getabouttext
commit	commit
getqueuesize	getqueuesize
num_params	num_params
nice	nice
getslice	getslice
getsampwidth	getsampwidth
setup	setup
queryparams	queryparams
args	args
compiler	compiler
ready	ready
setloggerclass	setloggerclass
weakkeydictionary	weakkeydictionary
dynamic	dynamic
subtract	subtract
imap4	imap4
_setroot	_setroot
atan	atan
csvreader	csvreader
charref	charref
lookup	lookup
getpid	getpid
sign	sign
mkdtemp	mkdtemp
qsize	qsize
fork	fork
fdatasync	fdatasync
firstweekday	firstweekday
free	free
vline	vline
parseaddr	parseaddr
identify	identify
_parse	_parse
getticks	getticks
gamma	gamma
regexp	regexp
fatalerror	fatalerror
effective	effective
unicode	unicode
getfillpoint	getfillpoint
writerows	writerows
skipif	skipif
threading_algorithm	threading_algorithm
breaks	breaks
rfactor	rfactor
getcreatorandtype	getcreatorandtype
group	group
hsv	hsv
urlcleanup	urlcleanup
flag	flag
setfloatmax	setfloatmax
fname	fname
src	src
argparse	argparse
color_number	color number
c7	c7
opendatabase	opendatabase
prot	prot
endheaders	endheaders
authuri	authuri
infolist	infolist
turtle	turtle
namedtemporaryfile	namedtemporaryfile
imod	imod
softspace	softspace
bindtextdomain	bindtextdomain
example	example
minutes	minutes
sci	sci
askyesnocancel	askyesnocancel
dir	dir
offset	offset
extendleft	extendleft
parsedate	parsedate
buffer_size	buffer size
target	target
getspall	getspall
typeahead	typeahead
viewvalues	viewvalues
outfile	outfile
extensions	extensions
pathname2url	pathname2url
fail	fail
tracing	tracing
panels	panels
pasv	pasv
cleandoc	cleandoc
future_builtins	future_builtins
getrecursionlimit	getrecursionlimit
crypt	crypt
copyliteral	copyliteral
apply	apply
commenthandler	commenthandler
sb	sb
literal	literal
sqrt	sqrt
removehandler	removehandler
mkd	mkd
mh	mh
form	form
deepcopy	deepcopy
v2	v2
getcharacterstream	getcharacterstream
dup	dup
isreg	isreg
fd2	fd2
al	al
string	string
rawvalue	rawvalue
blocks	blocks
files	files
confstr	confstr
r	r
wraps	wraps
getuser	getuser
touchwin	touchwin
macos	macos
peek	peek
currentframe	currentframe
flatten	flatten
getqnamebyname	getqnamebyname
seekblock	seekblock
dl	dl
entry	entry
report	report
ilshift	ilshift
packet	packet
disablereflectionkey	disablereflectionkey
isnonterminal	isnonterminal
qp	qp
retrbinary	retrbinary
section	section
tix	tix
flowing	flowing
uninstall	uninstall
grey2mono	grey2mono
push	push
timeit	timeit
until	until
client	client
normalize	normalize
handler	handler
localename	localename
stream	stream
component	component
encoding	encoding
bdb	bdb
arg	arg
killpg	killpg
setproperty	setproperty
multicall	multicall
exec	exec
invert	invert
path1	path1
record	record
pdb	pdb
post	post
copy2	copy2
locale	locale
mailfrom	mailfrom
normalvariate	normalvariate
ratio	ratio
month	month
iterweekdays	iterweekdays
opt_str	opt_str
begidx	begidx
dec	dec
subelement	subelement
methodcaller	methodcaller
f	f
isinstance	isinstance
hotshot	hotshot
unverifiable	unverifiable
tuple2st	tuple2st
isalnum	isalnum
lin2alaw	lin2alaw
modify	modify
simplexmlrpcserver	simplexmlrpcserver
vonmisesvariate	vonmisesvariate
chdir	chdir
fromresource	fromresource
want	want
sig	sig
sequences	sequences
audioop	audioop
rawconfigparser	rawconfigparser
refchild	refchild
getquota	getquota
rgbmode	rgbmode
timetz	timetz
assertsequenceequal	assertsequenceequal
enumvalue	enumvalue
qdevice	qdevice
fragment2	fragment2
getpwnam	getpwnam
setdtdhandler	setdtdhandler
in_file	in file
gethostbyname	gethostbyname
quantize	quantize
bytearray	bytearray
factory	factory
kind	kind
objects	objects
movemessage	movemessage
colorsys	colorsys
iterparse	iterparse
assertitemsequal	assertitemsequal
min	min
gettarinfo	gettarinfo
mouseinterval	mouseinterval
docmd	docmd
fm	fm
docleanups	docleanups
themonth	themonth
fstat	fstat
beep	beep
mag	mag
aifc	aifc
date_time	date_time
siginterrupt	siginterrupt
playtrack	playtrack
return	return
above	above
blocked	blocked
findfit	findfit
tracer	tracer
ok	ok
number	number
getincrementalencoder	getincrementalencoder
colorpicker	colorpicker
disco	disco
getsourcefile	getsourcefile
got	got
enter	enter
quick	quick
into	into
insch	insch
compileall	compileall
safeconfigparser	safeconfigparser
results	results
controlhit	controlhit
enable	enable
fromlist	fromlist
writepy	writepy
makefolder	makefolder
getfloat	getfloat
block	block
leapdays	leapdays
getpublicid	getpublicid
readfp	readfp
allocate	allocate
pack_item	pack item
append	append
close	close
httperrorprocessor	httperrorprocessor
rpartition	rpartition
timedelta	timedelta
subpad	subpad
spacing	spacing
scheme	scheme
fileobject	fileobject
graphics	graphics
sym	sym
size	size
packer	packer
wave_read	wave read
rlist	rlist
type	type
getfmts	getfmts
tzname	tzname
bases	bases
limit	limit
usage	usage
scaleb	scaleb
delitem	delitem
enumerate	enumerate
pi	pi
profilefunc	profilefunc
setfont	setfont
run	run
rewindbody	rewindbody
o	o
gammavariate	gammavariate
scrolledwindow	scrolledwindow
clearstamp	clearstamp
setsampwidth	setsampwidth
isblank	isblank
bin	bin
getnframes	getnframes
getframeinfo	getframeinfo
excepthook	excepthook
samplerate	samplerate
singular	singular
setnomoretags	setnomoretags
b	b
loadtestsfromtestcase	loadtestsfromtestcase
clone	clone
qiflush	qiflush
start_response	start response
cls	cls
str3	str3
jpeg	jpeg
toggle	toggle
proxy	proxy
apop	apop
server_documentation	server documentation
category	category
codec	codec
cookie	cookie
codecs	codecs
write	write
cos	cos
realm	realm
takewhile	takewhile
egid	egid
checkbox	checkbox
getproperty	getproperty
idna	idna
device	device
addfile	addfile
core	core
argumentparser	argumentparser
etype	etype
chr	chr
hline	hline
authorizer_callback	authorizer callback
to_angle	to_angle
featurename	featurename
ihave	ihave
mmap	mmap
valslider	valslider
formatargvalues	formatargvalues
emit	emit
double	double
new_y	new_y
createelement	createelement
c3	c3
truncate	truncate
utcoffset	utcoffset
assertnotregexpmatches	assertnotregexpmatches
turtles	turtles
setcontext	setcontext
createdocumenttype	createdocumenttype
parent	parent
env	env
controlswindow	controlswindow
integral	integral
methods	methods
notstandalonehandler	notstandalonehandler
nocbreak	nocbreak
sysconfig	sysconfig
starttls	starttls
proxydigestauthhandler	proxydigestauthhandler
klass	klass
runsource	runsource
date_time	date time
ndata	ndata
readall	readall
currency	currency
minidom	minidom
init	init
circle	circle
address	address
alo	alo
scalefont	scalefont
year	year
ftp_tls	ftp tls
unfreeze	unfreeze
l	l
fd_low	fd_low
unparsedentitydecl	unparsedentitydecl
strptime	strptime
endelement	endelement
_clear	_clear
zinfo_or_arcname	zinfo or arcname
base_name	base name
curses	curses
eager	eager
keys	keys
found	found
all	all
pass_	pass_
top	top
ver	ver
constructor	constructor
aepack	aepack
rename	rename
ustr	ustr
addbitmapdir	addbitmapdir
pwd	pwd
archive	archive
hasattributens	hasattributens
extract	extract
getattributenodens	getattributenodens
getparam	getparam
ordering	ordering
boolean	boolean
extn	extn
ungetwch	ungetwch
pre	pre
playsound	playsound
uu	uu
direction	direction
menu	menu
isnumbertype	isnumbertype
setdefaulttimeout	setdefaulttimeout
tab_id	tab id
modulename	modulename
ischr	ischr
root	root
fnmatchcase	fnmatchcase
nextpart	nextpart
b3	b3
domain	domain
repr	repr
subtype	subtype
setlevel	setlevel
rule	rule
stop	stop
endnamespacedeclhandler	endnamespacedeclhandler
resetwarnings	resetwarnings
unload	unload
langinfo	langinfo
writestr	writestr
message_part	message_part
setsyx	setsyx
copysign	copysign
forget	forget
build	build
configuration	configuration
getentityresolver	getentityresolver
scrollbars	scrollbars
notationdecl	notationdecl
junk	junk
to_angle	to angle
mod_name	mod_name
message_set	message set
selectors	selectors
getturtle	getturtle
lineno	lineno
gid	gid
_winreg	_winreg
ceil	ceil
cancel	cancel
getch	getch
assertis	assertis
winsound	winsound
floordiv	floordiv
imap4_ssl	imap4 ssl
ldngettext	ldngettext
decodestring	decodestring
first	first
ctype	ctype
istraceback	istraceback
docfilesuite	docfilesuite
notimeout	notimeout
log10	log10
flags	flags
empty	empty
listmessages	listmessages
runfunc	runfunc
field_names	field names
nonstandard	nonstandard
readlink	readlink
filecmp	filecmp
iconcat	iconcat
poly	poly
to_addrs	to_addrs
radius	radius
rms	rms
findall	findall
ngettext	ngettext
addinfo	addinfo
find	find
control	control
fileopen	fileopen
unpack	unpack
mime	mime
init_or_size	init or size
gettrackinfo	gettrackinfo
stat1	stat1
lfactor	lfactor
fd_high	fd high
c5	c5
_parse	parse
isgeneratorfunction	isgeneratorfunction
lin2adpcm	lin2adpcm
getfontinfo	getfontinfo
atanh	atanh
getcurrent	getcurrent
valuerefs	valuerefs
enumsubst	enumsubst
feed	feed
color_number	color_number
cbreak	cbreak
reference	reference
module_or_name	module or name
b2	b2
retr	retr
copybinary	copybinary
inc	inc
marshal	marshal
statvfs	statvfs
assertsetequal	assertsetequal
terminator	terminator
putsequences	putsequences
bisect	bisect
noop	noop
addressof	addressof
interact	interact
load	load
height	height
localtime	localtime
comment	comment
deletefolder	deletefolder
gettrace	gettrace
getweakrefcount	getweakrefcount
peer	peer
mutex	mutex
order	order
blo	blo
qname	qname
modifiers	modifiers
file	file
getiterator	getiterator
panel	panel
cwd	cwd
pair	pair
namelist	namelist
obuffree	obuffree
lchflags	lchflags
tobuf	tobuf
httpdigestauthhandler	httpdigestauthhandler
simplefilter	simplefilter
dbm	dbm
labels	labels
htmlparser	htmlparser
testcaseclass	testcaseclass
heappushpop	heappushpop
ref	ref
isvisible	isvisible
touched	touched
windowbounds	windowbounds
split	split
repr1	repr1
unpacker	unpacker
fileconfig	fileconfig
fd_high	fd_high
closeport	closeport
crc32	crc32
nvarray	nvarray
externalentityrefhandler	externalentityrefhandler
width	width
bind	bind
nan	nan
cookies	cookies
shelve	shelve
resetparser	resetparser
binhex	binhex
use	use
grp	grp
logical	logical
prettyprinter	prettyprinter
queue	queue
seteuid	seteuid
platform	platform
expt	expt
authenticate	authenticate
exc	exc
serverproxy	serverproxy
paretovariate	paretovariate
alt	alt
encode	encode
entityref	entityref
getgroups	getgroups
setslice	setslice
wcoredump	wcoredump
fileno	fileno
from	from
settrace	settrace
attrs	attrs
urllib2	urllib2
local	local
url2pathname	url2pathname
removeattributens	removeattributens
sequence	sequence
lock	lock
typecode	typecode
byte	byte
dllgetclassobject	dllgetclassobject
hidden	hidden
createkeyex	createkeyex
h_filename	h filename
il	il
box	box
isrecursive	isrecursive
getproxies	getproxies
writeplist	writeplist
_write	write
endswith	endswith
getouterframes	getouterframes
minor	minor
flagstr	flagstr
old_node	old node
expected	expected
removefilter	removefilter
ctermid	ctermid
nframes	nframes
reload	reload
data	data
length	length
t_k	t k
onoff	onoff
password	password
proxybasicauthhandler	proxybasicauthhandler
unittest	unittest
putwch	putwch
flush	flush
urlparse	urlparse
stat2	stat2
pwlcurve	pwlcurve
setcheckinterval	setcheckinterval
getparams	getparams
cmath	cmath
sampwidth	sampwidth
can	can
blocked_domains	blocked domains
cleardata	cleardata
req	req
username	username
readlines	readlines
label	label
getlinenumber	getlinenumber
summaryinformation	summaryinformation
below	below
isxdigit	isxdigit
completer	completer
register	register
vtbl_index	vtbl_index
getframerate	getframerate
size_or_initializer	size_or_initializer
testing	testing
match	match
strict	strict
getconfig	getconfig
getbase	getbase
do	do
filterwarnings	filterwarnings
au_read	au_read
attach	attach
extension	extension
getpos	getpos
random	random
abs	abs
tuple	tuple
codeop	codeop
obj	obj
idle	idle
makelogrecord	makelogrecord
filename_or_file	filename or file
getchildnodes	getchildnodes
is	is
uname	uname
struct	struct
namedtuple	namedtuple
geteuid	geteuid
minmax	minmax
resource	resource
defaulthandler	defaulthandler
fma	fma
referrers	referrers
implementation	implementation
showwarning	showwarning
sequence_of_strings	sequence_of_strings
capturewarnings	capturewarnings
wstopsig	wstopsig
visitor	visitor
getattr	getattr
isnan	isnan
version	version
seq	seq
seqs	seqs
sock	sock
isblk	isblk
cgi	cgi
enddoctypedeclhandler	enddoctypedeclhandler
getelementsbytagname	getelementsbytagname
getkey	getkey
getnames	getnames
hasattributes	hasattributes
error_handler	error handler
queryvalueex	queryvalueex
geteffectivelevel	geteffectivelevel
ungettext	ungettext
property	property
unpack_item	unpack item
tomono	tomono
task	task
hook	hook
words	words
level	level
partition	partition
httpredirecthandler	httpredirecthandler
openpty	openpty
prmonth	prmonth
imp	imp
email	email
_quit	_quit
difference	difference
startnamespacedeclhandler	startnamespacedeclhandler
join	join
askpassword	askpassword
readsamps	readsamps
maskpri	maskpri
value_name	value_name
fsum	fsum
getcolumnnumber	getcolumnnumber
killchar	killchar
kill	kill
test_support	test support
runeval	runeval
super	super
islnk	islnk
runpy	runpy
divide	divide
server_name	server_name
ncols	ncols
setnchannels	setnchannels
appendchild	appendchild
fromhex	fromhex
setnframes	setnframes
zip	zip
heapq	heapq
weakref	weakref
wave	wave
getsampfmt	getsampfmt
popen4	popen4
getwidth	getwidth
sniff	sniff
stack	stack
propertyname	propertyname
b2a	b2a
fl	fl
getvalue	getvalue
varray	varray
rectangle	rectangle
select	select
from_	from_
settscdump	settscdump
typeobj	typeobj
from_addr	from addr
out	out
escape	escape
seed	seed
importers	importers
tab_id	tab_id
filter	filter
getlength	getlength
tracebacks	tracebacks
splittable	splittable
erf	erf
callback	callback
prcal	prcal
getlasterror	getlasterror
getspnam	getspnam
file_name	file_name
setwatchcursor	setwatchcursor
old_node	old_node
getfilesystemencoding	getfilesystemencoding
calcsize	calcsize
setannotation	setannotation
mask	mask
stamp	stamp
getmessageid	getmessageid
islast	islast
getchannels	getchannels
content	content
getsizeof	getsizeof
arguments	arguments
setattr	setattr
bhi	bhi
value	value
urlunparse	urlunparse
removechild	removechild
z	z
getargvalues	getargvalues
nextfile	nextfile
expm1	expm1
getsockopt	getsockopt
isbuiltin	isbuiltin
reqed	reqed
functions	functions
loadtestsfromname	loadtestsfromname
dialogwindow	dialogwindow
destdir	destdir
_getframe	getframe
sendmail	sendmail
divider	divider
writeplisttoresource	writeplisttoresource
contenthandler	contenthandler
setpublicid	setpublicid
ex	ex
counttestcases	counttestcases
in_file	in_file
posixfile	posixfile
bytes	bytes
importlib	importlib
allowed_domains	allowed domains
atol	atol
wave_write	wave_write
doctype	doctype
values	values
on_flag	on_flag
fallback	fallback
imap4_ssl	imap4_ssl
canonical	canonical
getquotaroot	getquotaroot
c22	c22
inet	inet
defaulthandlerexpand	defaulthandlerexpand
setliteral	setliteral
continue	continue
call	call
secret	secret
settings	settings
math	math
floatmax	floatmax
parameter	parameter
writeplisttostring	writeplisttostring
resolveentity	resolveentity
createattribute	createattribute
node	node
webbrowser	webbrowser
statespec	statespec
seconds	seconds
unlink	unlink
groupdict	groupdict
bz2	bz2
indexof	indexof
https	https
parsestr	parsestr
shelf	shelf
createtextnode	createtextnode
seq_of_parameters	seq of parameters
getgrall	getgrall
mktime	mktime
ismeta	ismeta
ttyname	ttyname
pop3	pop3
yeardatescalendar	yeardatescalendar
vars	vars
tarfile	tarfile
setlocale	setlocale
ismodule	ismodule
erfc	erfc
concat	concat
unicode_char	unicode char
fromkeys	fromkeys
obj_or_type	obj or type
getfontname	getfontname
completedefault	completedefault
chown	chown
askfolder	askfolder
datetime	datetime
pipe	pipe
pyzipfile	pyzipfile
bottom	bottom
sha	sha
decompress	decompress
endwin	endwin
options	options
id	id
signal	signal
dial	dial
itemhit	itemhit
newattr	newattr
cert	cert
extend	extend
population	population
st2tuple	st2tuple
operation	operation
popen	popen
abc	abc
pyc	pyc
exists	exists
endpick	endpick
newchild	newchild
host	host
expat	expat
uid	uid
server	server
action	action
socket	socket
au_write	au write
_name	_name
ldexp	ldexp
lchown	lchown
isgetsetdescriptor	isgetsetdescriptor
sub	sub
view	view
sameopenfile	sameopenfile
keyword	keyword
makeusermenus	makeusermenus
interactiveinterpreter	interactiveinterpreter
attributesns	attributesns
iglob	iglob
isinf	isinf
from_addr	from_addr
y1	y1
writeframes	writeframes
isdown	isdown
class	class
sysconf	sysconf
message_parts	message_parts
eval	eval
farray	farray
module_or_name	module_or_name
linecache	linecache
gdbm	gdbm
test	test
send	send
nodes	nodes
machine	machine
getstr	getstr
decoded_seq	decoded_seq
channels	channels
addtypeequalityfunc	addtypeequalityfunc
sync	sync
sub_key	sub key
instate	instate
settimeout	settimeout
win	win
fnmatch	fnmatch
getdoc	getdoc
sequenceincludes	sequenceincludes
getnamebyqname	getnamebyqname
dedent	dedent
shift	shift
addnstr	addnstr
nlst	nlst
heap	heap
aggregate_class	aggregate class
unlock	unlock
field_name	field name
writeframesraw	writeframesraw
negate	negate
int2ap	int2ap
authobject	authobject
environ	environ
mu	mu
exception	exception
suffixes	suffixes
link_name	link name
limits	limits
mainloop	mainloop
message_part	message part
rjust	rjust
intersection	intersection
whathdr	whathdr
remainder	remainder
main	main
c21	c21
removedirs	removedirs
num_channels	num channels
getcolor	getcolor
yview	yview
tunnel	tunnel
margin	margin
codepoint	codepoint
requesthandler	requesthandler
flock	flock
mousemask	mousemask
pubid	pubid
nodelay	nodelay
hls	hls
httphandler	httphandler
readmodule	readmodule
sql	sql
examples	examples
setcreatorandtype	setcreatorandtype
prev	prev
interrupt	interrupt
temporaryfile	temporaryfile
search_criterion	search criterion
morsel	morsel
getfqdn	getfqdn
lin2lin	lin2lin
unredirected	unredirected
standend	standend
fragment	fragment
edict	edict
processinginstruction	processinginstruction
mimetypes	mimetypes
x	x
connectregistry	connectregistry
seekable	seekable
creator	creator
loadkey	loadkey
msgid	msgid
rotate	rotate
registerresult	registerresult
used_args	used_args
rewind	rewind
carbon	carbon
turnoff	turnoff
ln	ln
stacksize	stacksize
d2	d2
setblocking	setblocking
splitdrive	splitdrive
der_cert_bytes	der_cert_bytes
getwin	getwin
zinfo_or_arcname	zinfo_or_arcname
textwrap	textwrap
character	character
strip	strip
fp	fp
rfc822	rfc822
vtbl_index	vtbl index
code	code
prepare	prepare
yes	yes
sleep	sleep
color	color
visit	visit
pop	pop
dorollover	dorollover
tostring	tostring
major	major
authkey	authkey
computer_name	computer name
mvderwin	mvderwin
getcheckinterval	getcheckinterval
getfirstmatchingheader	getfirstmatchingheader
track	track
dgettext	dgettext
as	as
cursyncup	cursyncup
address_family	address_family
startcdatasectionhandler	startcdatasectionhandler
ftp	ftp
getcaps	getcaps
xmlreader	xmlreader
getheader	getheader
prompt	prompt
subdir	subdir
monthcalendar	monthcalendar
startelementns	startelementns
decode	decode
gc	gc
logout	logout
enddocument	enddocument
ipow	ipow
307	307
dest	dest
queryvalue	queryvalue
address_family	address family
re	re
redraw	redraw
rgb	rgb
bsddb	bsddb
len	len
rexec	rexec
voidcmd	voidcmd
pty	pty
urlsafe	urlsafe
loop	loop
setmark	setmark
script	script
splitfields	splitfields
y2	y2
source	source
iterkeys	iterkeys
shutil	shutil
setstring	setstring
glob	glob
hasattribute	hasattribute
threading	threading
near	near
reason	reason
iterator	iterator
findtext	findtext
getmessagefilename	getmessagefilename
next	next
mul	mul
restart	restart
ascii	ascii
site	site
sitedir	sitedir
async	async
kwargs	kwargs
writeall	writeall
colors	colors
nlocals	nlocals
contextmanager	contextmanager
scrap	scrap
cat	cat
float	float
focus	focus
pem	pem
addhandler	addhandler
multiprocessing	multiprocessing
ulx	ulx
function	function
openfp	openfp
tracefunc	tracefunc
file_name	file name
nurbssurface	nurbssurface
open	open
getloadavg	getloadavg
tarinfo	tarinfo
argcount	argcount
monthdays2calendar	monthdays2calendar
name	name
s_k	s k
itruediv	itruediv
imghdr	imghdr
qualifiedname	qualifiedname
setattributenodens	setattributenodens
val	val
dialects	dialects
napms	napms
putch	putch
telnet	telnet
zero	zero
configure	configure
codecname	codecname
listallfolders	listallfolders
setbase	setbase
mtime	mtime
inputsource	inputsource
splitext	splitext
xatom	xatom
stat	stat
b64encode	b64encode
process	process
_flush	flush
classinfo	classinfo
session	session
header	header
addfilter	addfilter
parsers	parsers
tb	tb
keyrefs	keyrefs
question	question
getfilled	getfilled
closerange	closerange
frame_lineno	frame lineno
names	names
substitute	substitute
response	response
points	points
strerror	strerror
finite	finite
dngettext	dngettext
etree	etree
extractall	extractall
termios	termios
when	when
filelineno	filelineno
mkdir	mkdir
fromname	fromname
calendar	calendar
encodings	encodings
cstringio	cstringio
not	not
log	log
processfile	processfile
iter	iter
b16encode	b16encode
gettext	gettext
ignore	ignore
install	install
doctypename	doctypename
storbinary	storbinary
charsets	charsets
localname	localname
_setroot	setroot
second	second
startfile	startfile
suffix	suffix
settarget	settarget
most	most
setentityresolver	setentityresolver
getpass	getpass
ontimer	ontimer
removeattributenode	removeattributenode
smtp	smtp
degrees	degrees
cram	cram
failure	failure
frombuf	frombuf
fcicreate	fcicreate
buf	buf
begin_y	begin y
headers	headers
fromtarfile	fromtarfile
syncup	syncup
ctl	ctl
partial	partial
setheading	setheading
tzinfo	tzinfo
mono2grey	mono2grey
search_function	search_function
release	release
typecode_or_type	typecode or type
iskeyword	iskeyword
bar	bar
setresgid	setresgid
openkeyex	openkeyex
getfile	getfile
self	self
listallsubfolders	listallsubfolders
untouchwin	untouchwin
func	func
meta	meta
option	option
getwche	getwche
setframerate	setframerate
wait	wait
removeattribute	removeattribute
collation	collation
whitespace	whitespace
addskip	addskip
unset	unset
py_compile	py_compile
disable	disable
handleerror	handleerror
done	done
sample	sample
getstrwidth	getstrwidth
ip_string	ip string
setsystemid	setsystemid
tag	tag
t_k	t_k
newgroups	newgroups
getreader	getreader
tempnam	tempnam
path_item	path item
insdelln	insdelln
search_function	search function
logb	logb
readline	readline
referents	referents
connection	connection
closure	closure
nis	nis
frames	frames
getaddresses	getaddresses
getcwdu	getcwdu
encoders	encoders
remove	remove
imap	imap
neg	neg
executemany	executemany
openport	openport
iadd	iadd
namednodemap	namednodemap
401	401
b32decode	b32decode
doublebuffering	doublebuffering
refresh	refresh
sizeof	sizeof
a	a
counter	counter
basename	basename
getpeercert	getpeercert
import	import
httpshandler	httpshandler
file_path	file_path
facility	facility
fullname	fullname
del	del
format_string	format string
getpeername	getpeername
imported	imported
tokens	tokens
processinginstructionhandler	processinginstructionhandler
getprofile	getprofile
multipart	multipart
shell	shell
startelementhandler	startelementhandler
cookiejar	cookiejar
exit	exit
assertdictcontainssubset	assertdictcontainssubset
active	active
quit	quit
uly	uly
cabname	cabname
itemgetter	itemgetter
cosh	cosh
skiptest	skiptest
numeric	numeric
modname	modname
unichr	unichr
grouped	grouped
helo	helo
whseed	whseed
csv	csv
used_args	used args
nsamples	nsamples
aiff	aiff
previous	previous
fg	fg
isenabled	isenabled
getbytestream	getbytestream
isub	isub
pgid	pgid
mode	mode
createsocket	createsocket
endprefixmapping	endprefixmapping
msilib	msilib
httppasswordmgr	httppasswordmgr
authorizer_callback	authorizer_callback
xml	xml
format_spec	format_spec
readplistfromresource	readplistfromresource
fetchmany	fetchmany
teardownclass	teardownclass
starttag	starttag
ioctl	ioctl
num_channels	num_channels
setscrreg	setscrreg
description	description
nowait	nowait
expired	expired
getrandbits	getrandbits
cpu	cpu
player	player
defaultcookiepolicy	defaultcookiepolicy
third	third
parsefile	parsefile
nbytes	nbytes
new_x	new x
typeid	typeid
value_name	value name
settypecreator	settypecreator
chgat	chgat
persist	persist
countof	countof
quoteattr	quoteattr
a)	a)
cursor	cursor
types	types
dumbdbm	dumbdbm
assert	assert
dis	dis
err	err
rootobject	rootobject
writer	writer
login	login
memmove	memmove
fopaque	fopaque
stdin	stdin
getuserbase	getuserbase
body	body
bkgd	bkgd
acosh	acosh
abstractmethod	abstractmethod
items	items
attrdict	attrdict
getsignal	getsignal
setx	setx
_object	_object
dtdhandler	dtdhandler
iterencode	iterencode
buffer	buffer
hexdigest	hexdigest
wrapped	wrapped
new_mailbox	new mailbox
setlogmask	setlogmask
sgid	sgid
closelog	closelog
unicodedata	unicodedata
fill	fill
mt	mt
pushbutton	pushbutton
basicconfig	basicconfig
getmtime	getmtime
optionflags	optionflags
collect	collect
mailbox	mailbox
copy	copy
getmarkers	getmarkers
b16decode	b16decode
