osnetwork	class sunos network
osservice	status svcadm sunos service controlling - svcs checking uses manipulation services command class
hostname	subclassed based generic hostname platform manipulation class
solaris	execute hostname later - strategy solaris11 command manipulation class
vars	and/or adds variables needed hosts inventory groups values loads vars_cache special view
hpuxvirtual	specific hp-ux virtual subclass defines
skip	action skip runtime
front	services handles cloudfront
manager	tasks cloudtrail creation cloudformation topic ansible result registration management requirements perform instance handles handler clusters forks fork creating worker cloudfront ecs sns de-registration services container configuration class pool destruction elb elasticache multiprocessing ec2
playbook	bin/ansible-playbook run playbooks *ansible basis tool thus system primary executing playbooks*, multinode deployment operation configuration class
unicode	objects sub unicode class
credentials	exception raised cloudcontrol cannot found credentials data dimension
facts	attempt mostly populate generic systems facts class
vmomi	easily helper requested create modified times objects references pyvmomihelper multiples class vmware caches
libcloud	exception raised cannot apache found libcloud
bsduser	class netbsd openbsd user manipulation
galaxy	default code revoke selinux global existing executing "present" managed disk zone 'all' server_ids nodes updated returned none named_ports balancing clc-sdk parameter tagging look 'dynamic' -- list uuid defaults os_type authenticating round 'default' upper force "absent" sync value initialized port append even product. specification access waiting 'na' template shared method metadata full hash tags spacing ranges downloaded objects clc-sdk.request groups address path wait search rdp dicts current prior 'ansible-python-api' base listens action options json. manage clc-python-sdk logical ips api names clc_sdk.group unit use working contains pubnub next call memory type datacenter expose occurred lookup mounted must account created values fetch compare ansible-playbook pre-parsed agent tag something want validated securityrule string filter respective gce id gcp absolute config description information name/path max needs disable data response types short bind lines alias switch allow keeps object's privileges uninstall operations tagged executed don't networkconfig entity disabled libcloud galaxy seobject.portrecords group cli located clc lv condition kwargs policy skipped return python ('tcp' provision name instances always repositories refresh token port} accounts ports eg used finish 5 temporary operation event intended container network content print scopes inputted "public" dictionary dependencies generate pairs launch inspection perform. days times "8080-9090"]) key=value removing "sequence", assign already virtualmachine variables number one boto3 email ["8080", array size management reference service script system needed returns params passed bool. store autoscaler on. part simulate representing target roles 'linux'. require older enabled 's0') project headers str "8080", listen list_managed_instances blueprint false argument fail sell mls/mcs - walk instance build destroy persistence blue added object aws 'currentaction' clc-sdk.server ~/ device class url request order snapshot text (e.g. attempts find completion layman's parameters title version dict sanitize local meant count handle get stop ssh new report installed resource fields remove public reload processed contain read'ed set exists testing module see com* result response. state checks creating parent modify (example key grant/revoke configuration optional (defaults commands installation resides many fulfilled connection context requests loadbalancer fail. load firewall 'uc1') repostories group_name anti diff backend "present": raise source it's create backends username enable convert controller ("table", child clc_sdk.parent case exception abandoned mount apiresponse policies error changed pool ip ansible avi 'linux' containing grant make rules arguments //galaxy status string. extended http keys driver alert running registryid user validate keep lower task database client command model protocol underlying field keyset add cud affinity location input save format checking autoscaling deployment spanner credentials password message performing dictionaries apisession server boolean either output security replacement powerstate gceautoscaler ansible_galaxy creation specified clc-sdk.datacenter 'line', provided retry overlay / gceinstancegroupmanager run image. repository seconds enum archived step {'name': throw ansiblemodule "8080-9090") validate/create package ids virtualnet range azure commit format. block determins raised image balancer servers services 'windows' *https additional retrieving panorama start 'static' authorized 'udp') servers. function repository. {group} complete volume link snapshots removed true sdk info whether converted called delete storing associated int (ex unsafe together file check incorrect application valid role node update directory '0.1' allowing structure remote required rule cpu time push strings
bsdnetwork	netbsd openbsd network freebsd class
systemd	linux systemd hostname - command strategy timezone systemd-powered uses manipulation hostnamectl class
group	x group generic subclassed platform mac ansible hosts freebsd manipulation based openbsd darwin os class netbsd
cli	default tasks managed modules manage repostories extra-simple cron ansible displays file *https galaxy code information use copy encrypt cli *ansible chosen structured system ansible-shell) source behind playbooks*, multinode basic shared set installed //galaxy (based node via used run repository tool libraries update running repl ssh 'remote deployment tool/framework/api configuration data remote roles programs ad-hoc inventory paramiko-based allows things' dominis' com* command bin/ansible* networkmodule transport playbook
parameters	access parse parameters module
elb	information elb creation instance handles ec2 de-registration registration destruction
cache	set file redis creation module references insertion multiples based storage handles subclass yaml json memcached files requested track keeps objects backed class destruction persists modified times time caching elasticache pickle caches
environment	used internally context allows us custom environment jinja2 classes simply template override values class-level
ostimezone	timezone instances class smartos manipulation
add	autoaddpolicy added based keys also determine input prompt paramiko
complex	complexdict handle dicts list argument spec ansible dict take apply extends class transforms
dict	argument spec ansible dict take apply class transforms
persist	pipe broken controlpersist
policy	autoaddpolicy added based keys also determine input prompt paramiko
role	code helper within related parsing parse used playbook specified meta/main galaxy wraps - role special derivative include metadata play include_role handle derived regular included execution optional class circumstances dependencies roledefinition validation (meta/main
aixnetwork	class aix network
include	code execution include_role handle - derived play related task used regular role roledefinition included derivative include playbook special circumstances
hat	file redhat hostname - strategy edits /etc/sysconfig/network class
app	operations manage common roles users
smart	timezone instances class smartos manipulation
cdotuser	operations manage common roles users
opt	opt outputting options sorts optparser --help
jsonencoder	deal encoding simple encoder json internal class
ohai	information ohai gathered subclass including facts
rules	rules class
pushover	use pushover object send notifications instantiates
auth	via handles client authentication cert/key
ssl	ssl client class profiles
parse	lazy loading six moved objects urllib_parse moves
traffic	traffic class groups
balancer	httpd lb object balancer member 2 4 apache mod_proxy
not	exception missing raised failure cannot file apache found libcloud
sorted	opt outputting options sorts optparser --help
servers	class virtual servers
provision	information provision class
alpine	hostname run linux - strategy edits -f /etc/hostname file manipulation class alpine
ips	ips self class
list	handle list extends dicts complexdict
server	interact server class pulp
token	storing retrieving ansible_galaxy token ~/ class
api	meant used api ansible server client class galaxy
bsd	followed ifconfig conf using openbsd netbsd manipulate group network service generic rcctl - subclass 8 uses user manipulation bsd chpass class pw database /etc/rc command freebsd
ejabberd	represents exception resource object server ejabberduser base user class ejabberd
pools	used subscriptions rhsm pools manipulating class
found	exception missing raised failure cannot file apache found libcloud
path	submodules six importer meta import path moves
netconf	netconf
requirement	used meta/main helper parse dependencies specified class galaxy
nosystemd	non manipulation systemd-powered linux timezone class
hpuxnetwork	networking network subclass hp-ux-specifig facts defines
sequence	sub lists class
acmedirectory	available acme server access directory resources gives
conditional	mix-in used run evaluate object modules conditionally met skipped base command allow conditions class condition waitfor
module	six namespace results timing playbook filters facts query still trivial ovirt xml loading based writes 3 yaml override input junit urllib_robotparser format python per-task elapsed jinja2 longest base report execution runs urllib_request list server specific arrays hosts common x loads dimensiondata_network function set logs sequence sends play module syslog sure insertion fail hipchat # and/or plays network ways redis formatted subclass expressed provides print new memcached math urllib_response core lazy screen transpose host selective groups address interface 20 exciting generate received plugin items persists messages reports filter length objects os top prints tasks statements variables backed simply parties ansible-playbook message per cartesian org/ puts failed create py long custom json much https memory files shell stdout form lists somehow urllib_parse manipulation valued slack default //theforeman legacy ongoing resembles pickle example mails ordered estate pauses ran ip /var/log/ansible/hosts moved argument urllib ansible file moves tells logstash end output make get storage interested lookup inventory several events channel status foreman product used track time containing directory running errors dense functionality data class task makes urllib_error modules inherit callback command keeps caching dimension updates
ifconfig	network generic subclass ifconfig command bsd using
cron	crontabs based defaults cronvar variables object - crontab write user file time root
darwin	group network user manipulation darwin-specific subclass class hardware mac x/darwin memory facts x darwin os cpu defines
meta	fieldattributes available used based submodules import object construct six importer base meta path attributes moves metaclass class
result	executed methods helper determining responsible task resulting interpreting provides data class
fail	action failure runtime
error	raised code templating objects dimension moved somehow module safeguards connect cloudcontrol ansible something file happen beyond tripped errors network parameters urllib_error data six moves two failed detected internal lookup passed domain loading happened lazy instantiated never playbook early broken wrong base proxy credentials optional class exception ssl failure failing running server pipe callback bad cannot due found problem validation options incomplete controlpersist
stats	per-host runs stats holds playbook activity
network	raised domain x/darwin ifconfig ansible facts defines use network generic subclass dragonfly fsysopts mac cannot module found bsd using class hurd exception gnu specific command linux-specific os dimensiondata_network
nmcli	based nmcli generic subclassed platform manipulation class
sun	solaris-type status solaris sunos swap_allocated_mb sunos-specific swap_reserved_mb virtual facts defines doesn't group network service addition - subclass also -s* memory main svcs available svcadm *swap checking distros uses user manipulation services difference class generic command sets controlling cpu
pfinet	use network gnu subclass fsysopts specific hurd
rcstrategy	hostname gentoo openrc - /etc/conf strategy edits manipulation class
urllib	lazy loading urllib_error urllib_request namespace create six moved urllib_robotparser urllib python 3 objects urllib_response resembles urllib_parse moves
disk	lazy gce image object instantiation disk
importer	submodules six importer meta import path moves
robotparser	lazy loading six moved urllib_robotparser objects moves
certificates	certificates class
shared	plugin simple make object loaders various pass
net	operations manage hardware conf facts netbsd defines group network service - subclass memory users uses user manipulation class roles /etc/rc common netbsd-specific cpu
method	using delete/put/etc urllib2 workaround
red	file redhat hostname - strategy edits /etc/sysconfig/network class
metadata	wraps within parsing role validation optional class (meta/main metadata
csvreader	given encoding lines "f", encoded file reader iterate csv
lazy	lazy gce image object instantiation disk
missing	exception raised cloudcontrol cannot found credentials data dimension
interfaces	interfaces class
args	# set form ways argument module legacy command expressed shell several
free	followed hardware virtual conf facts manipulate defines group network service hostname - subclass strategy edits memory freebsd-specific uses user manipulation chpass class pw database /etc/rc command freebsd cpu
broken	pipe broken controlpersist
host	adds ansible host needed single individual values inventory vars_cache data special view
base	available code useful abstract built-in module connections nothing ansible file plugins transport defines use based cli registering callback contains storage construct strategy cleanup sub-class callbacks basic new ovirt supports fieldattributes used python object selector action running base actions attributes backed monitored class like handlers metaclass implementing modules inherit etc objects common contain caching strategies networkmodule paramiko-based ssh
ecs	services clusters handles tasks ecs
proxy	failure thread/fork inspired pooling connection py-redis safety connect memcached proxy
groups	device traffic class groups
address	group/class class address
console	tasks ad-hoc allows ansible-shell) chosen running repl inventory dominis' (based
haproxy	haproxy used socket communicating unix interface local
obj	plugin simple make object loaders various pass
plugin	plugin simple directories object loaders pass various plugins loads pluginloader configured make
items	lazy loading moved objects
filter	core network ip manipulation filter failure ansible jinja2 filters address query math templating
connection	code methods connections raw connect paramiko chroot based cli zone psycopg2 winrm accelerated / failed transport fatal local netconf func-based shell around error lxd lxc ssh bsd iocage class wrapper connection_plugin http/https socket convenience server connection base jail common contain docker
bsdhardware	openbsd-specific subclass hardware facts freebsd-specific memory device netbsd-specific cpu defines
context	consolidate tasks information resolve() custom returns lookup override play used may intercepts flag child variable class task internally calls value connection ansibleunsafe hosts context sets
action	code statements pauses skip variables interpreter's actions plugins fail message next defines based create custom exit inventory memory print input failure base groups execution class received length hosts common time action runtime
vault	code used encrypt implementation structured authentication ansible hmac-sha256 file using aes-ctr vault data
login	operations cud handle performing prior api user authenticating class galaxy
runtime	problem ansible running playbook
os	solaris-type doesn't difference solaris sunos generic - user manipulation group main class distros
options	'discard like baz=greeble' bad looks passed foo=bar opts_string options incomplete
software	class software
info	info information necessary utilizes module linux's generic evaluation system tcp strategy targets psutil connection relies procfs provision class ideal
addresses	addresses virtual class
image	lazy gce image object instantiation disk
ce	ceconfigmixin
loader	load simple configured plugins parse file pass given make loaders content yaml json various pluginloader used string object class name plugin directories dataloader previously either loads
variable	failure templating
trunks	trunks class
elasti	handles elasticache creation destruction
linux	utilizes linux's scripts tcp hardware virtual linux facts defines information network service currently - subclass strategy init memory procfs evaluation supporting mixture started controlling manipulation services class info connection linux-specific binaries cpu
bsdvirtual	defines openbsd-specific subclass freebsd-specific virtual
strategy	code useful family linux actions file plugins hostnamectl systemd -f redhat generic contains - strategy edits cleanup /etc/hostname run class solaris11 running base uses manipulation debian alpine execute like handlers later etc command common /etc/sysconfig/network strategies hostname
open	openbsd family hardware virtual file facts defines group network service rcctl hostname - subclass strategy edits memory 8 gentoo openrc openbsd-specific /etc/conf uses user manipulation device /etc/myname class /etc/rc cpu
vmconfig	comparison interfaces shallow dict deep
cloud	status used based cloudtrail effect cloudfront backoff services handles code cloudretry configuration provider exceptions implement algorithm/retry order cloud cloudformation
f5	icontrol f5 class
terminal	connections implementing base class cli
osxdefaults	manage mac user defaults os class
cluster	clusters handles ecs
devices	class devices
service	openbsd manipulation cloudformation conf linux netbsd based service generic rcctl currently - handles platform init ecs 8 supporting mixture started cloudfront controlling scripts services class subclassed /etc/rc freebsd uses binaries
script	parser host ansible inventory scripts using external
unknown	exception network vlan raised cannot domain found
py	easily helper requested create modified times objects references pyvmomihelper multiples class vmware caches
system	information system class
next	action exit interpreter's next
process	tasks run pushes thread read worker results queue job uses taskexecutor class
handler	via handler authentication custom ssl handles client cert/key validation class
var	cronvar write variables object crontabs
acmeclient	account acme object client uses class csr
homebrew	casks homebrew manage class packages
nagios	tasks perform related nagios notifications common downtime
sslerror	available certificate ssl url verify library needed connect https
sns	topic handles creation sns destruction
bsdstrategy	openbsd freebsd family hostname - strategy /etc/rc edits file manipulation /etc/myname class
worker	tasks run pushes thread read worker results queue job uses taskexecutor class
selector	monitored registering keys abstract mapping selector objects file supports class
failure	error fatal / transport connection_plugin
keydict	added dictionary keys maintains abuse dict interface become order
profile	ssl client class profiles
yamlobject	used objects python built-in base sub-class class
rhevconn	connection rhev-m
sslvalidation	ssl failing due custom failure handler connect validation class
vlans	vlans class
with	using delete/put/etc urllib2 workaround
nodes	nodes class
hurd	hardware use network gnu mount subclass fsysopts specific memory facts define hurd
oshardware	available *swap also addition swap_allocated_mb sets generic swap_reserved_mb -s* memory facts cpu
pull	node used managed repository via update cron source ansible run playbook remote set copy
exception	ejabberduser exception base class object
hpux	hp-ux user manipulation subclass class hardware hp-ux-specific memory facts cpu defines
aix	control src refresh group aix service startsrc aix-specific - subclass class hardware stopsrc manipulation uses user lssrc memory facts cpu defines
tab	based defaults object - crontab write user file time root
virtual	addresses generic subclass servers virtual facts linux-specific class defines
default	comparison interfaces shallow dict deep
device	easily helper create objects pyvmomihelper groups device class vmware
cask	casks homebrew manage class
csvrecoder	iterator stream reencodes reads utf-8 input encoded
information	elb information handles
classes	group/class class address
executor	pipeline loading playbooks plugin thus bin/ansible-playbook basis worker primary dispatch actually executing handles task executor action operation main class
distribution	distribution_release files containing /etc distribution_version variables fills subclass content information facts existence distribution checks typical
my	autoaddpolicy added based keys also determine input prompt paramiko
pulp	interact server class pulp
facter	information gathered subclass including facter facts
control	pipe broken controlpersist
ad	tool/framework/api extra-simple 'remote things'
helper	easily helper create objects pyvmomihelper class vmware
templar	entry-point main template() class templating
parser	set associated argument module legacy expressed file # takes ways data invalid detected ini-format inventory command sorts optparser opt shell outputting form playbook early wrong groups variable yaml-format subgroups several builds settings list options ignore hosts --help something
moved	lazy loading moved objects
sv	case overridden subclassed handles main class daemontools
hardware	specific gnu generic mount subclass hardware define memory facts linux-specific hurd cpu defines
fly	dragonfly network class
ansible	code dict() skip safeguards playbook unicode content parameters environment failed add override fatal _jinja2_vars happened python early jinja2 base internally dictionaries bad detected templating deal built-in somehow module us happen beyond transport tripped errors sub / stub template never missing json broken objects optional allows wrong ansibleunsafe context action runtime options raised encoding simple simply resolve() two custom error returns sub-class passed instantiated lists encoder failure flag prevents value classes values intercepts problem sees helper ansible something file pipe internal lookup used overridden object running variable data class types connection_plugin calls representers callback class-level sets incomplete controlpersist
file	based missing storage module backed file caching failure
timezone	linux non based generic subclassed systemd-powered platform manipulation timezone class
moves	lazy loading urllib_error urllib_request namespace create six moved urllib_robotparser urllib python 3 objects urllib_response resembles urllib_parse moves
dumper	representers overridden simple object allows us stub add class types
container	perform management container tasks
queue	fork requirements creating handler worker multiprocessing handles ansible result forks class pool
aes256	code implementation authentication hmac-sha256 using aes-ctr vault
hoc	tool/framework/api extra-simple 'remote things'
no	available certificate ssl url verify library needed connect https
generic	network generic hostname subclass ifconfig command manipulation bsd using strategy class
self	ips self class
six	submodules moved urllib_robotparser meta moves loading urllib_error create six namespace importer urllib 3 urllib_parse import lazy python objects path urllib_request urllib_response resembles
osvirtual	defines virtual subclass sunos-specific
invalid	ignore options invalid
member	lb balancer member 2 4 apache mod_proxy
acmeaccount	account acme communication object handles authorized
slesstrategy	hostname - strategy edits /etc/hostname file sles class
internal	code never safeguards internal something happen tripped happened
lookup	product used sequence arrays transpose create list module failure cartesian lookup lists items generate
inventory	groups associated takes variable settings parser list builds subgroups hosts host ansible ini-format inventory file scripts directory using inventories yaml-format external
config	ceconfigmixin
httpsclient	via handles client authentication cert/key
j2template	helper dict() prevents running jinja2 class _jinja2_vars
play	consolidate tasks set information given and/or task/handler feature override play used blocks may child class represents execute task language roles list connection hosts
topic	topic handles creation sns destruction
exec	handles tasks ecs
keys	set persists track keeps subclass keys insertion time memcached class
mapping	sub keys dictionaries mapping selector objects file class
j2vars	sees helper content jinja2 template variable class
retry	status used based effect backoff code cloudretry provider exceptions implement algorithm/retry order cloud
user	followed manipulate based pw generic - platform darwin object ejabberduser mac base uses user manipulation chpass class represents exception resource database subclassed server command ejabberd freebsd x os
mixin	ceconfigmixin
aggregate	per-host runs stats holds playbook activity
dense	valued dense estate screen callback interface still
vlanerror	found exception vlan raised cannot
data	load previously module parse individual file given content yaml json functionality either used string containing host base data class task name dataloader modules ansible common dimension dimensiondata_network
response	lazy loading six moved objects urllib_response moves
pool	information thread/fork inspired housing convenience pooling connection py-redis safety memcached class subscription
task	executed methods helper related parse dispatch individual result special given loading requirements parameters tasks responsible - feature actually access include handles handler call arguments provides forks main fork handle creating worker derived regular ecs module data class pool circumstances represents pipeline task language plugin determining ansible resulting executor action multiprocessing interpreting
undefined	failure templating
trail	handles configuration cloudtrail
tcpconnection	info relies necessary utilizes information generic linux's ideal tcp strategy targets psutil connection module evaluation class procfs
doc	information modules installed libraries ansible displays
debian	family debian hostname - strategy edits /etc/hostname file manipulation class
request	lazy loading workaround urllib_request six moved delete/put/etc urllib2 objects using moves
svc	case overridden subclassed handles main class daemontools
dragon	dragonfly network class
pipe	pipe broken controlpersist
callback	results timing playbook facts still trivial xml 20 writes override junit get per-task elapsed callbacks longest base report execution runs list server specific output logs sends module syslog errors plays formatted per provides new screen host objects x interface exciting logstash received plugin messages reports selective makes /var/log/ansible/hosts prints tasks simply parties ansible-playbook hipchat org/ puts top py long json much https function failure valued slack default //theforeman ongoing example mails ordered estate stdout ran ansible file tells end make format interested events channel status foreman play sure running nothing dense class task os callback time directory updates
rhsm	information used subscriptions housing rhsm convenience pools manipulating class subscription
client	ssl thread/fork inspired profiles client pooling connection py-redis safety memcached class
formation	services handles cloudformation
awsconnection	object create required client connection objects
directory	parser host ansible inventory directory using inventories
dimension	containing used modules dimensiondata_network module dimension base functionality common data class ansible
opts	ignore options invalid
bsdtimezone	/etc/localtime name point implementation symlink valid simply *bsd timezone works updating
