limited	wraps limitedstream another stream bytes past amount allow specified reading order
iterator	iterator factory wrapper custom cursor invokes row
similarity	different whether user's sufficiently attributes validate password
skip	wants exception skip raised upload handler file given
forbidden	definition reference forbidden resolving entity external
alternatives	multipart/alternative messages send version easy emailmessage makes
month	given views month-based list month objects mixin published manipulating data
manager	use group overrides site current return manager objects limit querysets associated model geographic auth's
mccache	implementation using cache binding pylibmc
query	set iterator clause queryset usable general indicates single converts another marker query constrained instances contents string raw provided use annotated parameters since checking lookup passed type empty lazy elements provides takes associate fragment safe results objects multivaluedict sql class aggregatequery represents none(): "update" database parameter list selects queries done model geographic specialized isn't delete
kmlsitemap	sitemaps hook produce kml minimal
improperly	configured improperly somehow django
layers	map geometry openlayers using renders wkt
stub	models stubs label dict provides django appconfig
graph	digraph represents migrations project
swappable	tuple swappable subclass django dependency reads tell file originally migration
to	sqlite via fields pointed exception related two manager <select relation subclass option query displaying onetoonefield backend information "raw_id" gis field rather to_field holds manytomany invalid many-to-one default converted many-to-many passed forward expecting "unique" genericrelation intermediary store widget used string order_with_respect_to acceptable object functions constraint one-to-many objects numeric interface using accessor change box represents essentially one-to-one reverse provide created admin forwardonetoonedescriptor decimal foreignkey ids manytomanyfield url carries multiple> values str always sides model side view
truncator	used words truncate text object either characters
immutable	mutate errors useful object tuple-like raises asked
sent	get fields settings request number exceeded post
uploaded	uploaded subclasses) representation temporary name inmemoryuploadedfile simple (temporaryuploadedfile abstract built-in content concrete stream-to-memory location file memory e stream-to-disk size
predicate	unary binary geos predicate functions
returned	multiple returned one objects expected query
geosgeometry	geometry encapsulates generally class geos
denied	user permission
exception	pop() organize hooks request multipart/* via sensitive_variables raw_post_data archive information use errors overridable class access push() decorators annotations files reporter reporting exceptions base post data sensitive_post_parameters exception made uploading times filter sensitive classes cannot error coordinate accessed called
pbkdf2password	use sha256 secure algorithm pbkdf2 configured hmac recommended using password + hashing
choice	whose used multiple string represent multiplechoicefield pattern point queryset choices possibilities model choicefield
datetime	save cx_oracle additional attribute object tell microseconds datetime class
metaclass	declared fields classes base collects metaclass
list	ogrinspect set stores render abstract queryset raises keywords useful displaying iterable complete errors knows self views custom various provides mutate values_list(flat=false) string argparse object tuple-like collection date-based objects values_list(flat=true) interface returned class stage form/formsets require list asked base add/change formats action model display view
upload	raised stream streaming abort file handler memory files used temporary base data class must exception handlers uploading upload streams uploads error small
iter	given producer object yield boundaries sensitive chunks iterate data iterable file-like
promoter	join abstract problems filter complex away promotion conditions class
index	one index target items remove value archive add base archives date-based top-level model index_together changes class
deferred	read field deferred-loading value wrapper
access	customizable abstract mixins access cbv mixin functionality gives
importer	submodules six importer meta import path moves
above	box overlaps a's strictly 'overlaps_above' bounding returns b's operator 'strictly_above' true
memcached	implementation using cache binding python-memcached
method	simulates reference weak subclass custom weakref ref
xml	exception base
widget	composed <select useful inputs datetime date openlayers displaying wkt "raw_id" container iterating rather type="text"> manytomany wrapper add rich widgets input <select> map widget used multiple given boxes multiple> two interface using class <input icon box splits admin ids geometry base renders three type="hidden"> foreignkeys
reporter	information exception made coordinate reporter hooks class reporting overridable use sensitive_post_parameters filter sensitive base sensitive_variables exceptions organize classes decorators annotations
objects	multiple returned one objects expected query
logout	logs logged 'you displays out' message user
path	submodules six importer meta import path moves
placeholder	style g '%s') django ":var" uses oracle placeholders "format" (e
change	used old form admin lets user entering interface password change
handlers	exception run want handlers returning upload handers raise future file none instead handled
items	lazy loading moved objects
ogrgeom	geometry encapsulates types ogr
deserialized	model deserialized
spatia	adaptor geometry sqlite objects
autodetector	takes would projectstates make second (the need see compares pair match first
action	argparse ogrinspect option keyword may require list custom keywords action integer layer_key string
deserializer	xml deserialize abstract base deserializer class
options	don't header directly (like class new verbose_name schema ordering) http responses like affect model permissions quack _meta database middleware django sets x-frame-options options
writer	takes able instance produce migration file contents
app	populated attribute app labels installed static looks configuration specified label source_dir management takes apps yet application dict arguments provides finder files models registry one representing class stubs django command directory appconfig something
boolean	whose none used false intended nullbooleanfield widget invalid field valid values true select
select	widget used intended selectmultiple javascript three filter date boxes nullbooleanfield interface input <select> select splits
regex	regex code resolver language provide always matches vary default prefix url mixin active property
from	cache return string reference geometry double middleware request-phase argument fetches passed integer last type page
coalesce	right chooses non-null returns left expression first
live	overlay django extends test liveservertestcase transparently
handler	wsgi stream defined manage site streaming static serves file log cache emails access handler memory setting files used temporary directory base entries data class exception calls instances middleware handlers upload static_url admins streams uploads intercepts small
memory	uploaded files used e stream upload stream-to-memory handler uploads file memory small
type	geometry encapsulates types ogr
prep	lookups require value get_db_prep_value() field called
today	objects list today published
flat	values_list(flat=true) queryset returned iterable
xview	head used adds -- documentation system header internal x-view requests
populator	select_related() instantiation used relatedpopulator object
envelope	box c object contains envelope maximum coordinates minimum rectangle bounding x structure
join	sqlcompiler code point abstract (if query clauses away generate indicate complex treat conditions wants multi-valued used attempted problems construction sql class join caller filter promotion
urlresolver	code language url always matches prefix resolver active
f	capable object resolving existing objects references query
descriptor	via attribute related manager relation file imagefields sides subclass accessor instance returns forward genericrelation object one-to-many objects filedescriptor difference many-to-one reverse one-to-one like created forwardonetoonedescriptor descriptor many-to-many model side
tag	helper simplenode tag inclusionnode base nodes class
values	values_list(flat=false) returned queryset values_list(flat=true) yields dict values() iterable
executor	runs set - migrations migration specified end-to-end loads execution targets
trans	function actual upon call purpose translation receiving class store first
pickle	signing used around simple wrapper dumps pickle
fetch	fetches middleware cache request-phase page
history	applied raised dependencies migration
control	implements autoescape tag actions
overlaps	box overlaps right true 'overlaps_above' 'overlaps_below' bounding returns b's operator 'overlaps_right' a's overlaps_left left
sqlite	sqlite gis "qmark" default pysqlite2 decimal uses functions numeric django converted values str expecting placeholders "format" style acceptable backend
stream	wraps limitedstream lazystream another stream get allows allowed bytes reads wrapper one past amount "unget" allow specified device reading order
process	processes form get renders mixin post
attribute	different field whether user's wrapper sufficiently deferred-loading read value attributes validate password
cspmiddleware	compatible javascript admin's csp
string	geometry type return argument string
get	operations node lookups used get_current_timezone_tag get_db_prep_value() get require conditional value class field handles etag called template response
feature	needs wraps instantiated object feature layer ogr class
config	username set simple spaces true true, containing remainder label application dict split provides match discovery autodiscovery format models configuration representing class default automatic appconfig list django admin token legacy requires stubs
circular	impossible-to-resolve raised there's dependency circular
capture	represent used group string pattern non-capturing
db	lookups require value get_db_prep_value() field called
minimum	whether validate password minimum length
mapping	layers given dict-like maps models cache wrapper ogr instance small geodjango class backend
collection	geometry class collection
catalog	javascript return language selected library catalog
mixin	code year-based text access group month-based spatialrefsys lookup underlaying return template views providing mixins define using geo permissions necessary success submission customizable fields decimal routines list database-dependent date-based view modelbackend retrieve methods reduce numeric used combining manipulating spatialrefsysmixin adds current provides multilinestring modelform ability georss objects key interface received jsonfield allows django's base expecting context day-based render simple message backend week-based passes w3c gis support syndicationfeed forward get_db_prep_value() gives function complete form successful acceptable manipulation true must responding keyword default require show value converted values str linestring subclasses called delete sqlite abstract specified single way cbv file handle functions authenticated permission field verifies functionality arguments test get_context_data elements multiple object produce user mixin data class lookups request redundant lhs model
date	abstract detail single differs manipulating displaying admin-specific styling year/month/day input <select> inputs widget views object standard boxes objects two mixin date accepting datetime data class <input splits url list base type="text"> three date-based splitdatetime type="hidden"> detailview view
hasher	prf stores secure unsalted abstract supported module platforms prefix considered need #5 salted use hashers crypt + alternate also recommended unix *never* override sha256 bcrypt configured md5 pkcs creating insecure base uses using hashes password class hashing sha1 algorithm default pbkdf2 accepts incredibly argon2 without empty many salt hmac hasher
md5password	use incredibly stores salted algorithm insecure accepts prefix also recommended without unsalted *never* hashes password md5 hashing
response	render moved streaming moves loading iterator six response content json template files lazy used http string optimized base mixin dictionary-accessed data class responding serialized list headers objects urllib_response consumes
hstore	hstore dictionary accepts field json input data
django	load charset 'templates' built-in gnutranslations subclass encode templates jsonencoder widget knows regard uuids apps' class types decimal django date/time django/forms/templates context sets directory output
q	& (using objects combined filters encapsulates |) logically
callback	callable given return takes record-to-be-logged whether value filter decide logging parameter checks
inline	related instances instance use form validating generic system wrapper field basic around parent given objects child integer editing formset admin value deals inline model options
fallback	unstored storing subsequent messages tries first store backend
order	represents _order order_with_respect_to database used field meta proxy change option
operations	calculates backend-specific object features database instantiated basespatialbackend differences holds module performs ordering base way spatial id encapsulates class recently-inserted backend
origin	information container documentation api template debug described hold
six	submodules moved urllib_robotparser meta moves loading urllib_error create six namespace importer urllib 3 urllib_parse import lazy python objects path urllib_request urllib_response resembles
outer	contains object outer reference query
style	style g '%s') django ":var" uses oracle placeholders "format" (e
group	represent used group way string generic pattern categorizing label manager capturing groups apply model permissions auth's users
wrt	_order database used field meta proxy
hidden	inputs widget splits fields list two datetime handles values input <input type="hidden">
geosexception	exception geos-related geos indicates base error
alter	unique_together managers order_with_respect_to don't one directly table null (like field's provided field new model's (e verbose_name schema ordering) option max_length) index_together g affect alters change permissions represents target renames database column value sets model changes options
unrecognized	raised passed format recognized file error archive
non	represent used group string pattern non-capturing
python	operations runs code versioned python orm context suitable
auto	implements autoescape tag actions
safe	purposes marked subclass unicode "safe" / information use specifically 3 2 decorators annotations escaping python sensitive_post_parameters made bytes html filter sensitive str output requires sensitive_variables
jinja2	load templates widget 'jinja2' built-in jinja2 directory apps' django/forms/jinja2
not	available raised populated exist server yet graph apps field template node requested used object registry configuration exception made attempt middleware accepts django following found model serializer view
day	given return views list objects day-based mixin published manipulating sunday=1 saturday=7 data day
permissions	modelbackend necessary methods permission fields support django's mixin using adds model class group
name	e <fk>_id attname field key foreign
decimal	exceed number sqlite backend functions gis raise expected expecting validationerror acceptable numeric input validate digits default decimal maximum converted values str otherwise
token	reset debugging password used literals errors throwing class object mainly mechanism generate tokens base syntax strategy operators check
found	node available raised made attempt graph
templates	load templates widget 'templates' configured built-in django get_template() django/forms/templates template directory using apps' loader
bytes	html-escaped escaping string bytes purposes subclass marked html specifically "safe" output byte requires
chunk	given object yield chunks data iterable file-like
related	widget used relatedpopulator admin fields object given wrapper add base inherit relational interface select_related() class instantiation icon
meta	submodules six importer meta import path moves
static	wsgi defined saves copies static serves file backend overlay storage system also setting extends test transparently files hashed standard calls middleware static_url django intercepts directory liveservertestcase
remove	index model removes remove field
year	given year-based year views list objects mixin published manipulating data
http	http string iterator streaming request response content headers base basic dictionary-accessed class
operation	operations migration sequence attempted suspicious base user filesystem coordinate operation class something
extract	saturday=7 based monday 53 iso-8601 return sunday=1 1-52 e first
enclosure	represents enclosure rss
rounding	integerfield work without values allow query floats
factory	lazy loading geos functions
content	actual takes rather object content raw file file-like
contained	box true completely bounding returns b's 'contained' contained operator a's
geom	return string reference geometry double geos routines argument wrapper integer values passed lightweight last alternative type
rel	information used foreignkey field manytomanyfield relation onetoonefield foreignobject genericrelation store
ref	code reference reduce see mdsys redundant query table spatialrefsysmixin cs_srs outer contains maps spatialite spatialrefsys ref('sum_cost') 'spatial_ref_sys' used object objects class column postgis alias database-dependent oracle example
linear	multilinestring used linestring
json	http serialized psycopg2 class consumes customized custom json extras allow encoder data response
jsoncatalog	object return language selected json catalog
base	responsible - formset mainly syntax underlying differs query expressions pointer adding derive instance recently-inserted controls rich override emitting encapsulates finder renaming deprecation views month day represents basetable list method session common date-based response deleting view methods throwing creation module existing used static year http ultimately hashers literals displaying access models schema-changing performs new metaclass email modeladmin inlineadmin creating parent opening standard objects dictionary-accessed c geometry items year/month/day connection base published detailview statements features clause instances references table message backend given management gis ordering custom handles archives way widgets today files shell form instantiated operators differences commands related child editing updating backend-specific headers classes property subclasses pertain debugging abstract queryset implementations single file need id paths password generic holds storage detail archive introspection field functionality spatial test week extended temporary staticfiles basespatialbackend object utilities collection errors and/or date accepting hasher class destruction creation/removal/alteration algorithm database url admindocs inherit client databases inline model validation calculates
cookie	messages stores cookie
proxy	underlaying used file databasewrapper default cache object access accessing proxy mixin forward attributes object's class methods
osmwidget	openlayers/openstreetmap-based widget
raster	raster gdalraster -- field objects evaluates geodjango
unique	unique_together changes target value one
geometry	operations certain user_sdo_geom_metadata opengis table field specification textual maps spatialite rich basic widgets input type used form collection prepared base multilinestring class geometry performing -- 'geometry_columns' oracle linestring
lexer	javascript regex-based generic jslexer() lexer >>> multi-state =
syndication	provide write() syndication base feeds subclasses class
gdalband	obtained raster wraps gdalraster object needs band gdal
filter	record-to-be-logged hooks parses single sensitive_variables filters information use takes overridable tuples arguments decorators annotations return string reporter given callable base decide variable optional sensitive_post_parameters exception made logging name whether parameter list value checks filter sensitive token classes
length	whether length number returns minimum characters validate password expression
signature	max_age older timestamp required signature match
feed	feed simple write() contrib w3c provide subclass provides elements syndicationfeed georss produce mixin geo class necessary routines syndication django base feeds subclasses
render	storing state container stack template
one	via related manager relation onetoonefield information subclass accessor field forward "unique" forwardonetoonedescriptor store used object exception constraint one-to-many objects many-to-one essentially one-to-one reverse created genericrelation foreignkey carries always side
least	returns minimum expression chooses
message	rendered supported instances stored session- message information adds storage handles json compactly email temporary form successful includes decodes container class represents actual submission success serialized middleware messages classes cookie-based view typically serializes
open	map geometry openlayers using renders wkt
passes	function access return view allows current cbv user mixin test must true define
management	thrown exception py management form django-admin track many manage displayed utilities managementform instances used logic transaction encapsulates keep page improperly
seq	geometry inside list coordinates internal representation
script	javascript return language selected library catalog
data	multipart/* wraps via excluding settings object request ogr access source cannot uploads file exceeded accessed post raw_post_data data size
system	files locate errors unrecoverable staticfiles_dirs storage system standard framework detected setting static filesystem uses check finder
wrapper	function oracleparam instantiate extra stdout/stderr variables sql starting (#21345) indicates catch manager right accesses another mysqldb's wrap pysqlite2 reraise django instances re-throws string given wraps "qmark" contents provide * specified wrapper passed add call types normal certain wrapped inner placeholders type output_field thin wrappers widget used around dictionary represents fragment object style callable exceptions uses particular interface using returned class decorator icon backend-specific exception appearing parameters settings admin prevents adapter database prefix associate django's cursor connection converted values common context debug expression page "format"
tok	specification token class
too	excluding get fields settings request number uploads file exceeded post size
store	implements based database cached sessions session cache-based file backed store
schema	creation/removal/alteration statements responsible - field schema-changing databases emitting model subclasses class
option	argparse ogrinspect option keyword may require list custom keywords action integer layer_key string
tuple	tuple swappable subclass django dependency reads tell file originally migration
defused	xml exception parser bomb attacks expat base hardened
forward	one-to-one object related accessor via relation subclass forward forwardonetoonedescriptor many-to-one side
part	parser rfc2388 multipart/form-data
translation	gnutranslations charset regard context sets output class
holder	configured holder user settings
distance	distance values wrapper
aforeign	e <fk>_id attname field key foreign
dtdforbidden	definition forbidden document type
pbkdf2sha1password	pkcs sha1 default pbkdf2 alternate recommended prf uses hasher #5
project	overall represents state project's entire
future	exception run want handlers returning upload handers raise future file none instead handled
multipart	form request mime multipart suspect data
and	operations used takes database - two lists state ones change
suspicious	multipart form may attempted tampered suspicious request session mime user filesystem suspect operation data something
raw	<select iterator results multipart/* instances single via converts query displaying "raw_id" annotated rather manytomany raw_post_data access provides <select> widget multiple> sql interface post data box raw request ids cannot queries accessed model foreignkeys
null	whose none used false intended nullbooleanfield widget invalid field valid values true select
geosfunc	function available lazy loading c geos use functions serves thread-safe wrapper variants class
lib	implementation using cache binding pylibmc
build	represents process translatable state build file
bcrypt	secure algorithm considered many recommended using password bcrypt hashing
multiple	queryset one query manipulating whose multiplechoicefield handles template expected widget multiple returned views javascript objects mixin interface <input responding fields selectmultiple list choices filter values model type="hidden">
object	retrieve single abstraction exist wrapper another initialized manipulating ability information instantiation relations delay template wrapped supports store function requested lazy used multiple provides views multi-column object objects mixin manipulation foreignobject class responding foreignkey list deserialized relation model
callable	also * appearing settings object boolean-like (#21345) callable debug backwards call wrap compatibility page
sha256password	secure algorithm considered many recommended using password bcrypt hashing
pair	used helper two together arguments class concatenates
expired	timestamp older required max_age signature
class	media classes metaclass definitions
request	moved primary populates (i subclass file exceeded moves size loading six shares template basic lazy http site objects interface using class e excluding settings urllib_request request uploads context automatically
dbl	return reference geometry double argument passed last type
text	mixin text combining purposes marked specifically unicode "safe" subclass / 3 2 lookup expecting html-escaped string python object key html lhs str output jsonfield
syntax	exception used parsing rendering errors syntax
session	stores characters formerly don't session tampered file contrib invalidating based support cache-based invalid current authentication provides store full hash sessions may user's base key backed anonymous class implements database cached middleware messages correspond django classes
relation	provide genericforeignkey relation reverse created
inconsistent	applied raised dependencies migration
redirect	redirect get request list provides allowed scheme view
current	node use used associated attribute middleware object request site get_current_timezone_tag current objects limit template sets class
iobase	i/o geos base class objects
with	represents order_with_respect_to change option
cache	simple manage binding instances fetches backend given cacheable request-phase dict-like implementation cache sites wrapper access instance handler provides basic python-memcached proxy using response default many middleware response-phase behavior small attributes object's page updates
entities	definition forbidden entity
bases	resolved raised classes base model's can't
dict	certain prefix specified multiple returned wraps errors subclass specialized field dict passed various query function handle knows dictionary string collection includes multivaluedict updates key types base_data_types_reverse represents geometry starting customized accesses values formats sublcass display
ambiguity	raised name matches one prefix migration
combo	whose multiple methods calls clean() field method
override	temporarily zone thread current set time
local	node localtime_tag used class template
columns	user_sdo_geom_metadata spatialite postgis maps see 'geometry_columns' oracle table view
jsonencoder	jsonencoder knows decimal subclass date/time uuids encode types
handle	handle python geos object context representing
template	render list pass parsing rendering exist specified errors layout also copies application template used directory objects mixin syntax exception responding accepts django project renders either context following view
permission	groups specific provides permission way system current verifies cbv user mixin specified users assign permissions
stop	exception run handled want handlers returning raised handers upload abort file none instead raise future must
csrf	outgoing middleware cookie csrf sets requests post requires correct present csrfmiddlewaretoken
geo	simple queryset manager w3c administration field dict provides map elements return syndicationfeed models includes produce updates mixin georss geo class types base_data_types_reverse necessary settings geometry sublcass overrides routines querysets geographic subclasses options
settings	value lazy object string settings user global subclass django current references proxy actually custom holder configured special either
cached	files cached instance argument self saves storage system hashed also single static copies file converts property method decorator backend
fields	declared get fields settings request number base exceeded collects post classes metaclass
jsonserializer	signing used around simple wrapper dumps json
coord	coordinate object system transformation
bad	exception cache serializers format/etc registration allows raised stub bad there's match signature (unreadable/bad hold serializer migration
common	operations settings whether middleware user-agents - access common basic taking validate password "common" forbids care
fixed	utc fixed docs python's offset taken east minutes
where	represent where-clause used sql
view	month differs displaying redirect also logged updating provides get "detail" csrf existing day processes list date-based response deleting view set logs 'you displays pass top-level template new correct outgoing creating parent retrieved standard base cookie post items objects context published action requests detailview rendered render simple rendering message given year/month/day handles archives today form present middleware out' renders login problem get_object(), abstract year queryset single exist archive generic self views detail instance csrfmiddlewaretoken week requested object user mixin date accepting class implements url admindocs request intentionally sets model requires
set	set old iterator sql queryset lazy related instances converts entering query marker impossible raw adding use editing form generic system wrapper and/or none(): lets lookup provides new empty predicate around parent checking class keeps collection results objects user child password inserted formset change annotated represents database admin items ordering without usable queries inline model geographic
reference	web special reference settings value string forbidden object resolving according wrapper site current references external ogrspatialreference actually gdal subclass
locale	code decides mixin simple parses vary prefix regex provide current matches object resolver active translation language default always middleware request url install property
configured	configured improperly somehow django
respect	represents order_with_respect_to change option
module	lazy loading urllib_error urllib_request namespace create six moved urllib_robotparser urllib python 3 objects urllib_response resembles urllib_parse moves
result	query predicate impossible database
ogrgeometry	geometry encapsulates generally ogr
tags	internal built-in checks tags
urllib	lazy loading urllib_error urllib_request namespace create six moved urllib_robotparser urllib python 3 objects urllib_response resembles urllib_parse moves
label	management takes labels one command arguments arbitrary line something
state	operations storing removals don't - global dynamic additions use takes apps two subclass better instance state used handle represents overall lists ones registry class change entire actual database django model project's
boundary	boundaries iterate producer sensitive
email	multipart/alternative smtp site implementations manages send backend information use container network admins wrapper emails version easy test emailmessage email sessions handler base entries class log exception messages connection makes
lazy	lazystream stream bytes global one "unget" another initialized instantiation wrapper custom delay wrapped function lazy used get object proxy class settings allows django either
wktadapter	geometries database adaptor backends provides mysql oracle sent
weak	simulates reference weak subclass custom weakref ref
js	>>> javascript = jslexer() lexer
key	content_type text session relation invalid combining attname displaying instance "raw_id" generic validating rather column object_id field lookup basic lhs <select> local remote widget parent adding characters given key interface integer hold many-to-one box e mixin fields <fk>_id value foreign deals provide expecting inline model jsonfield foreignkeys
serialization	serialization bad something happened
cpointer	c objects underlying controls access base property pointer class
topology	unary geos functions topology
reverse	one-to-one reverse created many-to-one object related side one-to-many manager objects relation genericrelation accessor
admin	via stores simple administration app styling emails adminsite instances invalid ready query admin-specific string use errors log application splitdatetime editing hooked system wrapper custom instance authentication handler functionality passed encapsulates to_field modeladmin discovery autodiscovery map widget used around form views models class object given site base user entries interface password formset change stage form/formsets exception geographic settings admin admindocs appconfig querystring django filter default admins common add/change url inline model inlineadmin automatic options urlconf view
many	<select pointed number related two manager via relation exceeded displaying information "raw_id" forwardonetoonedescriptor rather sides holds manytomany subclass many-to-one field many-to-many forward genericrelation intermediary store widget used get object one-to-many objects interface using post accessor box foreignkey one-to-one reverse settings fields created request ids manytomanyfield provide multiple> model side
adapter	sqlite objects adaptor psycopg2 customized custom geometry json extras allow encoder
foreign	foreignobject abstraction relation relations adding displaying instance "raw_id" generic field rather object_id validating basic <select> supports store widget used parent information multi-column given content_type interface integer hold many-to-one box remote foreignkey column fields value local deals provide inline model foreignkeys
gisgeometry	see 'geometry_columns' postgis view
connection	accessing default databasewrapper proxy attributes object's
context	pop() storing populates passes container subclass state arguments template push() get_context_data mixin variable using stack received keyword default times context called automatically
login	authenticated form current handles verifies cbv user mixin action login displays
expression	filters extra parses single another wrap query expressions provide tuples combined inner output_field arguments return string base variable optional class name list filter token context expression
combinable	ability two one connector objects combine provides
extent	aggregate used return extent value
deserialization	deserialization bad something happened
wsgiserver	basehttpserver implements wsgi protocol python
pop	pop() push() called times
loader	files status database migration loads disk
cs	operations return sequence routines coordinate integer
table	used renames clause base references table model's basetable class
iterable	lookups returned instance require queryset values_list(flat=false) value get_db_prep_value() field yields values_list(flat=true) dict model values() called iterable row
backend	smtp module manages backend use network wrapper authenticates test auth_user_model email used sessions base implementations conjunction class settings middleware package server connection found remoteusermiddleware
xframe	http responses middleware header sets x-frame-options
java	javascript return language selected library catalog
source	source wraps object data ogr
create	rendered consistent table sessionbase create instance template new model's save type used creating object docstring base catch response exception internally (see view
py	implementation using cache binding pylibmc
add	index add adds model field
exhausted	device reads allowed
literal	object self-resolvable django template basic variable similar
flexible	base_data_types_reverse geometry includes field dict updates sublcass types
empty	predicate database checking queryset usable none(): impossible marker query class empty
moved	lazy loading moved objects
external	forbidden resolving external reference
func	function call sql
case	case overlay searched django extends sql test liveservertestcase expression transparently
multi	composed code point multipart/alternative parser subclass (if handle indicate send field version treat easy widgets emailmessage multipart/form-data wants multi-valued widget used multiple dictionary attempted aggregates construction key join fields caller messages customized values rfc2388 logic makes
defining	media classes metaclass definitions
single	retrieve ability object single provides manipulation
value	node represents lookups multiple dictionary called fields aggregates within customized value get_db_prep_value() field values subclass key logic wrapped handle expression require
cursor	right iterator instances reraise row style "qmark" '%s') factory wrapper custom invokes placeholders (e around normal ":var" uses particular catch class types exception pysqlite2 g mysqldb's django cursor thin oracle "format"
gmlfield	lob conversion used database gml wrapper ensure oracle
error	stores syntax executing manager session improperly loading irreversible detected save indicating happened resolved form/formsets matches kind framework using one decorator internally name prefix bad common view node set consistent migration re-throws index errors sessionbase there's various occurs available lazy deleted error base serialization stage thrown 'silent_variable_feature' (see django's dependency objects context graph can't raised unrecoverable deserialization impossible-to-resolve parsing rendering management system validating model's type knows reversed catch true backend-specific exception made classes formats exceptions problem display attribute moved encountered something (unreadable/bad moves check urllib_error generic six invalid field circular wrappers used add/change docstring update collection tries data class transaction attempt database format/etc django command model
property	cached self argument instance single converts property method decorator
rename	deprecation renames db_column paths field handles affect model might method renaming
resolved	contains object outer reference query
layer	ogrinspect layer layer_key option layers needs maps custom instantiated models string may object wraps ogr integer geodjango class argparse keyword datasource action
helper	helper simplenode tag inclusionnode base nodes class
gdalraster	raster wraps object source data gdal
is	e <fk>_id attname field key foreign
expat	xml parser bomb attacks expat hardened
site	associated attribute site (i ready use application hooked adminsite shares current instance encapsulates object primary objects interface class e admin middleware request django limit sets urlconf
parse	lazy loading six moved objects urllib_parse moves
bboverlaps	box overlaps true bounding returns b's operator 'bboverlaps' a's
in	uploaded stream-to-memory e file memory
ready	populated apps registry yet django
id	box widget ids rather "raw_id" manytomany cursor late-binding multiple> <select variable execute passed interface <select> displaying foreignkeys
binary	binary geos predicate functions
moves	lazy loading urllib_error urllib_request namespace create six moved urllib_robotparser urllib python 3 objects urllib_response resembles urllib_parse moves
generic	formset related manager relation information generic object_id accessor genericforeignkey genericrelation store used parent one-to-many objects content_type many-to-one reverse created fields provide inline problem view
media	media classes metaclass definitions
same	tests actual "same as" operator "~=" geometric
check	errors unrecoverable system framework detected check
authentication	formerly don't app session invalidating form sessions custom current authentication used hash users extend get user's base class admin middleware accepts correspond authenticating
split	inputs widget splits styling datetime boxes type="text"> two input splitdatetime admin-specific <input type="hidden">
deletion	objects providing ability mixin delete
docs	admindocs views base view
lite	adaptor geometry sqlite objects
filtered	filter interface selectmultiple javascript
week	week-based week given saturday=7 return monday views first list 53 iso-8601 objects mixin published manipulating sunday=1 1-52 data e based
used	middleware used configuration server
temporary	uploaded e stream-to-disk upload handler streams location file temporary data
keys	require/restrict keys validator designed hstore
driver	driver source wraps gdal/ogr data
bbcontains	box true contains completely bounding returns 'bbcontains' operator a's b's
sys	code 'spatial_ref_sys' cs_srs objects database-dependent reduce spatialite postgis maps see mdsys used redundant spatialrefsys oracle table class spatialrefsysmixin
declarative	declared fields classes base collects metaclass
user	username abstract within web-server-provided module represented featured cbv django backend current given conjunction holder privileges system class access authentication test utilizing permissions configured define function used return users form provided user's different implementing admin-compliant base user mixin found web-server validate password true pages must package whether fully middleware settings allows server creates sufficiently attributes model remoteusermiddleware logon view
aggregate	provided elements aggregatequery clause list another selects query parameter takes
transaction	thrown exception management used transaction improperly
database	operations statements methods creation manager used id re-throws backend takes ordering responsible - two introspection field state schema-changing change way test emitting encapsulates opening wrappers shell performs creation/removal/alteration differences utilities lists ones using class decorator destruction backend-specific database pertain django's recently-inserted connection client represents common context databases exceptions model validation subclasses calculates
client	backend-specific shell methods opening client encapsulates class
command	prevent allows copy labels unacceptable argumentparser one executing static something specified different ultimately management layout takes copies application arguments template several indicating files systemexit arbitrary commands symlink locations base line installed class improve exception settings occasions messages customized django project derive command either error directory problem
greatest	returns expression chooses maximum
gzip	compresses compression middleware allows content gzip browser
model	lazily via managers show request queryset instances alters way subclass directly specified query django (like iterable row adding given and/or table multiplechoicefield to_field don't administration invalid formset instance state authenticates functionality allows passed auth_user_model encapsulates modelform create modeladmin inlineadmin ordering) map handle string whose models sets use provides schema objects mixin new affect editing choicefield class permissions storing represents drops actual sender renames settings admin metaclass signal database querystring model's choices filter url yields common app_label inline model geographic verbose_name options view
left	box overlaps 'left' true strictly bounding returns b's operator a's overlaps_left left
unary	unary geos predicate functions
atomic	given guarantees atomic execution class block
argon2password	secure algorithm argon2 using password hashing
migration	operations status raised set (the storing digraph list able produce equal see migration questions specified need (unreadable/bad disk targets contents responses project takes would instance provide make optimization - migrations shorter process there's compares length might match gives files file returned autodetector projectstates records base pair execution class applied represents runs database format/etc second deals bad dependencies end-to-end loads powers first
questioner	autodetector might responses questions gives
generator	reset password used object mechanism generate tokens strategy check
param	string parameters object wrapper formatting oracle
simple	function lazy name simple appconfig object content file initialized representation discovery automatic size
spatialite	table spatialite 'geometry_columns' 'spatial_ref_sys'
input	widget fields device list reads <input> handles base values allowed widgets class <input type="hidden">
finder	locate attribute app extended static looks file specified source_dir backend storage custom setting finder files used staticfiles staticfiles_dirs base uses class default classes directory
bin	binary routines return generates geos wkb hex sized construction prototype string
format	style g '%s') format raised recognized django ":var" uses passed error oracle file placeholders "format" archive (e
big	excluding settings request uploads file exceeded size
test	function access return overlay view allows django current cbv user mixin liveservertestcase test extends must true transparently define
integer	integerfield work without values allow query floats
password	set old secure abstract supported module alphanumeric unix considered entering need check hashers crypt recommended mechanism strategy lets override bcrypt used creating form class object tokens base user interface using validate password generate change hashing reset algorithm platforms admin many whether without common hasher
insert	late-binding cursor execute variable passed
success	adds success form successful submission message
signal	sender signal app_label allows subclass signals base lazily specified class string
server	overlay django extends test liveservertestcase transparently
output	return around geometry stdout/stderr geos routines wrapper sized prototype string generates
inter	boundaries iterate producer
directories	files attribute app static looks specified directory source_dir finder
right	box overlaps right true strictly bounding returns b's 'right' operator a's 'overlaps_right'
methods	deprecation handles renaming method paths
creation	username backend-specific given creation form database privileges differences creates user test pertain encapsulates password class destruction
library	template registering tags compiled filter filters class
streaming	http iterator class content streaming response
escape	implements autoescape html-escaped string object actions tag unicode output byte
duration	objects stores timedelta
optimizer	operations returned process - list equal shorter provide length optimization powers
manifest	files saves storage system hashed also static copies file backend
subquery	outer may explicit outerref() subquery references contain
cast	coerce type expression field new
does	requested exception used object accepts field exist template following found model serializer view
robotparser	lazy loading six moved urllib_robotparser objects moves
provider	regex language provide vary default mixin active property
recorder	deals storing database migration records
run	operations provided runs code reverse context may python versioned raw orm statement sql suitable
host	header contains http_host value invalid
offset	utc fixed docs python's offset taken east minutes
post	'spatial_ref_sys' multipart/* via request postgis raw_post_data access see cannot 'geometry_columns' accessed table post data view
column	e <fk>_id attname field key foreign
dependency	impossible-to-resolve raised there's dependency circular
constructor	binary routines generates geos wkb hex construction prototype
managers	model's managers alters
unsalted	use sha1 stores unsalted algorithm insecure accepts also prefix without *never* hashes incredibly salt empty md5
image	files core use file provides alongside django base mixin filedescriptor difference imagefields like
float	sqlite gis allow integerfield default decimal work functions numeric without converted values str query expecting floats acceptable backend
bound	used container iterating field plus widgets useful data class
nothing	node matches nothing
promise	closure function lazy created base proxy class
operator	lookups used gis specific behavior encapsulating operation class
bool	backwards object boolean-like callable also compatibility
utility	py django-admin manage utilities logic encapsulates
area	values wrapper area
strictly	box true strictly bounding returns b's 'strictly_below' operator 'strictly_above' a's
apps	removals handle dynamic additions global apps subclass installed better applications registry stores model configuration class
transform	get_lookup() key output_field check text self object lhs system registerlookupmixin() examine get_transform() expecting mixin combining coordinate lookup jsonfield transformation first
editor	creation/removal/alteration statements responsible - field schema-changing databases emitting model subclasses class
var	late-binding cursor execute variable passed
disallowed	redirect via string admin querystring to_field contains list value filter header http_host invalid passed allowed url query scheme view
files	files wsgi calls defined middleware saves storage system static_url standard also setting static copies file intercepts directory hashed serves backend
rwlock	classic implementation lock reader-writer writers preference
conditional	operations get conditional handles etag response
form	set old objects show request app child queryset related system rendering way multipart entering associated custom displaying around parent adding given editing extend generic privileges and/or authentication wrapper formset lets suspect provides plus modelform username used handle users form get track displayed use template base mime user mixin new interface post password data class change processes instances admin fields accepts managementform keep creates without renders many collection inline response authenticating page view
encoder	instances json message compactly class serializes
numeric	whether alphanumeric validate password
decoder	serialized includes instances json decodes message
remote	provided used package middleware remoteusermiddleware web-server-provided module server authentication web-server found utilizing conjunction logon pages backend
irreversible	raised reversed irreversible migration
reset	reset password used object mechanism generate tokens strategy check
default	files accessing databasewrapper default storage cache uses access static proxy attributes object's finder backend
middleware	operations cache decides behavior formerly don't simple attribute parses conditional web-server-provided sites header many session etag request temporary invalidating "common" page provided cacheable adds compression request-phase provides handles - system access response current authentication internal allows get basic utilizing content correct csrfmiddlewaretoken web-server head used hash responses sessions compresses user's object http site x-frame-options cookie updates csrf user-agents x-view outgoing translation configuration pages forbids care settings -- requires middleware documentation messages correspond server response-phase fetches present install sets gzip post requests logon taking browser
below	box overlaps a's strictly 'overlaps_below' bounding returns b's 'strictly_below' operator true
delete	since get_object(), retrieved self object constrained general base done drops queries table model's delete deleting class view
ordered	ordering items set inserted keeps
int	return sequence geometry routines argument coordinate integer type
abstract	fully abstract admin-compliant implementing featured base user model class permissions
parser	xml prevent parser bomb systemexit attacks occasions expat messages customized argumentparser unacceptable rfc2388 multipart/form-data error hardened several class improve
geoscontext	handle python geos object context representing
as	tests actual "same as" operator "~=" geometric
ogrenvelope	represents c ogrenvelope structure
exist	requested exception used object accepts field exist template following found model serializer view
file	imagefields subclasses) raised methods stream simple (temporaryuploadedfile abstract suspicious built-in translatable raw static file http operation files size instance given error setting takes descriptor rather alongside storage state response content process stream-to-memory handler location provides memory forward returns stream-to-disk finder build uploaded core used temporary inmemoryuploadedfile attempted staticfiles_dirs object use standard optimized base skip mixin filedescriptor actual difference data class underlaying attribute represents exception e name streaming uses handlers uploading upload like django wants concrete streams uploads filesystem small representation model locate file-like
timezone	node used get_current_timezone_tag template timezone_tag class
gisspatial	'spatial_ref_sys' see postgis table
archive	raised implementations month api inherit file year top-level archive given errors implementation day archives passed encapsulates today week format published objects external class exception items list recognized base error date-based
crypt	crypt supported recommended module platforms unix using password hashing
storage	behaviors storing stores saves system extended static file contrib message backend subsequent storage copies also systems override finder files used temporary sessions hashed standard tries base uses class unstored necessary default messages inherit django session store filesystem cookie providing first
detail	render url object detail "detail" standard differs single base date accepting displaying year/month/day detailview view
invalid	classes resolved use passed characters safe raised invalid raw session can't key query model's base isn't
introspection	introspection backend-specific encapsulates class utilities
field	stores pointed relation using opengis query alternative onetoonefield field's whose wraps maps choicefield to_field add dict input might return string none updates new integer base_data_types_reverse renames -- fields attname deals timedelta always sublcass clean() view methods column adds dictionary multiplechoicefield specification relational (e method widget parent base extent interface alters floats raster essentially reverse g constraint geometry accepts foreign carries objects plus logic via key exception textual given gis area two wrapper sides validating json passed basic "unique" type get_db_prep_value() field form instantiated removes ogr true distance kind db_column foreignkey require work value choices admin values evaluates problem called false gdalraster <fk>_id queryset exist lightweight null needs provide holds feature invalid many-to-many instance valid intermediary requested used multiple integerfield provided max_length) aggregates object includes aggregate geodjango data class types icon lookups e hstore calls database url inherit without allow inline model affect
setting	load templates * appearing settings configured object (#21345) callable debug get_template() call template wrap using loader page
lookup	via mixin text 'overlaps_above' geometry as" right combining operator 'strictly_above' overlaps_left "same 'left' strictly contains contained invalid field returns b's dict expecting passed lookup geometric a's 'overlaps_right' overlaps box tests 'contained' includes 'overlaps_below' completely updates key "~=" bounding true types base_data_types_reverse actual left admin querystring filter url 'bbcontains' lhs 'right' 'strictly_below' 'bboverlaps' jsonfield sublcass view
spatial	code features objects reduce site module mdsys encapsulating table operation backend web cs_srs gis field holds wrapper maps spatialite spatial spatialrefsysmixin 'spatial_ref_sys' used instantiated basespatialbackend object base ogrspatialreference class gdal lookups database according redundant specific database-dependent behavior oracle spatialrefsys
ogrindex	index exception set attribute 'silent_variable_feature' raised invalid encountered true
node	represent raised helper direct actions single tag migration get_current_timezone_tag viewed links graph contains available matches internal template timezone_tag nodes node autoescape used adjacent simplenode inclusionnode localtime_tag base sql nothing where-clause class implements made attempt tree
separate	operations used takes database - two lists state ones change
geoscoord	geometry inside list coordinates internal representation
update	rendered existing session query cacheable cache template occurs deleted object update tries base updates sql response updating represents "update" middleware django response-phase view
prepared	geometry certain performing operations prepared
registry	populated apps registry yet django
sql	provided runs reverse may raw statement sql
variable	given used template may prevents adapter object instantiate oracleparam wrapped cursor resolvable converted context variable variables class string
concat	entire used helper text two together backends arguments fields class concatenates result
sha1password	use sha1 stores algorithm insecure recommended *never* hashes password salt empty hashing
required	authenticated current verifies cbv user mixin specified permissions
persistent	provided middleware authentication web-server logon pages
together	unique_together target value index_together one changes
validator	exceed number alphanumeric minimum require/restrict different raise expected input validationerror keys user's designed validate password digits hstore whether maximum sufficiently length validator common attributes otherwise
time	node inputs widget used splits styling boxes datetime localtime_tag type="text"> two template input splitdatetime admin-specific class <input type="hidden">
oracle	formatting cs_srs string parameters object cx_oracle attribute user_sdo_geom_metadata wrapper datetime maps mdsys tell microseconds oracle table save class additional
validation	backend-specific validating error encapsulates validation data class
serializer	raised simple abstract queryset signing //geojson geojson registration xml serializers org/ cache wrapper stub yaml json basic requested used http around python exception objects hold class convert allows dumps base found pickle serializer serializes
