testcoercion	test Coercion
minbound	min Bound
isillegaloperation	is Illegal Operation
handleposn	Handle Posn
swap	swap
separator	separator
General Category	General Category
delete	delete
float	float
calloc Bytes	calloc Bytes
atomicmodifyioref	atomic Modify IORef
the	the
Kleisli	Kleisli
digit	digit
Static Ptr Info	Static Ptr Info
mkweakioref	mk Weak IORef
[maxbytesused]	[max Bytes Used]
foldl M	foldl M
generic1	generic1
min Prec	min Prec
rem	rem
byte Swap32	byte Swap32
[heapprofileintervalticks]	[heap Profile Interval Ticks]
product	Product
takemvar	take MVar
timeoutcallback	timeoutcallback
printf	printf
newpool	new Pool
enumfromto	enum From To
buffer0	buffer0
fix	fix
punc	punc
shiftl	shift L
text	text
sync	sync
decode Float	decode Float
[getstate]	[get State]
count Trailing Zeros	count Trailing Zeros
formatsign	Format Sign
Array Exception	Array Exception
end	end
to1	to1
format	format
indices	indices
endby1	end By1
threadwaitreadstm	thread Wait Read STM
showintatbase	show Int At Base
nativenewlinemode	native Newline Mode
encode Float	encode Float
failure	Failure
fieldformat	fieldformat
datatype	Data Type
$list$	$list$
b'	b'
cuseconds	CUSeconds
evt	evt
is EOF	is EOF
fd	Fd
Rec Con Error	Rec Con Error
get GCStats Enabled	get GCStats Enabled
word Ptr To Ptr	word Ptr To Ptr
Some Async Exception	Some Async Exception
(dot)	(DOT)
handle	Handle
closefd	close Fd
surrogate	surrogate
List	List
from String	from String
formatinteger	format Integer
from Integral	from Integral
scanr1	scanr1
infix	infix
newline	Newline
Blocked Indefinitely On STM	Blocked Indefinitely On STM
No Arg	No Arg
int#	Int#
a2	a2
complement Bit	complement Bit
printf	Printf
int	int
D#	D#
dec	dec
second	second
openbinaryfile	open Binary File
maximum	maximum
format Char	format Char
swap32	swap32
double	Double
nontermination	nontermination
parse	parse
m4	m4
No Method Error	No Method Error
issigned	is Signed
peek Array0	peek Array0
ioerrortype	IOError Type
Array	Array
intersectby	intersect By
Directory	Directory
toexception	to Exception
state	state
maskingstate	maskingstate
arrowplus	arrowplus
malloc Array	malloc Array
todyn	to Dyn
dupable	dupable
hs Lex	hs Lex
cchar	cchar
fromdynamic	from Dynamic
Read S	Read S
realfloat	Real Float
Typeable	Typeable
mk Weak Ptr	mk Weak Ptr
applicative	Applicative
Is List	Is List
pooled Malloc	pooled Malloc
h Show	h Show
with	with
hs	hs
left	left
typerep	type Rep
ordering	ordering
functor	functor
IORef	IORef
nubby	nub By
Masked Uninterruptible	Masked Uninterruptible
with MVar	with MVar
Function	Function
proxy#	proxy#
pi	pi
estate	estate
Unmasked	Unmasked
zeros	zeros
cwstring	cwstring
Time	Time
gcflags	gcflags
storable	Storable
alreadyexistserrortype	already Exists Error Type
oct	oct
ticks	ticks
hole	hole
getcontents	get Contents
space	Space
[fpchar]	[fp Char]
isalgtype	is Alg Type
readfloat	read Float
fieldformat	Field Format
indefinitely	indefinitely
allocationlimitexceeded	Allocation Limit Exceeded
rep1	rep1
recconerror	recconerror
minimum By	minimum By
pooledmallocarray0	pooled Malloc Array0
Errno	Errno
word64	word64
fdtohandle'	fd To Handle'
takewhile	take While
stats	Stats
show GFloat	show GFloat
[heap Profile Interval Ticks]	[heap Profile Interval Ticks]
datarep	datarep
zip With M	zip With M
textencoding	Text Encoding
con3	con3
fraction	fraction
cshort	cshort
CString Len	CString Len
bitsizemaybe	bit Size Maybe
L1	L1
mkioerror	mk IOError
i	i
recselerror	recselerror
!int64	!int64
Monad Plus	Monad Plus
hiseof	h Is EOF
intptr	intptr
str	str
Get Opt	Get Opt
floatradix	float Radix
flags	Flags
word8	Word8
fractional	Fractional
$f_7$	$f_7$
squeeze	squeeze
fieldformatter	fieldformatter
flushwritebuffer0	flush Write Buffer0
newtvario	new TVar IO
t	t
Non Termination	Non Termination
is User Error	is User Error
M1	M1
kproxy	KProxy
char	Char
throwifneg_	throw If Neg_
trace IO	trace IO
constrtype	constr Type
cint	cint
Flags	Flags
Has Resolution	Has Resolution
match	match
isstring	Is String
compact	compact
put Char	put Char
other	other
Prof Flags	Prof Flags
d#	D#
openpunctuation	Open Punctuation
gcast	gcast
[maxbytesslop]	[max Bytes Slop]
qsem	qsem
Buffered IO	Buffered IO
i Shift L#	i Shift L#
char Is Representable	char Is Representable
Blocked On Exception	Blocked On Exception
[parmaxbytescopied]	[par Max Bytes Copied]
isnegativezero	is Negative Zero
buffer	Buffer
ioerror	io Error
numeric	Numeric
exist	exist
is Infix Of	is Infix Of
No Buffering	No Buffering
malloc	malloc
lcm	lcm
read List	read List
count Leading Zeros	count Leading Zeros
threadstatus	threadstatus
generic Take	generic Take
Coerce	Coerce
[user]	[user]
Field Format	Field Format
put Trace Msg	put Trace Msg
s_to_p	s_to_p
base	base
if	if
acc	acc
Num	Num
proper Fraction	proper Fraction
realloc Array0	realloc Array0
Associativity	Associativity
CULong	CULong
locale	locale
generictake	generic Take
runsparks	run Sparks
ST	ST
freehaskellfunptr	free Haskell Fun Ptr
else	else
lexeme	Lexeme
try Put MVar	try Put MVar
short	short
indexconstr	index Constr
heapoverflow	Heap Overflow
is Suffix Of	is Suffix Of
show	show
blockedonforeigncall	Blocked On Foreign Call
negative	negative
traceshowid	trace Show Id
[sparks Full]	[sparks Full]
deadlock	Deadlock
upd	upd
eventmanager	Event Manager
File Path	File Path
mathsymbol	Math Symbol
newioref	new IORef
errormissingargument	error Missing Argument
find Indices	find Indices
h Get Posn	h Get Posn
UTF32	UTF32
traversable	traversable
universalnewlinemode	universal Newline Mode
bounded	Bounded
double	double
new CString	new CString
foldr	foldr
enabled	enabled
alignptr	align Ptr
[sparks Sampled]	[sparks Sampled]
withargs	with Args
sum	Sum
or	or
Buffer Codec	Buffer Codec
thread Wait Read	thread Wait Read
stm	STM
hslex	hs Lex
forkos	fork OS
castcuchartochar	cast CUChar To Char
unique	Unique
HPrintf Type	HPrintf Type
Stable Ptr	Stable Ptr
Prelude	Prelude
(<<^)	(<<^)
[close]	[close]
get System Event Manager	get System Event Manager
testcoercion	testcoercion
pow	pow
exit Failure	exit Failure
withpool	with Pool
[fmt Adjust]	[fmt Adjust]
failed	failed
concurrent	concurrent
mkduplexhandle	mk Duplex Handle
[input NL]	[input NL]
is Punctuation	is Punctuation
mkweakthreadid	mk Weak Thread Id
word	Word
is Permission Error Type	is Permission Error Type
tryioerror	try IOError
runinunboundthread	run In Unbound Thread
fail	fail
transpose	transpose
modifiers	modifiers
prelude	prelude
buffermode	Buffer Mode
ziplist	ziplist
eq	eq
map	map
totitle	to Title
(>>>)	(>>>)
)	)
prefix	prefix
Fractional	Fractional
ischar	ischar
Event	Event
cwstringlen	CWString Len
Seek Mode	Seek Mode
modify IORef	modify IORef
generics	Generics
new QSem N	new QSem N
GHC	GHC
modify IOError	modify IOError
wordptrtoptr	word Ptr To Ptr
perform	perform
general Category	general Category
bifunctor	Bifunctor
hprintf	h Printf
ctime	CTime
stream	Stream
Stream	Stream
rotate L	rotate L
textdecoder	textdecoder
zerobits	zero Bits
csig	csig
unsafeforeignptrtoptr	unsafe Foreign Ptr To Ptr
open Binary Temp File	open Binary Temp File
gcstats	gcstats
iseof	is EOF
some Nat Val	some Nat Val
show Int At Base	show Int At Base
localeencoding	locale Encoding
right	right
throwerrnoifminus1	throw Errno If Minus1
debug	Debug
copy	copy
threadid	Thread Id
pooled New Array	pooled New Array
writeioref	write IORef
show List With	show List With
peek CAString Len	peek CAString Len
Opt Descr	Opt Descr
[fmtchar]	[fmt Char]
stref	STRef
binary	binary
Stats	Stats
with File	with File
shows Prec	shows Prec
oldlist	oldlist
performmajorgc	perform Major GC
is Already In Use Error	is Already In Use Error
Close Punctuation	Close Punctuation
default	default
zipwith6	zip With6
overflow	overflow
coerce	Coerce
set Size	set Size
insert By	insert By
asyncexception	Async Exception
codingprogress	codingprogress
traceevent	trace Event
fd	fd
(<$>)	(<$>)
math	math
read Signed	read Signed
Blocked On STM	Blocked On STM
Read	Read
con	con
Paragraph Separator	Paragraph Separator
readmvar	read MVar
seek	seek
bounded	bounded
mk Weak Thread Id	mk Weak Thread Id
unzip	unzip
arch	arch
base	Base
newlinemode	newlinemode
cast Ptr	cast Ptr
fixst	fix ST
move Array	move Array
open	open
enum	enum
threadid	threadid
for M_	for M_
mkinttype	mk Int Type
init	init
strict To Lazy ST	strict To Lazy ST
peek CWString Len	peek CWString Len
rnf	rnf
[version Tags]	[version Tags]
join	join
a3	a3
[sp Info Module Name]	[sp Info Module Name]
try	try
pure	pure
utf16	UTF16
withcwstringlen	with CWString Len
|	|
by1	by1
funptr	Fun Ptr
shiftrl#	shift RL#
Buffer	Buffer
max Constr Index	max Constr Index
hashstablename	hash Stable Name
missing	missing
isstring	isstring
zip With6	zip With6
(>>^)	(>>^)
choice	choice
bufferstate	Buffer State
[wallseconds]	[wall Seconds]
!int64	!Int64
addr#	Addr#
iodevice	IODevice
endo	endo
min Bound	min Bound
(&&)	(&&)
to Exception	to Exception
fingerprint	Fingerprint
User Interrupt	User Interrupt
powmodnatural	pow Mod Natural
Other Symbol	Other Symbol
throw	throw
Input Underflow	Input Underflow
Sum	Sum
to Integer	to Integer
bits/num	bits/num
Arrow Choice	Arrow Choice
Int32	Int32
list	List
minimum	minimum
[sweep]	[sweep]
fromstring	from String
finite Bit Size	finite Bit Size
read Float	read Float
directory	Directory
issymbol	is Symbol
zip	zip
nl	nl
castchartocschar	cast Char To CSChar
Either	Either
read P_to_S	read P_to_S
either	Either
Absolute Seek	Absolute Seek
break	break
CDouble	CDouble
no Newline Translation	no Newline Translation
updatetimeout	update Timeout
used	used
splittyconapp	split Ty Con App
(&)	(&)
option	Option
handle'	handle'
time	Time
get	get
Debug	Debug
Floating	Floating
pop	pop
mktextencoding	mk Text Encoding
word8	word8
allocated	allocated
floating	floating
finalizer Free	finalizer Free
arrowmonad	arrowmonad
hlookahead	h Look Ahead
optdescr	optdescr
modifiersymbol	Modifier Symbol
argdescr	argdescr
void	void
mkweakmvar	mk Weak MVar
staticptrinfo	static Ptr Info
dstate	dstate
Control	Control
mkpolar	mk Polar
punctuation	punctuation
new CWString Len	new CWString Len
munch1	munch1
maybe	Maybe
show Fixed	show Fixed
cast Foreign Ptr	cast Foreign Ptr
h Seek	h Seek
newtvar	new TVar
endo	Endo
(|||)	(|||)
int16	int16
tointeger	to Integer
with Foreign Ptr	with Foreign Ptr
index Constr	index Constr
readchan	read Chan
Void	Void
witharray	with Array
fmap Default	fmap Default
tracemarker	trace Marker
throw Errno Path	throw Errno Path
[versionbranch]	[version Branch]
l#	l#
wait	wait
clear	clear
ptr To Word Ptr	ptr To Word Ptr
perror	perror
title	title
finalizer	finalizer
$tuple_2$	$tuple_2$
uncons	uncons
Kind Rep	Kind Rep
signed	signed
sequencea_	sequence A_
!Double	!Double
finalizerptr	finalizerptr
exitfailure	exit Failure
associativity	associativity
foldable	foldable
fdkey	Fd Key
h Ready	h Ready
inline	inline
spaces	spaces
fold	fold
h Set Echo	h Set Echo
unsafeinterleavest	unsafe Interleave ST
Sync	Sync
chan	chan
Bool	Bool
Printf Type	Printf Type
isvaliderrno	is Valid Errno
static Ptr Keys	static Ptr Keys
bracketonerror	bracket On Error
try IOError	try IOError
unsafe Lookup Static Ptr	unsafe Lookup Static Ptr
isnan	is Na N
cast CSChar To Char	cast CSChar To Char
alwayssucceeds	always Succeeds
lifetime	Lifetime
Proxy	Proxy
is Terminal	is Terminal
Modifier Letter	Modifier Letter
Comp1	Comp1
ziplist	Zip List
cast Char To CUChar	cast Char To CUChar
Applicative	Applicative
list	list
reads	Read S
void	Void
open File Blocking	open File Blocking
read Maybe	read Maybe
with CWString Len	with CWString Len
[textencodingname]	[text Encoding Name]
h Duplicate	h Duplicate
Exception	Exception
fork Finally	fork Finally
mkweakpair	mk Weak Pair
unsafe Dupable Perform IO	unsafe Dupable Perform IO
time	time
show FFloat Alt	show FFloat Alt
latin1	latin1
rep#	rep#
unmasked	Unmasked
type Rep Fingerprint	type Rep Fingerprint
is Na N	is Na N
dup	dup
throwerrnopathif	throw Errno Path If
alloc	alloc
foreignptr	Foreign Ptr
c#	c#
alloca Array	alloca Array
kleisli	kleisli
Dynamic	Dynamic
Code Buffer	Code Buffer
word#	word#
ptr	Ptr
naturaltowordmaybe	natural To Word Maybe
marshal	marshal
from Dyn	from Dyn
l1	l1
[fprest]	[fp Rest]
translation	translation
generic	generic
[cpuseconds]	[cpu Seconds]
modify MVar	modify MVar
testcoercion	Test Coercion
Blocked Indefinitely On MVar	Blocked Indefinitely On MVar
!int	!Int
cllong	CLLong
word#	Word#
ioerrortype	ioerrortype
new TVar IO	new TVar IO
Type	Type
rawio	Raw IO
zip4	zip4
inttodigit	int To Digit
iocallback	iocallback
shiftr	shift R
mkfunty	mk Fun Ty
Is Char	Is Char
throw Errno If Minus1_	throw Errno If Minus1_
blockedonexception	Blocked On Exception
lexeme	lexeme
hsetposn	h Set Posn
to Upper	to Upper
nativenewline	native Newline
invalid	invalid
Proxy#	Proxy#
unsafe Perform IO	unsafe Perform IO
par1	par1
usage	usage
[fmt Width]	[fmt Width]
threaddelay	thread Delay
unique	unique
read Constr	read Constr
string	string
real	Real
kill Thread	kill Thread
decoder	decoder
show String	show String
pooled Malloc Array0	pooled Malloc Array0
throwerrnoifminus1_	throw Errno If Minus1_
Double#	Double#
castcchartochar	cast CChar To Char
codingfailuremode	Coding Failure Mode
write IORef	write IORef
skipmany	skip Many
Option	Option
threadid#	threadid#
my Thread Id	my Thread Id
isprefixof	is Prefix Of
Natural	Natural
minus1retry_	minus1retry_
types	Types
gather	gather
zip7	zip7
peekcastringlen	peek CAString Len
mask_	mask_
tryjust	try Just
ensureiomanagerisrunning	ensure IOManager Is Running
(dot)	(dot)
CLLong	CLLong
allocationlimitexceeded	allocationlimitexceeded
($)	($)
typelits	Type Lits
Alg Rep	Alg Rep
is Surrogate	is Surrogate
annotateioerror	annotate IOError
show Oct	show Oct
usererror	user Error
onexception	on Exception
g	g
put Str Ln	put Str Ln
showffloatalt	show FFloat Alt
unionby	union By
read S_to_P	read S_to_P
universal Newline Mode	universal Newline Mode
module	module
allocaarray	alloca Array
readp	Read P
showfixed	show Fixed
setbit	set Bit
associative	associative
add MVar Finalizer	add MVar Finalizer
bifunctor	bifunctor
showhex	show Hex
[get State]	[get State]
is Signed	is Signed
peek	peek
formatparse	formatparse
disableallocationlimit	disable Allocation Limit
sequence_	sequence_
malloc Foreign Ptr Array0	malloc Foreign Ptr Array0
pooled Malloc Bytes	pooled Malloc Bytes
MVar	MVar
Thread Finished	Thread Finished
supports	supports
utf32le	utf32le
throwerrnopathif_	throw Errno Path If_
Invalid Sequence	Invalid Sequence
reads_to_p	read S_to_P
errno	Errno
mallocforeignptrarray	malloc Foreign Ptr Array
maybe To List	maybe To List
dupchan	dup Chan
c	c
argument	argument
newlinemode	Newline Mode
chan	Chan
u1	U1
showlistwith	show List With
guard	guard
digits	digits
hsetecho	h Set Echo
cdouble	CDouble
rtssupportsboundthreads	rts Supports Bound Threads
withmany	with Many
isalreadyinuseerror	is Already In Use Error
fun	fun
get Environment	get Environment
fractional	fractional
putchar	put Char
is Digit	is Digit
Ident	Ident
setenv	set Env
Fixed	Fixed
dynamic	Dynamic
registertimeout	register Timeout
Con Index	Con Index
nestedatomically	Nested Atomically
show Char	show Char
linker	linker
h Get Encoding	h Get Encoding
applicative	applicative
run Sparks	run Sparks
bool	Bool
cast CChar To Char	cast CChar To Char
foldr'	foldr'
event	Event
lines	lines
error	Error
deleteby	delete By
union By	union By
prefix	Prefix
bit Default	bit Default
fun Result Ty	fun Result Ty
enum	Enum
Real World	Real World
blockedonstm	Blocked On STM
strict	strict
chr	chr
somesymbol	somesymbol
plusptr	plus Ptr
cast Stable Ptr To Ptr	cast Stable Ptr To Ptr
[spinfomodulename]	[sp Info Module Name]
hsetbinarymode	h Set Binary Mode
gc	gc
get Opt'	get Opt'
rnftycon	rnf Ty Con
byte	byte
read Oct	read Oct
undefined	undefined
handlejust	handle Just
st	st
castchartocchar	cast Char To CChar
all	All
textdecoder	Text Decoder
ln	ln
mallocforeignptrbytes	malloc Foreign Ptr Bytes
setsize	set Size
Text Encoding	Text Encoding
array	Array
lift M4	lift M4
data	data
ghc	ghc
cast	cast
foreign	foreign
bracket_	bracket_
while	while
staticptr	staticptr
hgetbuf	h Get Buf
static	static
argorder	argorder
nontermination	Non Termination
advance	advance
slidecontents	slide Contents
xor	xor
modifymvar	modify MVar
orelse	or Else
dup2	dup2
split Poly Ty Con App	split Poly Ty Con App
datarep	Data Rep
fillreadbuffer	fill Read Buffer
fromrational	from Rational
typerepargs	type Rep Args
zip With4	zip With4
item	Item
universal	universal
getfilesystemencoding	get File System Encoding
minus	minus
run	run
makestablename	make Stable Name
castfunptr	cast Fun Ptr
free Stable Ptr	free Stable Ptr
throwio	throw IO
freestableptr	free Stable Ptr
interleave	interleave
Static Key	Static Key
mk	mk
Nested Atomically	Nested Atomically
is Control	is Control
permission	permission
is IEEE	is IEEE
monad	Monad
hduplicateto	h Duplicate To
a4	a4
scanl1	scanl1
Traversable	Traversable
type Lit Type Rep	type Lit Type Rep
is	is
signplus	Sign Plus
Type Rep	Type Rep
bound	bound
handle Just	handle Just
pokearray	poke Array
sampled	sampled
tycon	tycon
if_	if_
show FFloat	show FFloat
hwaitforinput	h Wait For Input
Trace	Trace
Lex	Lex
permutations	permutations
Constr Rep	Constr Rep
noarg	No Arg
handler	handler
isfullerrortype	is Full Error Type
stripprefix	strip Prefix
oneshot	One Shot
show Hex	show Hex
formatparse	Format Parse
ispermissionerrortype	is Permission Error Type
mallocforeignptr	malloc Foreign Ptr
gcflags	GCFlags
minor	minor
mkfilehandle	mk File Handle
bitdefault	bit Default
cast Ptr To Fun Ptr	cast Ptr To Fun Ptr
unsafe Shift R	unsafe Shift R
modifystref	modify STRef
add	add
encoding	encoding
loc	loc
Enclosing Mark	Enclosing Mark
take MVar	take MVar
mkcharconstr	mk Char Constr
getprogname	get Prog Name
is Number	is Number
islist	islist
Unsafe	Unsafe
Open Punctuation	Open Punctuation
Parser Combinators	Parser Combinators
head	head
puttracemsg	put Trace Msg
peek Array	peek Array
tvar#	tvar#
just	just
mfilter	mfilter
Int64	Int64
throw Errno If Retry May Block	throw Errno If Retry May Block
constrrep	Constr Rep
fill Read Buffer	fill Read Buffer
writenonblocking	write Non Blocking
y	y
W#	W#
wordptr	Word Ptr
!double	!Double
openbinarytempfile	open Binary Temp File
maskingstate	Masking State
filepath	File Path
(++)	(++)
(<$)	(<$)
maskeduninterruptible	Masked Uninterruptible
Left Associative	Left Associative
unsetenv	unset Env
readprec	Read Prec
to	to
ishexdigit	is Hex Digit
buffercodec	Buffer Codec
w#	W#
hash Unique	hash Unique
space	space
conindex	Con Index
cycle	cycle
from Rational	from Rational
lex Digits	lex Digits
RTS	RTS
already	already
readconstr	read Constr
de	de
Relative Seek	Relative Seek
fromenum	from Enum
Arg Order	Arg Order
many	many
wall	wall
cwstringlen	cwstringlen
fmt	fmt
Console	Console
[squeeze]	[squeeze]
error	error
copybytes	copy Bytes
div	div
regular	regular
Exts	Exts
threadrunning	Thread Running
lift A	lift A
countleadingzeros	count Leading Zeros
stablename	Stable Name
is Already Exists Error Type	is Already Exists Error Type
genericlength	generic Length
timeoutkey	timeoutkey
Coercible	Coercible
(<>)	(<>)
readp_to_s	read P_to_S
staticptr	Static Ptr
cstring	cstring
reads Prec	reads Prec
bits/num	Bits/Num
lift M5	lift M5
Foldable	Foldable
lifta2	lift A2
thread Wait Write	thread Wait Write
read Dec	read Dec
repconstr	rep Constr
shows	Show S
($!)	($!)
filepath	filepath
setallocationcounter	set Allocation Counter
put	put
list2chan	list2chan
functor	Functor
environment	environment
weak	weak
peek CWString	peek CWString
int#	int#
culong	CULong
[max Bytes Slop]	[max Bytes Slop]
[gc Cpu Seconds]	[gc Cpu Seconds]
storable/eq	Storable/Eq
type Rep	type Rep
constrrep	constr Rep
Failure	Failure
[fmtwidth]	[fmt Width]
for	for
illegal	illegal
contents	contents
seekfromend	Seek From End
split At	split At
($>)	($>)
absolute	absolute
file	file
!int	!int
paragraph	paragraph
findindices	find Indices
msg	msg
[heapprofileinterval]	[heap Profile Interval]
modifyioerror	modify IOError
read File	read File
throw Errno If Minus1Retry_	throw Errno If Minus1Retry_
pokearray0	poke Array0
double#	double#
unsafedupableperformio	unsafe Dupable Perform IO
h Flush	h Flush
Ord/Num	Ord/Num
peekcwstring	peek CWString
storable	storable
echo	echo
errorbadargument	error Bad Argument
minusptr	minus Ptr
threadblocked	Thread Blocked
mk Weak IORef	mk Weak IORef
unregister Fd_	unregister Fd_
s	s
typerep	Type Rep
exception	Exception
gcd	gcd
firsts	firsts
no	no
with6	with6
split	split
h Close	h Close
from Enum	from Enum
mk Int Type	mk Int Type
fixity	fixity
arithexception	arithexception
!Int	!Int
funptr	funptr
Generic	Generic
mapm_	map M_
isalphanum	is Alpha Num
Format Parse	Format Parse
debugflags	debugflags
insert	insert
write Non Blocking	write Non Blocking
finalize	finalize
already Exists Error Type	already Exists Error Type
U1	U1
staticptrinfo	staticptrinfo
new TVar	new TVar
annotate IOError	annotate IOError
line	line
coercible	coercible
one	one
toupper	to Upper
take	take
is Left	is Left
generic Index	generic Index
[gccpuseconds]	[gc Cpu Seconds]
gcs	gcs
unsafe Interleave ST	unsafe Interleave ST
atomic Modify IORef'	atomic Modify IORef'
lit	lit
asum	asum
Alloc	Alloc
Space	Space
find Index	find Index
permissionerrortype	permission Error Type
parse Version	parse Version
Debug Flags	Debug Flags
ident	ident
mapandunzipm	map And Unzip M
num	Num
unmasked	unmasked
mk Weak Pair	mk Weak Pair
word	word
Internal	Internal
timestamp	timestamp
lift A2	lift A2
created	created
[num Gcs]	[num Gcs]
buffermode	buffermode
complex	complex
get Contents	get Contents
st	ST
FD	FD
traceflags	traceflags
reset	reset
retry_	retry_
mk IOError	mk IOError
arrayexception	arrayexception
blockreason	blockreason
fdtohandle	fd To Handle
with CString Len	with CString Len
[mktextdecoder]	[mk Text Decoder]
integral	Integral
zipwith4	zip With4
mkdatatype	mk Data Type
invalidsequence	Invalid Sequence
initialquote	Initial Quote
Buffer State	Buffer State
writetvar	write TVar
killed	killed
thread	thread
showlitchar	show Lit Char
mallocarray	malloc Array
block_	block_
null Fun Ptr	null Fun Ptr
io Error	io Error
munch	munch
ieee	ieee
getsystemeventmanager	get System Event Manager
byteswap32	byte Swap32
getgcstatsenabled	get GCStats Enabled
Arith Exception	Arith Exception
sweep	sweep
fp	fp
exitfailure	Exit Failure
map Maybe	map Maybe
stableptr	Stable Ptr
ceiling	ceiling
fromdyn	from Dyn
res	res
threadstatus	Thread Status
Thread Running	Thread Running
ptrtointptr	ptr To Int Ptr
haskell	haskell
index	index
de Ref Weak	de Ref Weak
allocation	allocation
isnoreptype	is Norep Type
arrowapply	Arrow Apply
formatrealfloat	format Real Float
traceid	trace Id
complex	Complex
unzip7	unzip7
mvar	MVar
blockedonblackhole	Blocked On Black Hole
elem	elem
Read P	Read P
printftype	printftype
nestedatomically	nestedatomically
[fmt Modifiers]	[fmt Modifiers]
tvar	tvar
set Env	set Env
h Get Line	h Get Line
hprintftype	hprintftype
complement	complement
cuint	CUInt
liftm5	lift M5
h Is EOF	h Is EOF
errorcall	Error Call
encoding	Encoding
throwerrnoifretrymayblock	throw Errno If Retry May Block
(<*)	(<*)
(>>=)	(>>=)
hsetbuffering	h Set Buffering
maskedinterruptible	Masked Interruptible
Show S	Show S
constr Type	constr Type
div'	div'
add Foreign Ptr Finalizer	add Foreign Ptr Finalizer
Fixity	Fixity
Seek From End	Seek From End
isnumber	is Number
$tuple_5$	$tuple_5$
illegal Operation Error Type	illegal Operation Error Type
hsetnewlinemode	h Set Newline Mode
modifymvarmasked_	modify MVar Masked_
CShort	CShort
left App	left App
Masking State	Masking State
move	move
rotate R	rotate R
free Pool	free Pool
output	output
comp1	Comp1
withmvar	with MVar
Sign Plus	Sign Plus
constr	constr
cat Maybes	cat Maybes
readlist	read List
ischar	Is Char
map M_	map M_
TVar	TVar
$f_4$	$f_4$
mod	mod
issurrogate	is Surrogate
associativity	Associativity
Double	Double
getenvironment	get Environment
Error On Coding Failure	Error On Coding Failure
real Part	real Part
proper	proper
skip Many1	skip Many1
h Look Ahead	h Look Ahead
debug	debug
is Seekable	is Seekable
timeout	timeout
constr Rep	constr Rep
modify STRef'	modify STRef'
lazy	Lazy
[output NL]	[output NL]
generalcategory	general Category
unset Env	unset Env
phase	phase
sparks	sparks
compare	compare
opentempfilewithdefaultpermissions	open Temp File With Default Permissions
is Mark	is Mark
p	p
waitqsemn	wait QSem N
genericdrop	generic Drop
off	off
traceeventio	trace Event IO
Raw Buffer	Raw Buffer
timermanager	timermanager
[timestamp]	[timestamp]
shift L	shift L
ismark	is Mark
mktycon3	mk Ty Con3
enumfrom	enum From
enclosingmark	Enclosing Mark
handleposn	handleposn
fill Read Buffer0	fill Read Buffer0
h Get Echo	h Get Echo
advanceptr	advance Ptr
[trace Scheduler]	[trace Scheduler]
atomicmodifyioref'	atomic Modify IORef'
show Lit Char	show Lit Char
with CString	with CString
addforeignptrfinalizer	add Foreign Ptr Finalizer
is Permission Error	is Permission Error
calloc Array	calloc Array
req	req
blockedindefinitelyonmvar	Blocked Indefinitely On MVar
size Of	size Of
Data	Data
map Exception	map Exception
realloc Array	realloc Array
wordptr	wordptr
stablename	stablename
advance Ptr	advance Ptr
adjust	adjust
hgetline	h Get Line
posn	posn
cuint	cuint
performminorgc	perform Minor GC
product	product
Endo	Endo
error Missing Argument	error Missing Argument
u1	u1
rotatel	rotate L
throwerrnopath	throw Errno Path
qsemn	QSem N
punc	Punc
rawbuffer	rawbuffer
interrupt	interrupt
environment	Environment
constr Fields	constr Fields
Generic1	Generic1
castcschartochar	cast CSChar To Char
arrow	arrow
is EOFError	is EOFError
[mutatorwallseconds]	[mutator Wall Seconds]
exts	Exts
proxy	Proxy
realloc Bytes	realloc Bytes
Real	Real
type Rep Ty Con	type Rep Ty Con
iscontrol	is Control
throw Errno If Retry_	throw Errno If Retry_
frombool	from Bool
scheduler	scheduler
(^>>)	(^>>)
delay	delay
sep By	sep By
new Pool	new Pool
many1	many1
sepby	sep By
CUChar	CUChar
typelittyperep	type Lit Type Rep
map Accum L	map Accum L
Surrogate	Surrogate
Newline Mode	Newline Mode
codebuffer	codebuffer
fmapdefault	fmap Default
k	k
letternumber	Letter Number
strip	strip
witharraylen	with Array Len
get Masking State	get Masking State
tryreadmvar	try Read MVar
timeoutcallback	Timeout Callback
Utils	Utils
curry	curry
findindex	find Index
formatstring	format String
unregister	unregister
codebuffer	Code Buffer
Prec	Prec
mallocarray0	malloc Array0
type Rep#	type Rep#
to Title	to Title
Category	Category
recip	recip
close	close
constrfixity	constr Fixity
sort On	sort On
bufferedio	Buffered IO
dashpunctuation	Dash Punctuation
fillreadbuffer0	fill Read Buffer0
h Get Buffering	h Get Buffering
closepunctuation	Close Punctuation
lexlitchar	lex Lit Char
b	b
cuchar	CUChar
event	event
maybe	maybe
is Does Not Exist Error Type	is Does Not Exist Error Type
double#	Double#
[tracescheduler]	[trace Scheduler]
Raw IO	Raw IO
relativeseek	Relative Seek
catch Just	catch Just
exit With	exit With
registerfd	register Fd
Functor	Functor
Addr#	Addr#
minus1_	minus1_
Handle Posn	Handle Posn
[cpu Seconds]	[cpu Seconds]
isusererror	is User Error
get Foreign Encoding	get Foreign Encoding
IO	IO
skip Spaces	skip Spaces
sizeof	size Of
map And Unzip M	map And Unzip M
coerce	coerce
newqsemn	new QSem N
throw Errno Path If	throw Errno Path If
hgetbufnonblocking	h Get Buf Non Blocking
$tuple_6$	$tuple_6$
throw If	throw If
malloc Foreign Ptr Array	malloc Foreign Ptr Array
show Paren	show Paren
sort By	sort By
profflags	profflags
symbol	Symbol
readtvar	read TVar
gcast1	gcast1
istrue#	is True#
branch	branch
read	Read
Coding Progress	Coding Progress
charisrepresentable	char Is Representable
fieldformatter	Field Formatter
modify MVar_	modify MVar_
fd To Handle	fd To Handle
retry	retry
arithexception	Arith Exception
alternative	Alternative
from	from
uppercase	uppercase
splitpolytyconapp	split Poly Ty Con App
with Binary File	with Binary File
with Array0	with Array0
mappend	mappend
Instances	Instances
finalizeforeignptr	finalize Foreign Ptr
foldr1	foldr1
Integral/Show	Integral/Show
malloc Foreign Ptr Bytes	malloc Foreign Ptr Bytes
error Short Format	error Short Format
ord	ord
stats	stats
call	call
hshow	h Show
hasresolution	hasresolution
nomethoderror	nomethoderror
error With Stack Trace	error With Stack Trace
path	path
mallocbytes	malloc Bytes
polar	polar
regularfile	Regular File
mk Data Type	mk Data Type
csigatomic	csigatomic
fd_	fd_
arrowapply	arrowapply
running	running
timeoutkey	Timeout Key
lifetime	lifetime
swap MVar	swap MVar
h Set Encoding	h Set Encoding
isalpha	is Alpha
unsafelookupstaticptr	unsafe Lookup Static Ptr
srclocpackage	src Loc Package
foldable	Foldable
reallocbytes	realloc Bytes
finite	finite
Complex	Complex
neg_	neg_
app	app
[fp Char]	[fp Char]
fork IO	fork IO
rts	rts
asyncexception	asyncexception
[current Bytes Slop]	[current Bytes Slop]
readlistdefault	read List Default
combining	combining
either	either
somenat	somenat
take While	take While
iomanager	iomanager
test	test
readsprec	reads Prec
staticptrkeys	static Ptr Keys
srcloc	srcloc
user	user
mapaccumr	map Accum R
readsigned	read Signed
exitcode	exitcode
kproxy	kproxy
lazy	lazy
word64	Word64
whocreated	who Created
system	System
Dash Punctuation	Dash Punctuation
close Fd	close Fd
count	count
kindrep	Kind Rep
h	h
Fun Ptr	Fun Ptr
$tuple_4$	$tuple_4$
Exit Code	Exit Code
conindex	conindex
[gcwallseconds]	[gc Wall Seconds]
ioref'	ioref'
(+)	(+)
sequence A_	sequence A_
Timeout Callback	Timeout Callback
readdec	read Dec
rec	rec
Pattern Match Fail	Pattern Match Fail
alternative	alternative
may	may
thread Wait Read STM	thread Wait Read STM
bit Size Maybe	bit Size Maybe
run In Bound Thread	run In Bound Thread
sync	Sync
symbol	symbol
realpart	real Part
ascii	ascii
assertion	assertion
package	package
traverse_	traverse_
fork OS	fork OS
pool	pool
threadwaitwritestm	thread Wait Write STM
Exit	Exit
signum	signum
pop Count	pop Count
Alternative	Alternative
liftm	lift M
[gc Wall Seconds]	[gc Wall Seconds]
issuffixof	is Suffix Of
sp	sp
exit	Exit
utf8	utf8
asproxytypeof	as Proxy Type Of
peek CString Len	peek CString Len
denominator	denominator
Arrow Monad	Arrow Monad
result	result
statickey	statickey
Bits	Bits
console	Console
unsafe Local State	unsafe Local State
initial	initial
endby	end By
[spinfosrcloc]	[sp Info Src Loc]
handle	handle
false	False
died	died
thread Capability	thread Capability
Encoding	Encoding
new MVar	new MVar
debugflags	Debug Flags
Field Formatter	Field Formatter
sel	sel
realfrac	Real Frac
cschar	CSChar
buffering	buffering
catmaybes	cat Maybes
mempty	mempty
args	args
foldr M	foldr M
ready	ready
fold M	fold M
throw Errno	throw Errno
format Real Float	format Real Float
rawbuffer	Raw Buffer
zero Bits	zero Bits
opentempfile	open Temp File
conjugate	conjugate
plus	plus
lookup	lookup
mark	mark
hseek	h Seek
tags	tags
finally	finally
make Stable Name	make Stable Name
hputchar	h Put Char
Thread Status	Thread Status
Fd Key	Fd Key
sign	sign
C#	C#
hgetposn	h Get Posn
Timer Manager	Timer Manager
qsemn	qsemn
megabytes	megabytes
fork	fork
trace Id	trace Id
printftype	Printf Type
(^)	(^)
someasyncexception	someasyncexception
free	free
Printf	Printf
throw IO	throw IO
union	union
num Sparks	num Sparks
ord/num	Ord/Num
m_	m_
trace Event	trace Event
&	&
foldrm	foldr M
dup Chan	dup Chan
mallocforeignptrarray0	malloc Foreign Ptr Array0
newstableptr	new Stable Ptr
fromrat	from Rat
by	by
h Wait For Input	h Wait For Input
permission Error Type	permission Error Type
tvar#	TVar#
skip	skip
iodevice/bufferedio/typeable	iodevice/bufferedio/typeable
[current Bytes Used]	[current Bytes Used]
newcwstringlen	new CWString Len
getchancontents	get Chan Contents
finished	finished
on	on
utf32be	utf32be
read IORef	read IORef
alreadyinuseerrortype	already In Use Error Type
Safe	Safe
data	Data
is Illegal Operation	is Illegal Operation
peekarray	peek Array
pfail	pfail
spacingcombiningmark	Spacing Combining Mark
liftm4	lift M4
ordering	Ordering
[max Bytes Used]	[max Bytes Used]
register Timeout	register Timeout
first	First
throwerrnoifnull	throw Errno If Null
native Newline Mode	native Newline Mode
false	false
lifta	lift A
annotate	annotate
read Paren	read Paren
control	control
[fmtadjust]	[fmt Adjust]
cstring	CString
minimumby	minimum By
as	as
Data Type	Data Type
htell	h Tell
genericindex	generic Index
c	C
constrrep	constrrep
find	find
read TVar	read TVar
mk Weak MVar	mk Weak MVar
Permute	Permute
subsequences	subsequences
na	na
threadid#	Thread Id#
mk File Handle	mk File Handle
derefweak	de Ref Weak
Line Buffering	Line Buffering
[heap Profile Interval]	[heap Profile Interval]
Deadlock	Deadlock
threadcapability	thread Capability
flip	flip
Ord	Ord
showfloat	show Float
exts	exts
(<*>)	(<*>)
encodefloat	encode Float
hready	h Ready
read Lit Char	read Lit Char
generic Drop	generic Drop
assertionfailed	Assertion Failed
maybetolist	maybe To List
representable	representable
bracket	bracket
scanr	scanr
somesymbol	Some Symbol
(+++)	(+++)
Exit Failure	Exit Failure
current	current
coerce With	coerce With
leftassociative	Left Associative
patternmatchfail	patternmatchfail
minus Ptr	minus Ptr
CWString Len	CWString Len
lifta3	lift A3
integral/show	Integral/Show
(&&&)	(&&&)
readmode	Read Mode
Types	Types
constr	Constr
get Num Processors	get Num Processors
catch STM	catch STM
foldl'	foldl'
isalreadyexistserrortype	is Already Exists Error Type
quot	quot
null	null
showparen	show Paren
evt Read	evt Read
category	Category
writefile	write File
sum	sum
codingfailuremode	codingfailuremode
[fmt Char]	[fmt Char]
fixity	Fixity
Arrow Plus	Arrow Plus
open Temp File With Default Permissions	open Temp File With Default Permissions
isterminal	is Terminal
Numeric	Numeric
until	until
unregisterfd_	unregister Fd_
is Just	is Just
fix ST	fix ST
pokebyteoff	poke Byte Off
!	!
word32	word32
stream	stream
[fp Modifiers]	[fp Modifiers]
spacing	spacing
shift R	shift R
Bits/Num	Bits/Num
fromintegral	from Integral
[bytesallocated]	[bytes Allocated]
foldl1'	foldl1'
Lazy	Lazy
skipmany1	skip Many1
instances	instances
(DOT)	(DOT)
approx Rational	approx Rational
withforeignptr	with Foreign Ptr
Ratio	Ratio
plus Ptr	plus Ptr
pair	pair
align Ptr	align Ptr
touch Foreign Ptr	touch Foreign Ptr
ratio	ratio
Handle	Handle
nested	nested
pooledrealloc	pooled Realloc
Async Exception	Async Exception
tycon	Ty Con
hsetencoding	h Set Encoding
f	f
mzero	mzero
get Locale Encoding	get Locale Encoding
perform Major GC	perform Major GC
exitcode	Exit Code
typelits	typelits
modify	modify
recover	recover
is Nothing	is Nothing
io	io
formatchar	format Char
gcstats	GCStats
of	of
maximum By	maximum By
Monad	Monad
rts Supports Bound Threads	rts Supports Bound Threads
showconstr	show Constr
h Get Char	h Get Char
current Call Stack	current Call Stack
version	Version
is Hex Digit	is Hex Digit
poolednewarray	pooled New Array
eventmanager	eventmanager
finitebits	finitebits
Word Ptr	Word Ptr
readparen	read Paren
hfilesize	h File Size
Private Use	Private Use
showoct	show Oct
eof	eof
[fmtmodifiers]	[fmt Modifiers]
Version	Version
copyarray	copy Array
threadwaitread	thread Wait Read
number	number
catchjust	catch Just
Punc	Punc
somesymbolval	some Symbol Val
uninterruptible	uninterruptible
posix	posix
bit	bit
Block Buffering	Block Buffering
min	min
readtvario	read TVar IO
touch	touch
ensure IOManager Is Running	ensure IOManager Is Running
to Constr	to Constr
Int16	Int16
peekcstringlen	peek CString Len
rational	rational
Handler	Handler
comparing	comparing
async	async
blockedindefinitelyonstm	Blocked Indefinitely On STM
typeable	Typeable
showlist	show List
Other Letter	Other Letter
return	return
callocbytes	calloc Bytes
perform Minor GC	perform Minor GC
blocked	blocked
Uppercase Letter	Uppercase Letter
r	r
new Foreign Ptr	new Foreign Ptr
split Ty Con App	split Ty Con App
sep	sep
unsafe Interleave IO	unsafe Interleave IO
monoid	Monoid
recupderror	Rec Upd Error
parseversion	parse Version
os	os
io	IO
Float	Float
die	die
get Prog Name	get Prog Name
block	block
castptrtofunptr	cast Ptr To Fun Ptr
get Chan Contents	get Chan Contents
(<|>)	(<|>)
mktyconapp	mk Ty Con App
f#	f#
Rational	Rational
IODevice/Buffered IO/Typeable	IODevice/Buffered IO/Typeable
showsigned	show Signed
statickey	Static Key
alloc	Alloc
throw Errno Path If_	throw Errno Path If_
isinfixof	is Infix Of
Finalizer Ptr	Finalizer Ptr
par	par
read Non Blocking	read Non Blocking
kleisli	Kleisli
readio	read IO
counttrailingzeros	count Trailing Zeros
out	out
getopt	Get Opt
malloc Foreign Ptr	malloc Foreign Ptr
writestref	write STRef
interruptible	interruptible
returna	return A
textencoder	textencoder
rnf Ty Con	rnf Ty Con
Constr	Constr
usage Info	usage Info
limit	limit
eq/num	eq/num
group	group
Generics	Generics
Fd	Fd
argorder	Arg Order
[sparksfull]	[sparks Full]
(==)	(==)
exists	exists
peekbyteoff	peek Byte Off
uppercaseletter	Uppercase Letter
type	type
show	Show
(<+>)	(<+>)
unsafeinterleaveio	unsafe Interleave IO
fields	fields
foldl1	foldl1
eof Error Type	eof Error Type
generalcategory	generalcategory
is Negative Zero	is Negative Zero
fromconstr	from Constr
write	write
elem Indices	elem Indices
Arg Descr	Arg Descr
parsercombinators	parsercombinators
constrindex	constr Index
Format Adjustment	Format Adjustment
arrowchoice	Arrow Choice
catch	catch
optdescr	Opt Descr
rep Constr	rep Constr
throw To	throw To
control	Control
Thread Killed	Thread Killed
witharray0	with Array0
Text Encoder	Text Encoder
gfloat	gfloat
[numgcs]	[num Gcs]
fill Bytes	fill Bytes
flushwritebuffer	flush Write Buffer
use	use
outputunderflow	Output Underflow
threaddied	Thread Died
movebytes	move Bytes
CSChar	CSChar
codec	codec
readioref	read IORef
Thread Id#	Thread Id#
maximumby	maximum By
errno	errno
Alg Constr	Alg Constr
real	real
stref'	stref'
newmvar	new MVar
complementbit	complement Bit
replicate M	replicate M
replicatem	replicate M
foreignptr	foreignptr
nub By	nub By
notelem	not Elem
[mutator Wall Seconds]	[mutator Wall Seconds]
end By	end By
isieee	is IEEE
Prefix	Prefix
Stable Name	Stable Name
toconstr	to Constr
nullfunptr	null Fun Ptr
mem	mem
showstring	show String
natural	Natural
mk Char Constr	mk Char Constr
get File System Encoding	get File System Encoding
mem	Mem
IODevice	IODevice
$tuple_7$	$tuple_7$
write STRef	write STRef
(<++)	(<++)
set	set
[recover]	[recover]
word32	Word32
fdkey	fdkey
norep	norep
n	n
integral	integral
manager	manager
lex	Lex
shift L#	shift L#
truncate	truncate
cdouble	cdouble
open Binary File	open Binary File
permissions	permissions
exitwith	exit With
locale Encoding	locale Encoding
permute	permute
Foreign Ptr	Foreign Ptr
throw Errno If Minus1Retry May Block_	throw Errno If Minus1Retry May Block_
[sp Info Src Loc]	[sp Info Src Loc]
with Many	with Many
coercewith	coerce With
optional	optional
h Set Binary Mode	h Set Binary Mode
register	register
Index Out Of Bounds	Index Out Of Bounds
show Constr	show Constr
from1	from1
concurrent	Concurrent
disable	disable
typerepfingerprint	type Rep Fingerprint
minus1retry	minus1retry
trans	trans
on Exception	on Exception
h Get Buf Non Blocking	h Get Buf Non Blocking
approx	approx
textencoding	textencoding
trace	trace
otherwise	otherwise
mk Duplex Handle	mk Duplex Handle
reads	reads
ord	Ord
reseterrno	reset Errno
pooled	pooled
(*>)	(*>)
Ty Con	Ty Con
!Int64	!Int64
alg	alg
abs	abs
duplex	duplex
is Valid Errno	is Valid Errno
foreign	Foreign
text	Text
opt	opt
arg	arg
ctime	ctime
Letter Number	Letter Number
Arrow	Arrow
integer	Integer
disable Allocation Limit	disable Allocation Limit
[compact]	[compact]
step	step
showsprec	shows Prec
malloc Bytes	malloc Bytes
h Printf	h Printf
end By1	end By1
Not Assigned	Not Assigned
rational	Rational
coercible	Coercible
with CWString	with CWString
x	x
paragraphseparator	Paragraph Separator
rawio	rawio
#	#
item	item
capability	capability
Error Call	Error Call
with4	with4
trace Show Id	trace Show Id
instances	Instances
Timeout	Timeout
internal	Internal
Arrow Apply	Arrow Apply
properfraction	proper Fraction
my	my
eq Stable Name	eq Stable Name
ahead	ahead
read	read
performgc	perform GC
getallocationcounter	get Allocation Counter
cstringlen	cstringlen
staticptrinfo	Static Ptr Info
csigatomic	CSig Atomic
ratio	Ratio
openfile	open File
poke Array	poke Array
char	char
eq/num	Eq/Num
mythreadid	my Thread Id
from Constr	from Constr
get Line	get Line
mutator	mutator
readfile	read File
Some Symbol	Some Symbol
hprintftype	HPrintf Type
Math Symbol	Math Symbol
Rep	Rep
always	always
static Ptr Info	static Ptr Info
lazy To Strict ST	lazy To Strict ST
cchar	CChar
poke Byte Off	poke Byte Off
GCStats	GCStats
l	l
unsafelocalstate	unsafe Local State
reallocarray0	realloc Array0
Thread Died	Thread Died
setnumcapabilities	set Num Capabilities
lex Lit Char	lex Lit Char
somenatval	some Nat Val
Heap Overflow	Heap Overflow
array0	array0
d#	d#
modify STRef	modify STRef
putstrln	put Str Ln
test Coercion	test Coercion
privateuse	Private Use
trace	Trace
some	some
mplus	mplus
first	first
Stack	Stack
error Bad Format	error Bad Format
cast Fun Ptr To Ptr	cast Fun Ptr To Ptr
significand	significand
flags	flags
fmap	fmap
blockedindefinitelyonmvar	blockedindefinitelyonmvar
operation	operation
sequencea	sequence A
fd To Handle'	fd To Handle'
newforeignptrenv	new Foreign Ptr Env
popcountdefault	pop Count Default
float Radix	float Radix
poly	poly
rep1	Rep1
nub	nub
strip Prefix	strip Prefix
form_	for M_
lazytostrictst	lazy To Strict ST
cast Char To CSChar	cast Char To CSChar
Word#	Word#
utils	utils
unset	unset
userinterrupt	User Interrupt
masked_	masked_
otherletter	Other Letter
Blocked On MVar	Blocked On MVar
cllong	cllong
castforeignptr	cast Foreign Ptr
Blocked On Other	Blocked On Other
iodevicetype	IODevice Type
unzip4	unzip4
Newline	Newline
from Maybe	from Maybe
is Alpha	is Alpha
Integer	Integer
mk Fun Ty	mk Fun Ty
counter	counter
iomode	iomode
getline	get Line
throw Errno If	throw Errno If
clear Bit	clear Bit
Ptr	Ptr
Eq	Eq
Int Ptr	Int Ptr
erroroncodingfailure	Error On Coding Failure
interact	interact
Posix	Posix
Foreign	Foreign
new Stable Ptr	new Stable Ptr
Char	Char
print	print
hashunique	hash Unique
False	False
from Dynamic	from Dynamic
Info	Info
int	Int
Rec Upd Error	Rec Upd Error
read IO	read IO
seq	seq
add Foreign Ptr Finalizer Env	add Foreign Ptr Finalizer Env
tell	tell
getmaskingstate	get Masking State
throwif	throw If
Product	Product
safe	safe
throw STM	throw STM
show Signed	show Signed
setraw	set Raw
throw Errno If Minus1	throw Errno If Minus1
throwto	throw To
show Float	show Float
Monoid	Monoid
dyn	dyn
modifyioref	modify IORef
geterrno	get Errno
thread Wait Write STM	thread Wait Write STM
unbound	unbound
try Just	try Just
peekcwstringlen	peek CWString Len
withbinaryfile	with Binary File
mk Text Encoding	mk Text Encoding
hclose	h Close
cast CUChar To Char	cast CUChar To Char
foldm	fold M
dynamic	dynamic
f#	F#
traceio	trace IO
ref	ref
who	who
num	num
newbuffer	new Buffer
addr#	addr#
shiftl#	shift L#
castptr	cast Ptr
ffloat	ffloat
Bounded	Bounded
tuple	Tuple
atomically	atomically
illegaloperationerrortype	illegal Operation Error Type
free Haskell Fun Ptr	free Haskell Fun Ptr
width	width
lift M	lift M
register Fd	register Fd
cast Fun Ptr	cast Fun Ptr
p_to_s	p_to_s
throwerrnoifminus1retrymayblock_	throw Errno If Minus1Retry May Block_
Spacing Combining Mark	Spacing Combining Mark
private	private
atan2	atan2
ty	ty
is Alg Type	is Alg Type
is Alpha Num	is Alpha Num
Thread Blocked	Thread Blocked
blocking	blocking
poke	poke
newforeignptr	new Foreign Ptr
c#	C#
intptr	Int Ptr
alt	alt
Device	Device
vfmt	v Fmt
Finalizer Env Ptr	Finalizer Env Ptr
termination	termination
leading	leading
always Succeeds	always Succeeds
fillbytes	fill Bytes
Word64	Word64
Output Underflow	Output Underflow
update	update
local	local
unzip6	unzip6
sequence	sequence
Data Rep	Data Rep
true#	true#
[outputnl]	[output NL]
hgetbuffering	h Get Buffering
tolist	to List
Other Punctuation	Other Punctuation
read List Default	read List Default
recupderror	recupderror
finitebitsize	finite Bit Size
nothing	nothing
funresultty	fun Result Ty
mk Ty Con3	mk Ty Con3
Integral	Integral
pooledreallocbytes	pooled Realloc Bytes
read MVar	read MVar
Read Prec	Read Prec
format Integer	format Integer
h Put Str	h Put Str
iomode	IOMode
rest	rest
forever	forever
marker	marker
Mem	Mem
length	length
otherpunctuation	Other Punctuation
popcount	pop Count
indexoutofbounds	Index Out Of Bounds
conc	Conc
iodevice	iodevice
integral/show	integral/show
flush	flush
nomethoderror	No Method Error
thread Delay	thread Delay
finalizerptr	Finalizer Ptr
someasyncexception	Some Async Exception
!double	!double
category	category
char8	char8
perform GC	perform GC
peak	peak
exceeded	exceeded
with Array	with Array
rep	Rep
Some Nat	Some Nat
unsafe	unsafe
throwerrnoifminus1retry_	throw Errno If Minus1Retry_
modifier	modifier
catchstm	catch STM
assigned	assigned
traversable	Traversable
writelist2chan	write List2Chan
KProxy	KProxy
try Take MVar	try Take MVar
finalquote	Final Quote
arrowchoice	arrowchoice
linebuffering	Line Buffering
a1	a1
flush Write Buffer0	flush Write Buffer0
lift A3	lift A3
ty Con String	ty Con String
terminal	terminal
isdigit	is Digit
cuchar	cuchar
pooledmallocbytes	pooled Malloc Bytes
generalcategory	General Category
Regular File	Regular File
hgetecho	h Get Echo
[fp Rest]	[fp Rest]
constr Fixity	constr Fixity
Assertion Failed	Assertion Failed
maybes	maybes
Static Ptr	Static Ptr
test Bit Default	test Bit Default
Trace Flags	Trace Flags
trailing	trailing
stable	stable
get Errno	get Errno
buffer	buffer
h Get Buf	h Get Buf
throwerrnoif	throw Errno If
throwerrno	throw Errno
Old List	Old List
CUSeconds	CUSeconds
read TVar IO	read TVar IO
bool	bool
function	function
cis	cis
Thread Id	Thread Id
pooledmalloc	pooled Malloc
lexdigits	lex Digits
castfunptrtoptr	cast Fun Ptr To Ptr
rotater	rotate R
STRef	STRef
m5	m5
CUInt	CUInt
Eq/Num	Eq/Num
recconerror	Rec Con Error
write File	write File
copy Bytes	copy Bytes
duplicate	duplicate
Modifier Symbol	Modifier Symbol
version	version
new	new
mkfloattype	mk Float Type
newcstring	new CString
utils	Utils
reset Errno	reset Errno
utf8	UTF8
partition	partition
display Exception	display Exception
does	does
STM	STM
Is String	Is String
Blocked On Black Hole	Blocked On Black Hole
forkfinally	fork Finally
Initial Quote	Initial Quote
align	align
modifymvarmasked	modify MVar Masked
ap	ap
elemindex	elem Index
elem Index	elem Index
unsafeperformio	unsafe Perform IO
peek CString	peek CString
minus1	minus1
showffloat	show FFloat
touchforeignptr	touch Foreign Ptr
copied	copied
h Is Terminal Device	h Is Terminal Device
kill	kill
othersymbol	Other Symbol
replicate	replicate
Masked Interruptible	Masked Interruptible
tvar	TVar
who Created	who Created
deadlock	deadlock
copy Array	copy Array
sorton	sort On
[version Branch]	[version Branch]
Finite Bits	Finite Bits
(>>)	(>>)
numcapabilities	num Capabilities
non	non
int To Digit	int To Digit
m	m
killthread	kill Thread
string	String
cuseconds	cuseconds
seconds	seconds
console	console
forkio	fork IO
state#	State#
stack	stack
generics	generics
pow Mod Natural	pow Mod Natural
[text Encoding Name]	[text Encoding Name]
full	full
iodevicetype	iodevicetype
ispunctuation	is Punctuation
algconstr	Alg Constr
size	size
user Error	user Error
newchan	new Chan
threads	threads
mk Ty Con App	mk Ty Con App
filter	filter
masking	masking
tracestack	trace Stack
absoluteseek	Absolute Seek
display	display
getlocaleencoding	get Locale Encoding
typerep	typerep
monoid	monoid
$f_6$	$f_6$
testbitdefault	test Bit Default
info	info
Text Decoder	Text Decoder
and	and
par1	Par1
Storable	Storable
errorcall	errorcall
(=<<)	(=<<)
shot	shot
Zip List	Zip List
formatadjustment	Format Adjustment
QSem N	QSem N
array	array
getopt	getopt
int32	Int32
test Bit	test Bit
ptr	ptr
showgfloat	show GFloat
h File Size	h File Size
fingerprint	fingerprint
cdev	cdev
eoferror	eoferror
First	First
codingprogress	Coding Progress
[fpmodifiers]	[fp Modifiers]
CSig Atomic	CSig Atomic
bytes	bytes
shift RL#	shift RL#
culong	culong
deletefirstsby	delete Firsts By
(<**>)	(<**>)
enum From To	enum From To
Alt	Alt
CChar	CChar
inputunderflow	Input Underflow
blockedonother	Blocked On Other
empty	empty
[trace Gc]	[trace Gc]
[currentbytesused]	[current Bytes Used]
eqstablename	eq Stable Name
shows	shows
alpha	alpha
m1	m1
readmaybe	read Maybe
[encode]	[encode]
format String	format String
input	input
frominteger	from Integer
h Put Char	h Put Char
info	Info
proxy#	Proxy#
for M	for M
rep	rep
weak	Weak
between	between
blockedindefinitelyonstm	blockedindefinitelyonstm
with Args	with Args
isalreadyinuseerrortype	is Already In Use Error Type
typeable	typeable
hflush	h Flush
skipspaces	skip Spaces
pooled Malloc Array	pooled Malloc Array
peekarray0	peek Array0
State#	State#
throw Errno If Retry	throw Errno If Retry
Char#	Char#
with Array Len	with Array Len
:.:	:.:
[peak Megabytes Allocated]	[peak Megabytes Allocated]
mk Char Type	mk Char Type
pool	Pool
Buffer Mode	Buffer Mode
exception	exception
newline	newline
zipwithm	zip With M
Format Sign	Format Sign
unwords	unwords
cshort	CShort
ptrtowordptr	ptr To Word Ptr
m1	M1
numsparks	num Sparks
slop	slop
new Foreign Ptr Env	new Foreign Ptr Env
paren	paren
natural To Word Maybe	natural To Word Maybe
register Delay	register Delay
cschar	cschar
algrep	Alg Rep
hputstr	h Put Str
ghc	GHC
Tuple	Tuple
showchar	show Char
modifierletter	Modifier Letter
hduplicate	h Duplicate
histerminaldevice	h Is Terminal Device
[bytes Allocated]	[bytes Allocated]
isseekable	is Seekable
id	id
Blocked On Foreign Call	Blocked On Foreign Call
(	(
write TVar	write TVar
F#	F#
threadwaitwrite	thread Wait Write
(<<<)	(<<<)
Enum	Enum
exponent	exponent
mk Float Type	mk Float Type
keys	keys
already In Use Error Type	already In Use Error Type
trace Stack	trace Stack
:*:	:*:
Lifetime	Lifetime
getnumcapabilities	get Num Capabilities
bits	Bits
withcastringlen	with CAString Len
getfilehash	get File Hash
minprec	min Prec
Req Arg	Req Arg
isasciiupper	is Ascii Upper
slide Contents	slide Contents
uninterruptible Mask_	uninterruptible Mask_
int64	Int64
c'	c'
iocallback	IOCallback
stricttolazyst	strict To Lazy ST
user Error Type	user Error Type
quot Rem	quot Rem
seekmode	seekmode
stackoverflow	Stack Overflow
tryputmvar	try Put MVar
Text	Text
[currentbytesslop]	[current Bytes Slop]
from Integer	from Integer
cast Char To CChar	cast Char To CChar
caststableptrtoptr	cast Stable Ptr To Ptr
calloc	calloc
mapexception	map Exception
trace Event IO	trace Event IO
Marshal	Marshal
mk Polar	mk Polar
throw Errno If Null	throw Errno If Null
overflow	Overflow
make	make
Float#	Float#
threadkilled	Thread Killed
(:*:)	(:*:)
enclosing	enclosing
with CAString Len	with CAString Len
concat	concat
throwstm	throw STM
addforeignptrfinalizerenv	add Foreign Ptr Finalizer Env
set Bit	set Bit
maxconstrindex	max Constr Index
openfileblocking	open File Blocking
underflow	underflow
monad	monad
const	const
at	at
realloc	realloc
readstref	read STRef
skip Many	skip Many
get Opt	get Opt
(***)	(***)
mkappty	mk App Ty
ishiftl#	i Shift L#
get File Hash	get File Hash
stref	stref
heap	heap
textencoder	Text Encoder
(\\)	(\\)
internal	internal
lookupenv	lookup Env
currentcallstack	current Call Stack
Allocation Limit Exceeded	Allocation Limit Exceeded
Rec Sel Error	Rec Sel Error
show List	show List
generic Length	generic Length
prec	prec
enum From	enum From
ensure	ensure
words	words
monadplus	monadplus
ioref	IORef
IOError	IOError
natural	natural
yield	yield
Par1	Par1
blockreason	Block Reason
freepool	free Pool
poke Array0	poke Array0
realworld	realworld
somenat	Some Nat
Int	Int
clearbit	clear Bit
getnumprocessors	get Num Processors
relative	relative
arrowplus	Arrow Plus
storable/eq	storable/eq
is Symbol	is Symbol
get Num Capabilities	get Num Capabilities
threadfinished	Thread Finished
get Allocation Counter	get Allocation Counter
isleft	is Left
reqarg	Req Arg
w#	w#
succeeds	succeeds
$f_3$	$f_3$
open Temp File	open Temp File
blockbuffering	Block Buffering
bufferedio	bufferedio
Overflow	Overflow
approxrational	approx Rational
IODevice Type	IODevice Type
hasresolution	Has Resolution
Word	Word
bufferstate	bufferstate
is Full Error Type	is Full Error Type
int32	int32
int64	int64
castring	castring
usageinfo	usage Info
splitat	split At
throwerrnopathifminus1	throw Errno Path If Minus1
[inputnl]	[input NL]
h Print	h Print
stdout	stdout
from Rat	from Rat
seekable	seekable
pred	pred
Test Coercion	Test Coercion
fixed	Fixed
rotate	rotate
some Symbol Val	some Symbol Val
alt	Alt
isseparator	is Separator
notassigned	Not Assigned
evaluate	evaluate
coercion	Coercion
Real Float	Real Float
native Newline	native Newline
Rep1	Rep1
pattern	pattern
proxy	proxy
timeout	Timeout
formatsign	formatsign
Weak	Weak
finalize Foreign Ptr	finalize Foreign Ptr
trytakemvar	try Take MVar
shift	shift
profile	profile
flush Write Buffer	flush Write Buffer
IOMode	IOMode
final	final
ptr To Int Ptr	ptr To Int Ptr
posix	Posix
[mk Text Decoder]	[mk Text Decoder]
malloc Array0	malloc Array0
$f_2$	$f_2$
radix	radix
utf16	utf16
[sparkssampled]	[sparks Sampled]
arr	arr
major	major
coercion	coercion
IOError Type	IOError Type
IOCallback	IOCallback
to Bool	to Bool
float#	Float#
hex	hex
bracket On Error	bracket On Error
String	String
Bifunctor	Bifunctor
mvar	mvar
raw	raw
Coercion	Coercion
marshal	Marshal
Base	Base
decode	decode
coding	coding
mapaccuml	map Accum L
v Fmt	v Fmt
update Timeout	update Timeout
env	env
Word32	Word32
elemindices	elem Indices
peek Byte Off	peek Byte Off
src	src
patternmatchfail	Pattern Match Fail
modifymvar_	modify MVar_
sym	sym
len	len
CDev	CDev
iodevice/bufferedio/typeable	IODevice/Buffered IO/Typeable
v	v
type	Type
iseoferror	is EOFError
ident	Ident
floating	Floating
(^<<)	(^<<)
nobuffering	No Buffering
from Bool	from Bool
[tracegc]	[trace Gc]
registerdelay	register Delay
unsafeshiftr	unsafe Shift R
look	look
nat	nat
[peakmegabytesallocated]	[peak Megabytes Allocated]
mvar_	mvar_
nonspacingmark	Non Spacing Mark
device	Device
islist	Is List
finalizerenvptr	finalizerenvptr
is Prefix Of	is Prefix Of
throwerrnoifretry	throw Errno If Retry
failure	failure
argdescr	Arg Descr
unsafe	Unsafe
is True#	is True#
CString	CString
arrow	Arrow
l1	L1
Maybe	Maybe
method	method
isemptychan	is Empty Chan
Item	Item
typerep#	type Rep#
Word8	Word8
unlines	unlines
hash	hash
Stack Overflow	Stack Overflow
derefstableptr	de Ref Stable Ptr
ispermissionerror	is Permission Error
st To IO	st To IO
pooled Realloc Bytes	pooled Realloc Bytes
Symbol	Symbol
general	general
parsercombinators	Parser Combinators
name	name
errorwithstacktrace	error With Stack Trace
utf32	UTF32
movearray	move Array
de Ref Stable Ptr	de Ref Stable Ptr
alloca	alloca
is Separator	is Separator
chainl1	chainl1
val	val
zip5	zip5
isnothing	is Nothing
fixed	fixed
zero	zero
:+:	:+:
UTF16	UTF16
read Chan	read Chan
ioerror	IOError
Ordering	Ordering
Timeout Key	Timeout Key
monadplus	Monad Plus
arrowmonad	Arrow Monad
withcstring	with CString
fold Map	fold Map
rts	RTS
bits	bits
Read Mode	Read Mode
errorbadformat	error Bad Format
read STRef	read STRef
leftapp	left App
max	max
hgetencoding	h Get Encoding
comp1	comp1
TVar#	TVar#
to List	to List
finalizerfree	finalizer Free
pooledmallocarray	pooled Malloc Array
Coding Failure Mode	Coding Failure Mode
Non Spacing Mark	Non Spacing Mark
recselerror	Rec Sel Error
pop Count Default	pop Count Default
getforeignencoding	get Foreign Encoding
valid	valid
Concurrent	Concurrent
letter	letter
One Shot	One Shot
a5	a5
temp	temp
finitebits	Finite Bits
char#	char#
chainl	chainl
not	not
swapmvar	swap MVar
formatadjustment	formatadjustment
Format	Format
blockedonmvar	Blocked On MVar
oldlist	Old List
constrfields	constr Fields
float	Float
intersect By	intersect By
open File	open File
Fingerprint	Fingerprint
ptr_	ptr_
runinboundthread	run In Bound Thread
handler	Handler
rat	rat
evtread	evt Read
system	system
suffix	suffix
d	d
dash	dash
type Rep Args	type Rep Args
errorshortformat	error Short Format
unless	unless
testbit	test Bit
stableptr	stableptr
lefts	lefts
error Bad Argument	error Bad Argument
in	in
mk App Ty	mk App Ty
directory	directory
map M	map M
realworld	Real World
buf	buf
timermanager	Timer Manager
withcstringlen	with CString Len
getopt'	get Opt'
seekmode	Seek Mode
Storable/Eq	Storable/Eq
format	Format
CWString	CWString
drop	drop
lex	lex
sttoio	st To IO
Environment	Environment
mapm	map M
slide	slide
isjust	is Just
assertionfailed	assertionfailed
buffercodec	buffercodec
mapmaybe	map Maybe
throw Errno If Minus1Retry May Block	throw Errno If Minus1Retry May Block
fd	FD
integer	integer
usererrortype	user Error Type
finalizerenvptr	Finalizer Env Ptr
typereptycon	type Rep Ty Con
run In Unbound Thread	run In Unbound Thread
option	option
sort	sort
$tuple_3$	$tuple_3$
Final Quote	Final Quote
castchartocuchar	cast Char To CUChar
GCFlags	GCFlags
cat	cat
h Set Posn	h Set Posn
Chan	Chan
Error	Error
as Proxy Type Of	as Proxy Type Of
uninterruptiblemask_	uninterruptible Mask_
realfloat	realfloat
move Bytes	move Bytes
[wall Seconds]	[wall Seconds]
delete By	delete By
generic	Generic
map Accum R	map Accum R
foldlm	foldl M
conc	conc
traceflags	Trace Flags
return A	return A
modifystref'	modify STRef'
cpu	cpu
surrogate	Surrogate
insertby	insert By
readlitchar	read Lit Char
set Raw	set Raw
upper	upper
Type Lits	Type Lits
sequence A	sequence A
withfile	with File
Unique	Unique
set Num Capabilities	set Num Capabilities
numeric	numeric
device	device
bad	bad
prec	Prec
arrayexception	Array Exception
black	black
callocarray	calloc Array
utf32	utf32
wait QSem N	wait QSem N
safe	Safe
e	e
readoct	read Oct
newforeignptr_	new Foreign Ptr_
h Set Buffering	h Set Buffering
hprint	h Print
tyconstring	ty Con String
prog	prog
rl#	rl#
char#	Char#
new Chan	new Chan
ord/num	ord/num
a_	a_
pooled Realloc	pooled Realloc
a	a
atomic	atomic
modify MVar Masked_	modify MVar Masked_
encode	encode
Some Exception	Some Exception
tuple	tuple
constr Index	constr Index
peekcstring	peek CString
Src Loc	Src Loc
CInt	CInt
Int#	Int#
or Else	or Else
bounds	bounds
Real Frac	Real Frac
[par Max Bytes Copied]	[par Max Bytes Copied]
exit	exit
kindrep	kindrep
trace Marker	trace Marker
all	all
float#	float#
is Norep Type	is Norep Type
masked	masked
cint	CInt
capabilities	capabilities
Show	Show
h Tell	h Tell
getopt	get Opt
mkchartype	mk Char Type
someexception	someexception
with Pool	with Pool
to Dyn	to Dyn
native	native
part	part
cstringlen	CString Len
delete Firsts By	delete Firsts By
fst	fst
generic1	Generic1
mode	mode
frommaybe	from Maybe
eq	Eq
datatype	datatype
new IORef	new IORef
prelude	Prelude
Block Reason	Block Reason
hash Stable Name	hash Stable Name
is Empty Chan	is Empty Chan
System	System
C	C
stack	Stack
accum	accum
profflags	Prof Flags
lookup Env	lookup Env
modify MVar Masked	modify MVar Masked
numerator	numerator
lift	lift
Pool	Pool
readnonblocking	read Non Blocking
sortby	sort By
quotrem	quot Rem
someexception	Some Exception
src Loc Package	src Loc Package
state#	state#
int16	Int16
reallocarray	realloc Array
new Buffer	new Buffer
srcloc	Src Loc
cdev	CDev
absurd	absurd
permute	Permute
[linker]	[linker]
withcwstring	with CWString
function	Function
eoferrortype	eof Error Type
foldmap	fold Map
CTime	CTime
opt'	opt'
is Already In Use Error Type	is Already In Use Error Type
realfrac	realfrac
quote	quote
not Elem	not Elem
types	types
intersect	intersect
assert	assert
form	for M
nonewlinetranslation	no Newline Translation
throwerrnoifretry_	throw Errno If Retry_
throw If Neg_	throw If Neg_
readprec	readprec
h Duplicate To	h Duplicate To
unregistertimeout	unregister Timeout
interval	interval
set Allocation Counter	set Allocation Counter
h Set Newline Mode	h Set Newline Mode
satisfy	satisfy
Lexeme	Lexeme
atomic Modify IORef	atomic Modify IORef
displayexception	display Exception
Event Manager	Event Manager
All	All
cwstring	CWString
ioerror	ioerror
bimap	bimap
isdoesnotexisterrortype	is Does Not Exist Error Type
ioref	ioref
UTF8	UTF8
tobool	to Bool
throwerrnoifminus1retrymayblock	throw Errno If Minus1Retry May Block
num Capabilities	num Capabilities
addmvarfinalizer	add MVar Finalizer
[versiontags]	[version Tags]
mod'	mod'
decodefloat	decode Float
throw Errno Path If Minus1	throw Errno Path If Minus1
unsafe Foreign Ptr To Ptr	unsafe Foreign Ptr To Ptr
unregister Timeout	unregister Timeout
try Read MVar	try Read MVar
fill	fill
$f_5$	$f_5$
stm	stm
processors	processors
foldl	foldl
mkweakptr	mk Weak Ptr
is Ascii Upper	is Ascii Upper
Conc	Conc
new Foreign Ptr_	new Foreign Ptr_
write List2Chan	write List2Chan
readp	readp
hgetchar	h Get Char
