precondition	operation execute system rejected state
code	files set python upgrading 1 0 handles tensorflow class
forget	network recurrent long cell memory lstm unit short-term
iterator	disk iterator capable numpy abstract yielding iterators directory base image images array reading data class
saver	variables saves savers summaries checkpoint access take provides sequencequeueingstatesaver steps save seconds stateful base every checkpoints input interface class restores n listeners values action
global	layers different temporal wait_until_step max abstract global reaches 2d pooling step delays 1d spatial average operation execution data class 3d
dynamic	tests dynamic rnn learning estimators
cudnn	rnn-tanh rnn-relu gru rnn models cudnnrnn related without creates cudnn underlying benchmarks implementation using lstm model simple input_c
scalar	parent series scalar combine transforms class
entropy	distribution without entropy method normal
looper	runs optionally thread timer code repeatedly
query	return keys outputs reader table responds server sample values bigquery fake tf http requests data example schema
lookup	represents different represent sparse information column persists initializable feature needed lookup embedding steps interface table configuration across defines
decisions	layer inference features hard sampling single decisions paths learns decision hybrid samples test net data training made treats places neural tree embedding model soft
reparameterization	instances sampling reparameterized class represent
nested	(output generating rnn new_state) + cell state 1 input =
inverse	softplus distribution inversegamma concentration rate
chain	bij1 tests bij2 bijectors chain sequence correctness bij3 applies bijector = transformation
graph	helper almost float actions existing names computation stack use takes graph collections class implicit imperative tf tensorflow construction function tests form standard implementing step train every thread-local represented tensors providing quantized dataflow dumps default objects subgraph mode rewrites view
deterministic	real vector deterministic line r^k scalar base distribution distributions class
functions	tests feeding functions
grid2lstmcell	cell 2d receives output input lstm first creates gives
to	layer spacetobatch inference features visitor hard sampling single api batchtospacend pairs decisions paths given learns summarywriter decision ops hybrid forest samples test net summarizes tests batchtospace python combines input-output abstractly objects data protobufs implements training made treats places neural tree spacetobatchnd embedding model soft
init	enum-like request possible callback init session values take action on-session-init response
text	tensorboard text multi-line initializer api file table summaries string tables provides reader test newlines rich outputs registry delimited plugin lines ids summary initializers int64
stochastic	layer sampling observed interface paths learns decision stochastictensor valuetype hybrid classes samples stochastic tensor-like model basestochastictensor objects backed class training tree value base values distribution soft emit
spec	specifies ndim layer set partial eval dtype metric describe organized cluster shape api train infer functions model_fn specification ops maps specify passed tensorflow spec function tests hash returned metricspec buckets use connects possibly objects every key input device strong structure hashing represents "jobs" estimatorspec "tasks", changed list keyed estimator mode model
norm	constrains layer minmaxnorm weight maxnorm dropout recurrent benchmark batch constraint incident weights unit lstm norm hidden normalization
conv2dtranspose	transposed layer convolution sometimes deconvolution 2d called
grid1basic	basicrnn cell 1d basiclstm
string	tables string text ids initializer int64 file table
orthogonal	matrix orthogonal generates initializer
resample	tests outputs runs values resampling expected close
activation	function output activation applies
denied	raised caller run operation permission
saved	protocol builds buffer variables saves savedmodel assets
ndtest	tests spacetobatchnd ops batchtospacend pairs input-output
every	runs given monitors checkpoint callbacks base every execute steps n save class op
bounding	set itemhandler tensors boxes bounding parsed concatenates
rnnrelu	implementation cudnn model rnn-relu
truncated	distribution truncated generates normal initializer
tri	tril square helper/hidden operator done fake linearoperatorderivedclasstest additions matrix acting operatorpd handles tril+vdv multivariate tests normal triangular base class lower like r^k resulting linearoperator distribution [batch]
ref	variable processor
list	mapper container abstracting typed list wrapper fetch callbacks see tuples lists categorical_column_with_vocabulary_list namedtuples immutable
manager	creates training helper restores checkpoint session
large	tests belong run concat_op_test py large tensors
item	specifies function given via item-to-features itemhandler menu class mapping tensors item individual converts text-based parse_example tf navigation parsed history
vector	multivariate vector version student's t-distribution implementation deterministic times r^k scipy n fake input distribution repeats
delegate	division use divide python2/python3 delegation implement tensors
deadline	raised complete could expires deadline operation
pool	tests fractionalavgpoolgrad fractionalmaxpoolgrad
dir	directory set data debug-dump filesystem
rnncell	composed rnn_cells new_state) simple abstract slim +rnn sequentially 1 fused network rnncell + recurrent wrapper cell fusedrnncell state 1d basic input = creates gives basicrnn generating used multiple rnn adaptor object (output grid intersection representing neural cells 2d classes testing receives output first
initializable	interface lookup initializable table
prediction	enum-like makes prediction values model type
initializer	tables given ids string keys values int64 inherit tensors base lookup file initializers table initializer text class
strict1d	test function private
daoptimizer	dual algorithm models averaging sparse adagrad linear
rate	learning exponential transform softplus rate inversegamma scheduler concentration gamma
n	execute hook exception monitors callbacks step base every raises steps n class
pooling2d	layers inputs different e g max abstract global arbitrary layer 2d pooling images spatial average operation data class functions
append	helper docstring private public counterpart subclass promote class
index	files index name symbol list turn _guiderefs guide
length	outputs fixed-length file records reader
sub	tf graph existing subgraph view
diag	square softplus(diag_stddev) simple l matrices operator done linearoperatorderivedclasstest additions !> use diag_stddev cholesky matrix positive + definite acting symmetric 0 handles override = > multivariate tests uv^h normal uu^h diagonal tested base udu^h representing class ==> like multivariatenormaldiag well batch r^k classes resulting linearoperator cannot diag distribution [batch]
sum	series adds two
axes	indices tensor names axis
dropout1d	dropout version 1d spatial
cell	calculation linear-chain computes lstm happens gru network implementation recurrent wrapper cell fusedrnncell basic crf attention ensure device alpha class specific values block
sequential	training_test layers tests sequential py api covered model stack linear
apivisitor	use visitor exactly visit traverse api tf public
template	wrap function sharing variable aid
fractional	tests fractionalavgpoolgrad fractionalmaxpoolgrad
shared	wraps reuse variable scope subnetwork around
lstmblock	network helper implementation cells recurrent cell fusedrnncell provides basic lstm class housekeeping
public	use visitor exactly visit traverse api tf public
metadata	optionally container & observes runoptions hook embedding modifies runmetadata metadata
multivariate	multivariate diag_stddev softplus(diag_stddev) normal simple multivariatenormaldiag well r^k tested base override distribution = class
cropping2d	picture layer e g 2d input cropping
full	tests matrix positive definite wraps [batch] wishart done linearoperator base linearoperatorderivedclasstest distribution matrices class
hash	backing series fast table id out-of-vocabulary assigns perform wrapper tensors version structure mutable spec store tests hash string shardedmutablehashtable keys buckets sharded key implementation mutabledensehashtable using strong class specify keyed generic
tags	python section explicit tag rewrites guide
multinomial	multinomial distribution compound dirichlet-multinomial
hdf5matrix	used hdf5 dataset instead representation array numpy
residual	rnncell ensures added inputs outputs wrapper cell
len	real represents valued features column fixed-length feature parsing length tensor variable input configuration variable-length
cancelled	step cancelled raised operation
feeding	tests feeding feedingqueuerunner runner allows functions queue arrays values numpy
cholesky	!> use cholesky matrix positive + definite symmetric 0 wishart = > @ uv^h uu^h cannot udu^h matrices t; ==> compute positive-diagonal g l x distribution lower-triangular
method	used methods aggregation combine listing gradients class
strong	hash keyed structure key strong spec specify
change	loss tolerance change stops goes
patches	tests extractimagepatches gradient-checking functional op
box	set itemhandler tensors boxes bounding parsed concatenates
search	search returned outputs tests decoding beam finished grid decoder sampling final beamsearch
fetch	definition singleton structured dicts mapper mappers handler ops lists tensors tuples fetches namedtuples interface provided fetch
queue	operations prioritized runner list random implementations feeding implementation holds numpy tests elements run feedingqueuerunner enqueue base class thread dequeues arrays allows queue values order
binomial	distribution binomial negativebinomial
poisson	computation moments taking due large poisson time test distribution
action	test concrete enum-like basedebugwrappersession possible start init session values take implementation action call run()
fourier	implements rffm random feature mapping tensorflow fourier class
navigation	info containing outputs commands item individual navigation scroll history
options	files tfrecord elements return tensor observes optionally & runoptions hook used values manipulating watch_fn highlighting modifies runmetadata type options
iotest	tf operation tests io learn
control	control context calculating helper outputs manage flow mapping states loops maintain base graph caching control_outputs grad class topology
cache	tests manage calculating helper graph cache writers summary summarywritercache file caching control_outputs class
shuffle	queue containing batches shuffled implementation series random creates dequeues single elements order row
projection	adding given projection cell input operator output
tokenizer	text class tokenization utility
slices	given set tensor slices sparse indices representation
chi2with	) chi2 parameter transform df floor(abs =
scaled	member tests like family handles c [batch] scaled acting base done linearoperator linearoperatorderivedclasstest resulting additions = class identity matrix
initialize	cluster clusters initialization initializes waits
boolean	apply boolean mask series
tensorboard	tests http default server without error constructed
fake	multivariate http student's t-distribution implementation writer table plugin summary sample scipy sessionrunhook fake return server data functionality schema
apply	implements wraps matrix simply linearoperator apply [batch]
total	function tests image_ops total_variation()
sgd	gradient stochastic optimizer descent
unit	constrains generates initializer scaling incident without weights unit variance hidden tensors norm
skcompat	tensorflow scikit estimator wrapper learn
use	!> use ==> cholesky + uu^h l uv^h symmetric 0 cannot udu^h = >
or	triggers seconds timer n steps every
helper	inference helper abstract decoders sampling reads directly use adds scheduled inputs tests customize outputs seq2seq implementing base user interface class training allows functions
positive	linearoperatorderivedclasstest tests base done class
chooser	setup training ops variables chooser devices choose device replicated class
two	use two accept subclass parametric types arguments
pdfull	representing positive definite batch matrices class
svsummary	timer save summaries thread
handler	specifies via fetches converts parse_example parsed given cli itemhandler structured responds handler tf function http item-to-features mapping bigquery registry tensors handlers command requests
call	function calls ast visitor tensorflow finds
asset	simple text abstract serialize tensorboard disk summaries provided projector needed asset provides method base registry class assets dummy name plugin allows example
rnnparams	rnn saveableobject implementation handles params variable
scope	object defaults calls track keeps get_variable xla _global_custom_objects current carry depth cannot call provide provides escape variable scope changes previous
leaky	rectified leaky version unit linear
type	represent argument accept one instances index use varied valuetype two subclass class located checker arguments memory test type prediction host base interface sampling problem types compression solves enum-like makes record classes values reparameterized model parametric
grid2grucell	cell 2d receives output input lstm first creates gives
tfdecorator	tensorflow base decorators class
nevals	used run routines n hook times evaluation eval_ops
outputs	control outputs topology
benchmark	operations helper abstract masked_matmul_ops session operation functions slice transpose! interacting normalization provides split! tf new tests used strided registered benchmark running base registry tensorflow fifoqueue class concat case helpers maybe batch reports stuff registrar non-trivial benchmarks automatically
flag	values flags global container accessor
train	tests train mode estimatorspec
robin	round-robin ps task placement index next returns order
unimplemented	raised implemented operation
hints	holds 'is_x' every linearoperator initialized flags
valued	real represents valued features column continuous feature also length variable known
join	tests functions helper
quantized	ceiling representing quantization x distribution =
setup	tests datafeeder setup_predict_data_feeder
overloaded	function encapsulates overloaded _overloadedfunction
labeled	axes tensor annotated
crossed	represents combination conjuction cross also known transformation
install	override headers copied go dir
example	serialized parses transform simple protos asset tensorflow example
def	opdefs corresponding ops graph holds collection add
history	info use scroll records supports item object integration containing callback individual command navigation info_dict keeps lookup commands saved events outputs history
connected2d	2d inputs layer locally-connected
nearest	different make choices separately np tf test round
predict	represents tests setup_predict_data_feeder generic datafeeder prediction output head
correctness	addition combinations tests correctness adders
slim	simple rnn_cells slim wrapper
sample	adding draw outer dimensions possibly way samples new along
abort	run sessionthat n-th call aborts mock
numbers	tests normalizenumberfields()
tab	completion registry tab responses
axis	information label order valid error cases size class axis
normalize	tests normalizenumberfields()
regularization	function layer based activity update cost applies input
end	run on-run-end saves request results summary hook callback evaluation response
classproperty	property class decorator
inheritance	tests sub classes cannot estimator override methods
multiplexer	access eventmultiplexer eventaccumulators manages multiple
get	md title 'get_samples' private file test extract method
feature	feature_engineering_fn rffm parsing sparsefeaturecolumn tensor fixed-length feature variable-length tensorflow tests abstraction mapping input configuration class implements represents column random sparse fourier example
dnncomposable	implements dnn _composablemodel
regression	represents head _targetcolumn linear tests generalized output model regression
hot	relaxedonehotcategorical represents use temperature exprelaxedonehotcategorical column logits deep one-hot distribution networks onehotcategorical
forest	inference train random evaluate combines container monitor decision forests stops forest holding criteria tf net consisting good multiple embedding calculating hyperparameters stop trees base uses data class loss training builds neural request graphs estimator defaults decreasing termination model
renyi	renyi_ratio distributions minimized match show
gate	network recurrent long cell memory lstm unit short-term
csv	test load functions csv
config	specifies stores configurations docs required distributed feature indexes parse estimator lookup sparse run configuration class defines
profile	profile profiling point analyzer table data view
product	@ compute t; g positive-diagonal matrix x = lower-triangular
capture	values captures variable's collection
chi2	chi2 distribution
max	layer weight spatio-temporal global images operation fractionalmaxpoolgrad temporal 1d spatial 3d inputs tests maxnorm max data e g minmaxnorm constraint 2d pooling volumes
after	used run routines n hook times evaluation eval_ops
derived	tests square generic operators derived rectangular appropriate classes base test class
mapping	bijector helper typed make manage mapping class caching easier
collection	meant container proto datacolumns repeated collection sized field mimic iterable
constraint	tests sub classes cannot estimator override methods
mixin	transformer classifiers class mixin estimators regression
lstm2d	convolutional lstm
hasher	function use hash buckets spec structure hashing
data	iterator produced inference decisions maps sparse?, source samples tf meant tests represents rank using feeder loss list convenience soft view series hard learns container tensor decision datafeeder provider net corruption profiling tensors training census column items setup_predict_data_feeder embedding trainer raised minibatches features unrecoverable image dataframe sampling table combines generate decode tensorflow store repeated real-time map_op tensorflowdataframe made places tree reads example layer abstract encountered sample single dask paths functions proto datacolumns hybrid feature field forest test ingesting requested used information collection preprocessing augmentation data class implements treats neural mimic model
parallel	multiple readers class uses reader speed parallel improve
engineering	tests feature_engineering_fn
beam	tests returned outputs finished search decoding beam step decoder sampling final single beamsearch
counter	count training monitor replacing hooks measure patched per number hook second steps module time duration threads counts times time() called sleep()
lines	text multi-line rich
plateau	metric reduce rate stopped learning improving
processor	documents word sequence modelports bytes ids resourcevariables maps streaming sequences variable dense processor
callback	via abstracting simple abstract converts on-the-fly parsed given container itemhandler custom build new function used creating class callbacks base tensors list callback
chief	creates tf chief session
ones	1 initialized tensors generates initializer
block	named describing resnet block tuple
inline	tests correctness bijector custom callables inline constructed
order	tiers addition specified class valid done error test cases order axis
feed	feed runs dicts generator arrays dataframes dictionaries ordereddicts creates accordingly feed_fn feed_dict sets numpy pandas
serving	type return serving_input_receiver_fn
vars	test case variables graph
sigmoid	bijector sigmoid 0]) computes logits probs nn ) + / 1 = transformation tests exp([x bernoulli (1 g correctness -x )^-1 exp x
unauthenticated	credentials authentication valid request
stability	reproducible tests estiamtors
dnnlinear	training linear models dnn joined regressor estimator tensorflow classifier
adadelta	implements optimizer algorithm adadelta
progbar	prints bar stdout metrics callback displays progress
difference	'series another subtracts one
outer	@ compute t; g positive-diagonal matrix x = lower-triangular
monitor	monitors runs used exports monitor stream facilitate class testing given wrapper server callback base every estimator steps n evaluation events
bucketized	bucketized_column represents binning also see known transformation bucketization
ugrnncell	ugrnn network neural recurrent update cell gate
pddiag	tests positive operators definite diagonal batch matrices classes done base representing class
broadcasts	test broadcast shape operator's arguments
lu	linear thresholded rectified version leaky parametric unit
choose	bijector parameters chooses two location one
clusters	cluster clusters initialization initializes waits
split	based provide series mask boolean split! benchmark hash
then	paths combines inference embedding places neural tree decision hard hybrid training forest samples test model soft net treats
non	appropriate (i done linearoperatorderivedclasstest non-negative generic wrapper test tests non-linear sessions operators base class constrains e non-cli) rectangular non-interactive estimator weights debug
return	tril family diag member handles linearoperatorfullmatrix resulting operator additions "handles identity
python	defined summarizes given indicated python visitor object question protobufs indicates builtin regular objects file class
bernoulli	temperature parameters sigmoid bernoulli probs nn distribution relaxedbernoulli = logits
resnet	tests complete resnet v1 v2 small networks
scaling	adapting scale generates capable initializer scaling shape without weights variance tensors
scipy	session minimize wrapper scipy allowing tf operate optimize
aborted	due concurrent aborted action operation typically
mutable	tests hash shardedmutablehashtable generic using tensors backing implementation version sharded table mutabledensehashtable mutable class store
not	raised entity file (e use cholesky raise + directory) 0 fitting = > requested used udu^h class exception ==> g l estimator found
lplus	tril+vdv operatorpd class helper/hidden fake
padding3d	layer zero-padding spatio-temporal spatial data 3d
sampling3d	inputs upsampling layer 3d
pdsqrt	tests vdv^t defined representing + definite batch operatorpd matrices classes done base positive operator a=ss^t, = class
name	division use divide python2/python3 delegation implement tensors
edit	edit recorded fileeditrecorder record done file need changes
fully	layer stacked fully-connected neural feed-forward flattened network
l	tril multivariate lower square like normal additions handles triangular r^k acting resulting linearoperator operator distribution [batch] matrix
xla	calls track xla current depth call keeps scope previous
infer	tests infer estimatorspec mode
merge	generic merge layer elementwise functions
mode	enums suitable names modes reroute's standard graphs imperative mode tensorflow model execution interactive
debug	debugging set debugger stream debugger-related hook single session wrapper tf unit dump concrete implementation send classes basedebugwrappersession tensorflow grpc_debug_server events debug-wrapper tests dumped sessions grpc directory analyzer test running base tfdbg run() data class debug-dump tensor e non-cli) calls concurrent directories dumps non-interactive (i streams filesystem debug
found	requested raised g entity directory) file found (e
classifier	kernel methods api sdca regression binary implementation dnn feature class tensorflow optimizer linear keras models preprocessing mixin using classifiers training scikit-learn joined logistic model classifier
cropping3d	layer g cropping 3d data (e
weighted	see tests weighted_sparse_column nn weighted_moments
experiment	information containing experiment needed train model class
series	map given already applying name parent inputs series cache list results transform single transforms output operate requires class two
grid1lstmcell	cell lstm 1d
hard	paths layer learns inference treats hybrid decision hard tree training sampling samples test model soft
reduce	tests helper metric reduce functions rate stopped learning improving
gaussian	1-centered noise additive gaussian zero-centered multiplicative apply
numeric	see numeric_column
meta	information tensor sparse?, rank map_op store
exceeded	raised complete could expires deadline operation
sdca	sdcafprint dual sdca ascent squared test stochastic type shrink tests optimizer linear models update base class loss solver sessionrunhook smooth hinge weights logistic coordinate model op
operation	node represents computation ops graph list wrapper tensors acting proxy performs operation 'duck-type' class
kfeature	layer made treats places neural soft decision tree data single embedding model decisions net features
extract	tests extractimagepatches gradient-checking functional op
monitors	wraps sessionrunhook monitors tests
out	iterates raised methods support testing stubbing past range valid input operation class unit
predefined	map given already name series cache requires
apichange	api maps describe list changed
container	directed graph acyclic container layers
network	tests complete resnet v1 v2 small networks
space	tests spacetobatch ops batchtospace pairs input-output spacetobatchnd batchtospacend
gradient	function implements tests optimizer descent registering scale_gradient simple gradient proximal algorithm type decorator op
singular	tests singularmonitoredsession hooks initialization object session-like handles restoring
hooked	_wrappedsession tests calls hooks _hookedsession run()
stub	methods stubbing testing class support unit
re	linear thresholded rectified version leaky unit
imperative	graphs graph implementing imperative mode tensorflow execution class
reader	produces file table speed contents newlines tfrecords different readers fixed-length tensors reader tf multiple keys outputs bigquery records step produce uses key using class types improve entire delimited work lines value queued record base values every parallel example
print	prints given n steps every tensors
docstring	helper docstring private public counterpart subclass promote class
highway	rnncell adds wrapper cell connection output input highway
dataset	represents specification dataset
clustering	clustering k-means estimator
linear	shape wraps cholesky 0 defining @ tests represents linearoperators cannot combinations using udu^h loss like tiers l linearoperator done classifier operator[s] kernel square methods regressor specified linearoperatorderivedclasstest sdca scale matrix + squared symmetric acting _composablemodel multivariate non-linear linear uu^h diagonal base x c g column shift k correctness estimator embedding [batch] adders perturb _shape rank one scaled appropriate simply composes operator apply !> use addition needed _shape_tensor type > head operators triangular broadcast ==> compute rectangular classes distribution operator's regression information generic feature lookup arguments test = uv^h optimizer normal [batch derived update preprocessing user class identity of] implements lower r^k model order
barrier	represents key-value map graph persists executions across
timeline	steps tensorflow visualizing timelines execution class
args	represents added session call arguments run()
regularizer	base class regularizer
greedy	ps use task inference helper returns placement op least-loaded
hashed	see categorical_column_with_hash_bucket sparse_column_with_hash_bucket
base	load accumulator bijector useful methods aggregating hierarchy train abstract attentionmechanism initializable accumulates savers debug-wrapper resolving subclass cross-import initializers operator table gradients lookup distributions monitors unit functions monitor numpysource base-class deterministic wrapper properties needed epoch classes functionality types implementations reader test stochastic csv type tensor-like record available tests testing conditional parent keras models evaluate operators diagonal metrics tf running objects every user tfdbg tensorflow interface computation class identity interacting session produce pandassource facilitate scikit-learn step different queue callback base values common baseestimator providing averages emit sklearn
proxy	methods forwards ops object graph's current proxy operation class tensor
bidirectional	bidirectional cell wrapper gridlstm rnns
freq	cell network recurrent long time-frequency memory lstm unit short-term
unnamed	dummy name provided serialize example asset method
generate	files index name symbol list turn _guiderefs guide
training	stores helper variables random sampling reads directly use adds forests forest criteria tf consisting scheduled inputs tests multiple monitoredtrainingsession outputs trees uses container data loss training tree single termination
dirichlet	distribution compound dirichlet dirichlet-multinomial
logging	prints log seconds writes trainable given n steps every variable values local tensors
slice	inference slices gradients shape result operation check index given slice tensor gradient produces custom located memory test new numpy correct tests strided slice's benchmark host variants types varied case compute var^2 non-trivial stridedsliceshapes
thread	count runs code logs thread timer events checkpoint optionally threads repeatedly measure duration steps save summaries
waiter	wait_until_step delays global reaches step execution
balancing	ps task placement returns least-loaded op
luong	implements multiplicative attention luong-style scoring
timer	triggers seconds timer n steps every
round	round-robin ps task placement index next returns order
gfile	wrappers thread locking i/o without file
registrar	registrar abstract used benchmark class
signature	object tensor signature
enqueuer	queue data builds generator
rewriter	takes form graph float quantized rewrites
lambda	wraps object creating callbacks simple arbitrary layer custom callback on-the-fly expression
separable	separable 2d convolution depthwise
already	raised already exists attempted create entity
saving	tests saving rnn state learning estimators
conv1d	layer e convolution g temporal 1d (e
variables	training stores multiple variables random tree forests trees single tf container data consisting
rank	multivariate normal simple well r^k tested base override distribution class
one	relaxedonehotcategorical represents use temperature exprelaxedonehotcategorical column logits deep one-hot distribution networks onehotcategorical
hook	decreasing captures saves results session stops summaries wraps number monitor implementation delays hooks clusters local monitoredsession global ops sessionrunhook) stop runoptions every checkpoints execution loss runs wait_until_step evaluation routines shrink dumps steps debug observes debugger-related initializes second specified sdca summary monitors subclass tensor per goes tolerance profiling run extend seconds step tensors change eval_ops row/col training waits times streams requests prints debugger sweep reaches hook fake cpu/gpu given & accordingly handles counts feed_fn prep optionally (not related sweeps n evaluates modifies runmetadata called cluster information end nan invalid syncreplicasoptimizer feed_dict sessionrunhook grpc_debug_server events used track initialization keeps update run() data calls sets command-line-interface request weights filesystem model
array	feed dictionaries tensor iterator arrays data write-once wrapping yielding creates dynamic-sized per-time-step array numpy class
sheep	replacing module patched time time() sleep()
priority	elements prioritized implementation queue dequeues order
dump	set almost graph dumps step every filesystem directory data tensors debug-dump
categorical	relaxedonehotcategorical represents documents word temperature exprelaxedonehotcategorical categorical categorical_column_with_vocabulary_list variables ids class maps see categorical_column_with_hash_bucket sequences vocabulary distribution feautre logits onehotcategorical categorical_column_with_vocabulary_file
unknown	unknown error
elbo	converges show kl values sampling true
wrapper	rnncell projection helper namedtuple calculation abstract testing session send another operator stream lstm attentionwrapper subclass happens adding given wraps adds monitor concrete implementation test sessions state wrapper cell jit (i provides basic basedebugwrappersession input local highway inputs added keras grpc outputs dropout attention ensures dumps implementing step base particular device sequence-related execution data class non-cli) storing runs e housekeeping object subclasses cells scikit-learn cli xla specific non-interactive connection classes ensure debug-wrapper embedding filesystem debug output facilitate scope
response	on-run-end on-run-start request callback on-session-init response
checkpoint	runs thread seconds saves given timer n checkpoint action epoch every take checkpoints interface steps model save listeners op
checker	given compute tensor gradient tests result var^2 numpy check
zeros	initialized tensors 0 generates initializer
identity	square family initializer scaled done linearoperatorderivedclasstest additions matrix acting member handles reader = transformation tests generates outputs operators base key class identity c compute like g work correctness value queued resulting linearoperator x [batch]
wrapped	_wrappedsession tests around wrapper session tf
final	search end returned hook outputs decoding beam finished session tensors evaluates final
store	named variables number carries variable store
bahdanau	implements bhadanau-style attention additive
tuple	used tuple edit recorded cells fileeditrecorder state_size, state typed output lstm zero_state,
adaptor	adaptor rnncell classes used fusedrnncell
reversed	adaptor fusedrnncell time-reverse
inconvertible	represents tensorproto cannot np converted ndarray
padding	variable-sized padding batching fifoqueue supports tensors
forward	alpha computes linear-chain values crf
pooling3d	layers inputs different e g max abstract global arbitrary spatio-temporal layer functions pooling volumes spatial average operation data class 3d
fprint	tests sdcafprint op
target	binary head _targetcolumn classification single abstraction svms using model regression
tree	function tests random stores builds variables gather_tree tree training graphs single tf inference
zero	picture layer e g zero-padding sequence temporal 2d 1d spatial input data spatio-temporal 3d
headers	override headers copied
csvlogger	results callback epoch streams file csv
interactive	session use suitable e non-cli) sessions contexts wrapper (i non-interactive base imperative mode debug tensorflow shell execution class interactive
pre	given linear runs checkpoint rectified save parametric unit op
register	function used longer registering gradient register divergence kl implementation shape statistics type decorator op
runner	operations tests feeding run thread feedingqueuerunner runner allows holds list queue enqueue values arrays numpy
argument	two use invalid argument accept one subclass receives raised parametric operation types arguments
dask	series dataframe feeder reads dask data
analysis	stats step stores analysis output
concentration	rate transform softplus beta inversegamma concentration concentration0 concentration1 gamma
element	mapper singleton ops fetch tensors
min	weight minmaxnorm constraint
adamax	optimizer adamax section adam 7 paper's
mechanism	attentionmechanism base functionality common providing class
port	streaming processor modelports
centered	computes tests exp([x g sum(exp([x 0]) + (1 correctness bijector / transformation sum(exp )^-1 exp x = -x 0]))
builtin	indicated python object question builtin class
wishart	matrix positive definite wishart distribution matrices
lstmcell	layer basiclstm lstm unit short-term 2d network recurrent long cell 1d memory input phased dropout basic time-frequency grid bidirectional normalization gridlstm creates receives output gives first
indexed	given set tensor slices sparse indices representation
command	cli handlers headers command registry go keeps override lookup supports dir history
optimizer	adadelta ftrl variables pass related computes session proximal specified gradients custom descent gradient rmsprop syncreplicasoptimizer wrapper class handles tf sessionrunhook momentum abstract norm tests optimizer ops interfaces variant update scipy base moving external aggregate adagrad optimize optimizers efficiently implements algorithm minimize average clips synchronize optimization algorithms adam sparse operate updates allowing
trace	generating helper trace format chrome traces class
normal	softplus(diag_stddev) truncated simple initializer entropy loc diag_stddev parameters tensors location override = method multivariate generates normal softplus tested base scale class applied multivariatenormaldiag well r^k without distribution
object	summarizes given python visitor escape _global_custom_objects objects provides cannot scope changes protobufs
hparams	pairs good set defaults calculating hyperparameters name-value base holding hold class
callable	function composable callable simply defers
beta	transform softplus beta concentration1 concentration0 distribution
connected	layer stacked fully-connected neural feed-forward flattened network
adder	used abstract two add base adder fail operators class
multiply	element-wise layer list multiplies inputs
class	multi tests _targetcolumn classification 'head' generic docs operators docstring testclass page appropriate classes square base test collects decorated rectangular derived class
unavailable	raised runtime currently unavailable
dummy	(output generating new_state) + cell state 1 input lstm =
doc	point generating generates title python visitor object __call__ed url holding docs entry main doc's simple struct
average	layer employing variables global computes images operation decay temporal 1d spatial spatio-temporal 3d inputs optimizer maintains moving data e exponential g average list 2d pooling volumes averages
gather	function tests gather_tree
flow	control files set visitor abstract states loops need functions upgrading class 1 0 handles provides series test tensorflow flow function namedtuple tests context ast python mapping base using tensorflowdataframe implements calls list convenience maintain helpers benchmarks grad finds
kl	function implementation register divergence kl decorator
graphs	training inference builds random tree graphs forest tf
exp	tests compute exprelaxedonehotcategorical g correctness exp x distribution = transformation logits temperature
neg	constrains non-negative weights
caching	test caching brokenbijector
scaffold	tests scaffold) scaffold gather commonly pieces needed train invalid (not model create structure subclass
dot	product layer two computes samples tensors dot
event	eventaccumulator protocol logs iterator back accumulates api file event buffers takes generator summarywriter writes access yields events multiple abstractly eventaccumulators class add_events implements thread protos eventmultiplexer yield manages values eventloader
tfrecord	files tfrecords used tfrecord compression record outputs class write records file reader manipulating type options
visitor	function summarizes given generates calls ast python visitor object protobufs __call__ed objects docs tensorflow finds
random	inference moments rffm feature medium computation uniform elements queue implementation due tensors forest test tensorflow random generates normal registered benchmark mapping tf registry initializer class implements training builds dequeues taking tree large graphs time distribution fourier order automatically
scattered	see scattered_embedding_column
dnnestimator	models dnn _head estimator user specified tensorflow
watch	values return type watch_fn
session	operations hooks monitoredsession results session computation cli implementation graph send init tf local arguments tests around grpc possible represents non-cli) enum-like dumps (i debug works _coordinatedsession testing see errors interacting factory subclass provides restoring extend implementing base training creates non-interactive action variables session-like hook unit use helper contains wrapper class checkpoint handles call wrapped tensorflow debug-wrapper shell sessions worker _recoverablesession basedebugwrappersession on-session-init case _wrappedsession made contexts classes values benchmarks subclasses interactive stream certain implementations coordinator information singularmonitoredsession recovery callback recreates take test added kinds initialization object upon running tfdbg run() data response monitoredtrainingsession e calls _hookedsession restores request concrete chief client filesystem
lstm	(output generating 1997 new_state) implementation + - term cell cudnn state 1 unit memory hochreiter input lstm = model long-short
sampling2d	2d inputs upsampling layer
next	sequencequeueingstatesaver deferred stores nextqueuedsequencebatch data
probs	nn sigmoid bernoulli logits = probs
completion	completion registry tab responses
resource	resource exhausted resourcevariables handles dense variable based processor
upgrade	apis changed 1 0 various test
ratio	converges show distributions minimized kl renyi_ratio values sampling true match
reservoir	implements container stream reservoir items deterministic sampling map-to-arrays
title	md extract file title
menu	item menu class text-based
writer	files tfrecords tests cache protocol records writes writer summary write summarywritercache writers file fake class event buffers
distributed	layer slice temporal allows wrapper every input apply
failed	operation execute system rejected state
only	implements wraps matrix simply linearoperator apply [batch]
abs	) chi2 parameter transform studentt softplus df floor(abs scale =
dict	feed mapper dicts produces arrays series dictionaries transform creates ordereddicts dict typed zero-input numpy fetch
ltest	linearoperatorderivedclasstest tests base done class
rich	single-line text multi-line rich
constant	values tensors constant generates initializer
local	temporarily debugger cli implementing local command-line-interface testing allows us concrete something basedebugwrappersession import hook subclasses class wrapper subclass
count	step hook exception raises n
mixture	distribution mixture
handle	represents live session handle tensor
keras	keras implementation scikit-learn regressor api classifier
df	) chi2 parameter transform studentt softplus df floor(abs scale =
compiled	wraps jit xla step scope execution
stop	used run monitor request _check_stop routines stop stops n-th hook step session call times specified wrapped requests n evaluation eval_ops
listener	runs given checkpoint action listeners take interface save op
dropout3d	dropout 3d version spatial
cannot	use ==> cholesky + l uv^h symmetric 0 cannot udu^h = > !>
fifoqueue	operations padding elements variable-sized first-in implementation benchmark order queue dequeues tensors batching fifoqueue supports first-out
svstep	count steps duration threads measure
connected1d	inputs layer locally-connected 1d
feeder	trainer * iterator simple series manage dataframe feeder sample reads dask helper generator datafeeder tf externally-fed tests returning step data class 10 setup_predict_data_feeder feed_fn, graphs plumbing example
mapper	kernel singleton mappers abstract rffm provided dense ops feature class maps tuples tensorflow inputs random definition outputs mapping lists interface namedtuples tensors implements mapper dicts fourier fetch
bar	scrollbar cli vertical curses-based
strided	inference slices shape result gradients operation index given slice tensor gradient produces custom located memory test new numpy correct check strided slice's benchmark host variants types varied case non-trivial stridedsliceshapes
shape	inference methods manage _shape shape stridedsliceshapes operator manipulate abc tensor registering _shape_tensor arguments expected method function thrown used broadcast tensor's test deviates decorator implements represents exception longer linearoperator distribution operator's
factorization	weighted matrix factorization estimator wals using method
summary	cache protocol text saves results hook api tensorboard fake n event buffers summarywriter writes writer summaries writers provides evaluation files tests run abstractly every registry implements plugin summary summarywritercache steps
bad	used implementation concrete test adder basedebugwrappersession fail
crf	alpha computes linear-chain values crf
logistic	loc head scale optimizer classification parameters loss regression binary location logistic test sdca distribution class
activity	function layer based activity update cost applies input
tuner	tuning hyper-parameters experiment interface tuner class
fixed	tensor outputs fixed-length feature parsing records variable-length file reader input configuration
grad	constructing fractionalmaxpoolgrad produces used gradients gradient-checking index varied gradient graph custom located state fractionalavgpoolgrad memory test correct tests extractimagepatches strided slice's host types compute var^2 loop op
view	profiling subgraph graph list wrapper existing tf table data immutable view
sdcaestimator	optimizer linear models sdca base estimator using class
proximal	implements optimizer descent algorithm gradient proximal adagrad
reference	markdown links replacing references @{ } class
creator	worker factory creates chief session tf
bucket	implements container stream reservoir items sampling
frame	implements represents functions container tensorflow column feature dataframe produced convenience preprocessing using ingesting data tensorflowdataframe
testing	methods stubbing testing class support unit
regressor	tensorflow training dnn linear keras implementation optimization scikit-learn regressor class underlying models joined api solve mixin sdca using model regression estimators
module	collects page module docs
maximum	inputs layer stores element-wise within list maximum allocation timelne computes given allocator
observed	stochastictensor observed value
recurrent2d	convolutional layers abstract recurrent base class
stack	default graph thread-local implicit objects defaults providing stack
lrucache	storing used last tensor cache lru
affine	@ tests scale compute g shift + correctness x = transformation
stats	statistics stores analysis step output operator stats holder
tensor	wsgi axes visitor random tensorproto shape session conforming monitor 0 stochastic local spec cls namedtuple tests handle represents python evaluate stop test cannot every using loss sparsetensors list convenience steps nan sparse per-time-step sparsetensor set methods series observed operation monitors tensor stochastictensor ast stops current track provides tensor-like basestochastictensor seconds wrapping base backed tensors training estimator helpers signature grouping finds prints debugger forwards one tensorboard table given annotated itemhandler live returns class handles basic tensorflow files outputs train tensorflowdataframe arrays value n converted values benchmarks distribution emit function objects abstract dumped single initializers need lifetime parsed functions upgrading 1 application internal dynamic-sized forest np keys object is_instance tfdbg graph's ndarray implements calls write-once request decreasing visualizations
udvhupdate	perturb k update rank broadcast shape arguments test operator's linearoperator
cumsum	test function private
definite	linearoperatorderivedclasstest tests base done class
label	multi-label head classification
symmetric	linearoperatorderivedclasstest tests base done class
state	storing saving constructing states learning estimators loops attentionwrapper saved gradient graph access state provides sequencequeueingstatesaver input kutta namedtuple tests used rnn runge mapping stateful solver maintain values grad loop
phased	cell lstm recurrent phased network
masking	tests used sequence skip mask search masks eos beam value masking using timesteps
import	temporarily allows us something import class
geometric	geometric distribution
formatter	generating helper trace format chrome traces class
concatenate	inputs layer list concatenates
lazy	building lazily optimizer transformations mainly avoid variant module large handles pulling adam sparse dependancies caching import model efficiently updates
queueing	stateful access values provides sequencequeueingstatesaver input
relative	loss tolerance change stops goes
buckets	assigns keys buckets wrapper table id out-of-vocabulary string
attention	storing rnncell attentionmechanism another attentionwrapper scoring wraps additive wrapper cell state functionality luong-style basic namedtuple attention base class implements bhadanau-style common multiplicative providing
transpose	transpose! benchmark
analyzer	profiling dump directories analyzer debug data
conv3dtranspose	transposed layer convolution sometimes deconvolution called 3d
key	given keys metric tensors initializers values key table strings
multiplier	dnn_model_fn tests
interface	represent implementations session table different wrapper class client lookup tf algorithms across sessions interfaces scipy external base tensorflow optimize minimize persists optimization steps operate allowing
monitored	monitoredtrainingsession tests object singularmonitoredsession recovery hooks initialization monitoredsession session-like handles see restoring
optional	type optional
problem	solves enum-like values problem type model
cli	node command-line-interface stepper backend
c	simple models cudnnrnn without input_c
gmm	clustering mixture gmm gaussian estimator tensorflow model class
elboforms	control calculation elbo constants
plugin	simple text abstract serialize api tensorboard disk summaries provided projector needed functionality asset provides test method base registry class assets dummy name plugin allows summary embedding example
fitted	exception used raise fitting estimator class
adapter	wraps sessionrunhook monitors
declare	function tensorflow declares
softplus	bijector softplus(diag_stddev) log[1 computes concentration diag_stddev ) + transform floor(abs concentration1 concentration0 = transformation tests normal df studentt beta inversegamma scale ] applied exponential g multivariatenormaldiag correctness rate softplus exp x laplace gamma
plus1rnncell	(output generating rnn new_state) + cell state 1 input =
embedding	inference helper sampling see container operator integers scattered_embedding_column size adding given adds positive indexes cell needed lookup input metadata scheduled tests information use dense represents training column turns vectors embedding dnn_model_fn fixed
receiver	type return serving_input_receiver_fn
variance	adapting scale capable initializer shape weights tensors
whole	entire outputs value file reader contents
conv2d	separable layer e convolution g depthwise 2d spatial images
load	load ps functions task placement graph variables case returns op test csv least-loaded
and	tril family diag member handles linearoperatorfullmatrix resulting operator additions "handles identity
markdown	md extract file title
saveable	rnn saveableobject implementation handles params variable
simple	fed http fully-connected default error back server without tests input output constructed rnn
evaluable	e experiment g evaluatable objects interface
sweep	row/col runs ops track sweeps sweep keeps prep
loader	event iterator protos bytes avoid mainly module loader large yields individual pulling lazily file dependancies import loads eventloader
dimensional	(output generating new_state) + cell state 1 input lstm =
pdcholesky	representing positive definite batch matrices class
grublock	cell implementation gru block
projector	embedding projector plugin needed registry provides assets
assertions	get testcase mix proto2 googletest assertions class
learning	tests saving learning dynamic state rate scheduler estimators rnn
table	backing text initializable initializer mutabledensehashtable file table id out-of-vocabulary assigns tables generic wrapper tensors version lookup mutable store tests profiling hash string shardedmutablehashtable keys buckets base sharded interface using data class ids implementation initializers int64 view
vdvtlightweight	tril+vdv operatorpd class helper/hidden fake
fused	rnncell time-reverse used fused rnn adaptor abstract object cell fusedrnncell classes implementation lstm representing
raise	step hook exception raises n
second	triggers seconds timer n steps every
union	sum type
keys	use modes sparse_column_with_keys graph metric standard see collections names key model strings
py	simple md guide file parsing
strategy	round-robin ps task placement index representing next order returns export model op type class least-loaded
defined	function definition _definedfunction encapsulates properties
reduction	loss reduction types
optimizable	interface variables abstracting optimizers
glstmcell	cell g-lstm lstm group
combined	training tests run linear ops models all-reduce dnn joined one regressor mix session call estimator using tensorflow classifier
pd	tril+vdv matrix helper/hidden positive definite operatorpd wishart fake distribution matrices class
basic	layer network dropout recurrent sampling cell decoder normalization basic lstm unit rnn
numpy	feed iterator produces column data ordereddicts dictionaries yielding transform creates arrays single dict series array zero-input numpy
location	bijector parameters chooses two location one
supervisor	training helper models computes checkpoints summaries
dropout	1-centered adding given noise inputs outputs dropout gaussian cell multiplicative applies operator input apply
integerized	sparse_column_with_integerized_feature see
worker	creates tf session worker
seq2seq	tests sequence-to-sequence
rnnbenchmark	models cudnn lstm related benchmarks
assert	tests assertprotoequal()
composable	building implements abc blocks linear function create composable used estimators _composablemodel regression
external	interfaces optimization algorithms external base class
func	function functions helper track registered py remove keep construction _py_funcs class
coordinated	tests coordinator tf session wrapped works _coordinatedsession
case	case tests feeding string comparator feedingqueuerunner functions need base python3-compatible test tensorflow class
multi	composed _targetcolumn classification new_state) simple head learning lstm operation sequentially 1 'head' implementation + acting wrapper tensors cell state tests objective input = generating multiple rnn (output multi-label class multi cells multi-output list 'duck-type'
sdcalogistic	binary optimizer classifier logistic using sdca regression
grid3lstmcell	creates output basiclstm first cell receives input 2d gives 3d
exponential	employing exponential decay variables maintains transform softplus rate moving distribution averages
rnntanh	implementation cudnn model rnn-tanh
batch	layer spacetobatch stores series abstract single transforms batchtospacend specified szegedy size {un containing batches shuffled 'c' 't' test ops &'e' org/abs/1502 select batching 2014 row columns vec batch_ops tests http parent batchtospace 03167 benchmark input-output sequencequeueingstatesaver spacetobatchnd }batch ioffe //arxiv data class normalization pairs batch creates deferred broadcasting nextqueuedsequencebatch rank2+
value	adding draw outer dimensions keys way valuetype given possibly classes values samples table interface new along initializers tensors
profiler	information profiling seconds captures n every steps cpu/gpu
accumulator	eventaccumulator takes generator aggregating conditional accumulates accumulator values sparse gradients event
while	construct loop context
gumbel	loc scale parameters scalar gumbel location distribution
error	system gone raised already exists exhausted argument entity past internal shape load() deadline directory file operation implemented action axis fails raise generic unknown create currently authentication invalid loss directory) fitting valid *permanently* expected tensorflow (e corruption requested unrecoverable used run complete permission attempted expires execute rejected tensor's step state experiences deviates aborted found credentials cases execution data class unavailable thrown iterates exception resource input g concurrent typecheck could caller request range estimator encountered due receives error cancelled failures runtime typically order
stopping	training monitored stop stopped improving quantity
partitioned	variable objects container partitioned
guide	files index name md simple symbol list parsing turn _guiderefs file guide
loop	used constructing gradient graph state loop
real	real represents valued features column continuous feature also length variable known
layer	layer features point abstract hard sampling single lstm decisions unit layers paths learns network graph decision recurrent hybrid data test used blocks fully-connected models dropout base feed-forward flattened class normalization building made stacked treats neural tree entry soft
conv	convolutional layers layer used convolution implementation abstract recurrent nd private base lstm class
coupled	network recurrent long cell memory lstm unit short-term
kernel	kernel dense kernel-based mapper generic outputs abstract feature preprocessing class methods maps inputs estimator using classifier linear
vdvtupdate	tests vdv^t defined + operatorpd base done operator a=ss^t, = class
metric	functions metricspec metric connects key model strings
cluster	specifies represents set run organized "tasks", distributed cluster class "jobs" configurations
conc	implements network specifications tensor concatenation
cond	conditional construct context
io	files write methods read / exposes fileio class
in	pandassource numpysource abstract class parent
fn	feed dicts runs dataframes return returned model_fn ops arrays numpy generator dictionaries ordereddicts creates accordingly input_fn feed_fn feed_dict sets type pandas
cleanup	function helper registered remove _py_funcs class
avg	tests fractionalavgpoolgrad
id	tables file ids int64 string keys text assigns feature wrapper initializer lookup sparse buckets table configuration id out-of-vocabulary defines
binary	binary head _targetcolumn parent classification series two class scalar svm combine transforms logistic svms using operate regression
descent	implements optimizer descent algorithm gradient proximal
proto	objects defined visitor tensorproto indicates assertions file given proto class mix np summarizes get python object proto2 googletest protobufs ndarray represents testcase converted cannot
reshape	certain mapping reshapes shape another output class utility
recurrent	layers recurrent abstract base class
stepper	node debugger command-line-interface stepper tfdbg tensorflow backend
defun	tensorflow functions used decorator define
sqrt	operator implements sqrt_solve
grpc	stream grpc debugger-related send hook session streams wrapper debug grpc_debug_server data events
arguments	represents information column needed lookup embedding
runge	kutta state saved runge solver
twith	scale df studentt softplus ) floor(abs =
composition	function tests linearoperators one base done composes linearoperatorderivedclasstest composition class
interpolation	different make choices separately np tf test round
kutta	kutta state saved runge solver
sampling1d	inputs upsampling layer 1d
context	control information made provides session conditional flow construct base call context run() class loop
padding2d	picture layer e zero-padding g 2d input
checkpointed	implementation custom checkpointing op
reporting	maybe stuff benchmark reports
uniform	high generates parameters uniform scaling without low variance distribution initializer tensors
aggregation	used methods aggregation combine listing gradients class
allocation	given stores within maximum allocation timelne allocator
moving	employing optimizer exponential decay variables maintains computes moving averages average
student	) multivariate vector version student's t-distribution implementation floor(abs softplus studentt r^k df scipy scale fake =
walsmatrix	weighted matrix factorization estimator wals using method
densify	dense transforms sparse tensor
normalization	layer http 03167 batch org/abs/1502 normalization ioffe 2014 //arxiv szegedy
synthetic	test synthetic generation dataset
byte	documents sequence bytes ids loader maps individual file loads
builder	building protocol builds buffer variables saves handles transformations savers savedmodel base caching model class assets
opearator	test broadcast shape operator's arguments
solve	operator implements sqrt_solve solve
fnops	tests multi-output
format	used calls api enum list valid formats output
sharded	tests shardedmutablehashtable version sharded mutabledensehashtable class
model	multi-output protocol modelports variables saves streaming dual estimators sdca ascent regression returned defines evaluation adds abc model_fn & create dnn hybrid buffer epoch test stochastic save type implements tests used optimizer linear ops models blocks savedmodel base connected container class assets building loss training _composablemodel builds solver fully routines coordinate every model processor mnist
dimension	represents tensorshape dimension value one
recoverable	tests errors kinds certain upon _recoverablesession session wrapped recreates
nadam	nesterov optimizer adam
scheduler	rate scheduler learning
moments	tests weighted_moments nn
nan	loss training tensor nan stops monitors monitor
sdcaoptimizer	sdca optimizer class wrapper
actions	graph tests train actions
detail	simple function details class contain
dropout2d	2d dropout version spatial
unicode	test case string python3-compatible comparator
permute	given dimensions pattern according permutes input
divide	division use divide python2/python3 delegation implement tensors
transformer	another information transformer "contains transformations subgraph needed defined summarywriter abstractly transform one api featurecolumn handles implements result mixin estimators operation class
adagrad	implements optimizer dual algorithm models averaging proximal sparse adagrad linear
staging	ordering inputs guarantees staging class
classification	represents head classification output
generator	feed minibatches point visitor image back queue add_events generator class main numpy generating generates python docs object augmentation real-time data generate builds dicts arrays dictionaries yield creates __call__ed entry
source	produces series abstract dataframe single arrays array numpysource transform tensors source dict reader tf zero-input numpy parent keys using data class census column pandassource values
add	inputs layer adds family tril diag list member handles linearoperatorfullmatrix resulting operator additions "handles identity
internal	raised internal experiences system error
transformed	inputs applying transformeddistribution series allows results transform list transformed conditioning distribution intrinsic
board	wsgi conforming application tensorboard basic visualizations spec
samples	test 'get_samples' method private
dtype	represents elements type tensor
input	specifies ndim layer projection point simple dtype recordinput randomly shape input_fn wrapper serving_input_receiver_fn operator lstm asynchronously unit short-term adding given network graph recurrent long cell memory input type used return tfrecords models object every sequence-related storing input_c cudnnrnn reads without yields entry
logger	prints logs thread stdout accumulates metrics callback epoch averages events
save	checkpoint runs save given op
momentum	implements optimizer algorithm momentum
elu	unit linear exponential
scheduled	scheduled training adds helper outputs sampling directly
tests	simple function tests scale_gradient
rnn	back crf time-reverse rnn fusedrnncell implementation input linear-chain alpha fed output creates cudnn computes underlying values adaptor using model fully-connected
ops	batch_ops {un tests return returned model_fn ops end sequence-to-sequence hook input_fn session }batch evaluates type tensors
read	dense processor resourcevariables
big	return keys outputs reader table responds server sample values bigquery fake tf http requests data example schema
lron	metric reduce rate stopped learning improving
early	training monitored stop stopped improving quantity
grid	search network gridlstm recurrent tests long cell grid memory bidirectional lstm unit short-term
resolver	markdown links replacing references @{ } class
intersection	network neural recurrent +rnn cell intersection
lstmstate	used tuple state_size, cells state output lstm zero_state,
loss	raised unrecoverable request random encountered sdca monitor squared stops forest goes criteria test tolerance corruption optimizer linear stop uses data class change loss training nan smooth hinge logistic decreasing termination
like	tensor is_instance internal cls grouping sparsetensor
nascell	search network neural recurrent cell nas architecture
server	use in-process return default distributed error table training server sample without tests fake http constructed data tensorflow schema
t	multivariate vector version student's t-distribution implementation r^k scipy fake
sparse	features aggregating conditional rank parsing see gradients sparsefeaturecolumn information tensor categorical itemhandler sparse?, feature accumulator also lookup input sparse_column_with_hash_bucket defines store tests known map_op configuration represents sparsetensors column sparse_column_with_vocabulary_file sparse_column_with_keys weighted_sparse_column sparse sparse_column_with_integerized_feature example
output	projection helper manage head sampling api directly operator operation control_outputs regression adding given adds classification generic graph wrapper decoding cell acting valid tensors final scheduled tests used returned calculating outputs enum search prediction beam finished served class represents training calls multi-output list formats caching output model 'duck-type'
soft	paths layer learns hybrid decision tree training sampling samples model soft
page	function docs module page collects class
clidebug	cli implementing command-line-interface subclass concrete basedebugwrappersession local hook debugger
clipping	optimizer variables update wrapper clips specified norm
upgrader	files set python upgrading 1 0 handles tensorflow class
sequence	storing stores tensor sequence typed object stateful feature wrapper parsing access deferred variable-length values provides input sequencequeueingstatesaver sequence-related configuration data nextqueuedsequencebatch
concat	tests belong run concat_op_test py benchmark large tensors concat
tfexample	tensorflow examples decoder
conditional	bijector transformeddistribution parameters aggregating supports conditional allows local accumulator latents conditioning sparse distribution intrinsic gradients
some	registered benchmark registry automatically
library	opdefs corresponding ops graph holds collection add
streaming	trainer iterator modelports feeder streaming reads tf data processor
exporter	serving package exporter helps tensorflow model
export	represents exports monitor served representing n steps estimator export output every model type class
flatten	size input batch flattens affect
svtimer	checkpoint timer thread
pdidentity	tests r^k: base done x operator ax = class identity
exists	raised already exists attempted create entity
udvhupdatetest	!> use ==> cholesky 0 = + uu^h l uv^h symmetric operator base cannot test udu^h type >
tmp	data transformer temporary
scale	function applied tests diag_stddev softplus(diag_stddev) scale_gradient simple floor(abs multivariatenormaldiag ) studentt softplus df scale normal = laplace
dense	kernel layer backing abstract represented table dense tensor nn generic tensors maps version mutable store inputs tests hash shardedmutablehashtable represents outputs regular sharded mutabledensehashtable using class mapper densely-connected column resourcevariables implementation processor
for	wraps rnn support testing stubbing wrapper class cell sessionrunhook subclasses monitors unit methods
replicas	optimizer ops syncreplicasoptimizer related synchronize handles sessionrunhook pass aggregate gradients class
datum	profile tensor point dumped single tfdbg tensorflow data debugger
padding1d	layer e g zero-padding sequence temporal 1d input
tracker	track lifetime internal class tensor
select	'c' 't' rank2+ &'e' broadcasting vec test select
provider	requested source items list maps data tensors
recorder	need record changes file done
conv3d	layer e convolution g volumes spatial 3d (e
softmax	tests exp([x g sum(exp([x 0])) correctness bijector / 0]) computes sum(exp exp x = transformation
noise	apply zero-centered noise additive gaussian
run	specifies debugging observes monitoredsession results hook session monitors information wraps start contains response on-run-end call take provides test values arguments added run extend optionally on-run-start possible runoptions concurrent run() class represents made calls enum-like & request callback estimator sessionrunhook action modifies runmetadata configurations
pdbase	representing positive definite batch matrices class
power	c)**(1 tests * compute g power + (1 correctness c / c), -1 x = transformation >=
sparsify	dense transforms sparse tensor
deleted	thrown directory load() *permanently* gone
broken	forward inverse inverses
step	stores hooks global number reaches hook second analysis specified counts times stats monitor delays per tests seconds stop training beam step every execution search triggers wait_until_step request single timer n steps output requests called
percentile	different make choices separately np tf test round
variation	function tests image_ops total_variation()
rnnestimator	tests saving rnn dynamic state learning estimators
chrome	generating helper trace format chrome traces class
on	on-run-end start enum-like on-run-start request possible callback init session values take action call run() on-session-init response
ftrl	implements ftrl optimizer algorithm
census	source census data
idx	implements function specifications network identity
concurrent	debugging calls concurrent session test run()
column	meant _targetcolumn features classification mimic tests deep cross produced variable see bucketized_column networks scattered_embedding_column sparsefeaturecolumn binary use categorical_column_with_hash_bucket tensor conjuction categorical datacolumns feature regression also sparse_column_with_hash_bucket transformation categorical_column_with_vocabulary_file real field head abstraction sparse combination continuous binning collection one-hot repeated dataframe svms known using feautre represented represents valued numeric_column column categorical_column_with_vocabulary_list proto single sparse_column_with_vocabulary_file sparse_column_with_keys length weighted_sparse_column embedding sparse_column_with_integerized_feature model bucketization
of	iterates tiers addition raised past range valid done specified test input operation order
queued	sequencequeueingstatesaver deferred stores nextqueuedsequencebatch data
hinge	loss optimizer smooth hinge test sdca class
addition	tests adders addition correctness tiers test done specified combinations order
range	iterates raised past range valid input operation
estimator	kernel-based objects abstract random tests cross-import specified returned methods cannot sub model_fn generic dnn trainer/evaluator classes forest passed basic override tensorflow infer available head linear ops models evaluate baseestimator train user eval class estimatorspec training joined estimator mode model sklearn
plus	multivariate normal simple well r^k tested base override distribution class
sync	optimizer ops syncreplicasoptimizer related synchronize handles sessionrunhook pass aggregate gradients class
flattened	layer stacked fully-connected neural feed-forward flattened network
permission	raised caller run operation permission
invert	tests bij invert correctness bijector inverts another = transformation
gamma	medium moments taking due softplus rate inversegamma computation time test distribution concentration gamma
op	raised py graph operator corresponding select fails statistics 'c' 't' generic rank2+ belong &'e' custom state vec test tensorflow tests run per-op ops error precompute/validate collection opdefs execution holder tensors like checkpointing would holds concat_op_test large implementation broadcasting add op
bijector	bijector chain allows conditional log[1 sample base-class inverses constructed bij1 bij3 bij2 transformations invertible intrinsic + / )^-1 forward = -x @ tests bij power (1 brokenbijector test scale conditioning inline interface ] properties inverse g shift correctness transformation sum(exp exp caching x distribution invert
locally	2d inputs layer locally-connected 1d
eval	tests eval estimatorspec mode
curses	info containing cursesui actual command-line outputs commands subclass manipulations terminal ui bypasses curses-based navigation scroll mock history
image	tests minibatches tensor itemhandler gradient-checking image extractimagepatches functional parsed augmentation decodes real-time data generate op
kmeans	clustering benchmarks graph creates estimator base k-means class
negative	distribution negativebinomial
device	rnncell partial calculation variables operator replicated happens ensures specification chooser cell choose tensorflow ops training possibly particular device class represents runs setup devices specific ensure
square	tests ==> cholesky square generic test + use l rectangular 0 appropriate base done operators linearoperatorderivedclasstest udu^h = class >
sdcalinear	linear optimization underlying solve using sdca model regression
operator	helper/hidden wraps cholesky c 0 defining @ tests linearoperators cannot combinations udu^h matrices like l linearoperator simply operator[s] square methods composes specified linearoperatorderivedclasstest abc matrix r^k: + definite symmetric acting method tril+vdv multivariate linear uu^h diagonal base x tiers g shift k correctness [batch] adders perturb _shape rank one scaled appropriate done fake operator apply !> use addition positive wrapper _shape_tensor type > operators triangular representing ==> compute batch rectangular classes distribution sqrt_solve defined ax vdv^t generic operatorpd wishart test = uv^h normal [batch derived update scale a=ss^t, class identity of] implements lower r^k solve order
cropping1d	layer e g sequence temporal 1d input cropping
readline	bypasses command-line readlineui subclass manipulations terminal ui readline-based test
dnnregressor	models tensorflow dnn regressor
nsession	session run sessionthat stops n-th _check_stop call aborts wrapped mock
statistics	function statistics registering type decorator op
compression	record type compression
area	ordering inputs guarantees staging class
rmsprop	implements rmsprop optimizer algorithm
maskedmatmul	benchmark masked_matmul_ops
transform	>= correctness abstract c)**(1 scalar transforms parent + * two / combine series batching = transformation function namedtuple tests power (1 class c compute g list c), -1 x operate
fast	wrappers hash thread perform series locking fast i/o without file
custom	custom cannot optimizer customize abstract allows tests sampling base user provides escape scope _global_custom_objects changes class
start	start enum-like request on-run-start possible callback values take action call run()
low	multivariate normal simple well r^k tested base override distribution class
dumping	debugger wrapper dumps hook session filesystem debug data
var	real represents valued features column feature parsing length variable input configuration variable-length
function	_overloadedfunction simple computation collects _definedfunction graph feature_engineering_fn wrapper class details encapsulates function tests python docs composable regular properties definition runs overloaded contain page
head	classification single learning multi-label regression binary 'head' implementation generalized objective checks head head_ops linear head/top interface using class multi svm whether logistic model called
trainable	e experiment g writes trainable n variable objects values steps interface every log
complete	tests complete resnet v1 v2 small networks
pdderived	tests classes derived
wsgiapp	conforming application wsgi spec tensorboard
relaxed	relaxedonehotcategorical temperature exprelaxedonehotcategorical parameters distribution relaxedbernoulli logits
memory	pandassource numpysource abstract class parent
failure	exceptions certain helper tolerating
construction	tests http default server without error constructed
decoder	abstract sampling examples returned decoding decode basic tensorflow final beamsearch used rnn outputs object beam finished decoder interface data class search provider
line	delimited file text reader lines rich outputs single-line newlines
with	softplus(diag_stddev) divide sigmoid assigns probs delegation rate table sdca concentration id out-of-vocabulary !> logits separately different diag_stddev cholesky nn test make python2/python3 squared transform wrapper tensors 0 np concentration1 concentration0 = hinge division optimizer linear normal keys bernoulli buckets use tf beta inversegamma scale udu^h class string applied loss ==> exponential laplace multivariatenormaldiag smooth l choices softplus cannot logistic + implement > round gamma
info	simple module initializer result collects operation information transformer struct would title holds transform state holding function used temporary per-op "contains docs precompute/validate functions data class info like url partition doc's page
calls	debugging head head_ops calls whether called concurrent session test run() checks
default	default graph thread-local implicit objects defaults providing stack
smooth	loss optimizer smooth hinge test sdca class
up	inputs layer 2d upsampling 1d 3d
record	tfrecords recordinput outputs fixed-length randomly records reads yields file reader asynchronously
walsmodel	alternating weighted matrix least factorization model squares
ui	cursesui actual tfdbg command-line readlineui subclass manipulations terminal interface base ui user readline-based test bypasses curses-based class mock
highlight	elements highlighting options tensor
distribution	probability hierarchy resolving abstract manage shape manipulate parameters generic intrinsic subclass needed transformed supports ceiling base conditioning representing class transformeddistribution local = allows latents quantization x distribution
laplace	applied loc scale parameters softplus location distribution laplace
partition	info functions used partition holds initializer
ordered	feed produces arrays series dictionaries transform creates ordereddicts dict zero-input numpy
exhausted	exhausted resource
request	http on-run-end on-run-start request bigquery callback responds requests on-session-init
abstract	batching abstract class parent transforms
parser	md stores simple docs parses required transform parsing parse serialized protos file example tensorflow indexes guide
deep	represents information column needed lookup embedding
watcher	load paths wraps sequence directorywatcher loader
coordinator	coordinator threads
single	use head/top argument accept one single subclass interface model parametric types
replica	training ops setup devices choose replicated class
at	sessionthat saves results hook session raises specified n monitor stops n-th call aborts wrapped evaluation mock run stop step _check_stop exception request summary requests
file	protocol methods iterator defined fileeditrecorder reader initializer exposes indicates see protos done file need table event buffers tables proto writes cache recorded / write read writers fileio contents text yields categorical_column_with_vocabulary_file files string python outputs object generated regular class entire edit ids value summary record initializers int64 changes eventloader
check	whether head head_ops checks called
coder	shape mapping class another utility
gru	gru implementation recurrent - al cho cudnn gated et model unit
nn	inference simple hard paths combines baseline decision hybrid forest samples test net feed-forward network training treats places neural tree embedding model soft
no	case use ==> cholesky normal graph + uu^h l uv^h symmetric 0 without entropy cannot test variables distribution = method >
hybrid	layers building blocks models hybrid model defines
thresholded	rectified thresholded unit linear
invalid	thrown exception scaffold) hook sessionrunhook) scaffold raised invalid argument tensor's shape deviates receives (not expected operation subclass
l1l2	regularization l1 l2 regularizer
tolerator	exceptions certain helper tolerating
other	simple example asset
tfoptimizer	optimizers tensorflow class wrapper native
spatial	dropout 2d version 1d spatial 3d
test	image_ops chain show moments text monitoredsession dynamic actions log[1 shape session stridedsliceshapes computation estiamtors python3-compatible gradient-checking networks synthetic {un feeding extractimagepatches implementation graph base-class feature_engineering_fn &'e' 0 summarywritercache vec tf covered unit -x match batch_ops @ tests bij rnn ops (1 resnet test cannot grid combinations using variants one string loss runs normalizenumberfields() strided tiers correct separately )^-1 index mode logistic small x round _coordinatedsession square methods fractionalmaxpoolgrad generation concat_op_test testing estimatorspec located slice specified linearoperatorderivedclasstest sdca operation rectangular monitors bij1 'get_samples' bij3 scale shardedmutablehashtable gradient + datafeeder squared / cell state sequential various caching masking reproducible method training_test non-linear run linear power batchtospace derived feedingqueuerunner step base eval basedebugwrappersession transformation search total_variation() g concurrent shift taking changed correctness host sum(exp hinge estimator rank2+ op load bijector spacetobatch saving adders slices simple variables private sampling running appropriate api done learning estimators pairs custom select sparsefeaturecolumn properties 'c' addition dnn_model_fn invert py due wrapper sequence-to-sequence renyi_ratio without call override expected tensorflow type summary scaffold function assertprotoequal() complete apis outputs operators slice's benchmark testclass _hookedsession _recoverablesession tested train true case _wrappedsession comparator default multi-output smooth weighted_moments choices classes values resampling error server subclasses debugging setup_predict_data_feeder helper sdcafprint functions single medium reports close need gradients distributions regression constructed different singularmonitoredsession varied nn 't' generic large make belong stuff converges 1 mix brokenbijector fractionalavgpoolgrad http np csv = infer memory used optimizer tensors inference produces gather_tree docstring minimized input-output v1 v2 bij2 }batch tfdbg decorated run() ] class types sub monitoredtrainingsession calls beam maybe all-reduce well kl eos concrete broadcasting exp time dataset inline model order
pandas	feed dataframes produces series dictionaries transform dataframe creates zero-input pandas
mock	cursesui actual readlineui subclass manipulations terminal test bypasses mock
node	node layers debugger command-line-interface stepper two connectivity describes tfdbg tensorflow backend
dnnclassifier	models tensorflow dnn classifier
repeat	input times repeats n
csvparser	parses csv lines transform file
vocabulary	documents word vocabulary categorical categorical_column_with_vocabulary_list variables ids sparse_column_with_vocabulary_file maps see sequences class categorical_column_with_vocabulary_file
update	weights python section explicit update shrink tag sessionrunhook sdca model rewrites guide
bundle	test case variables graph
cpp	tests spacetobatch ops batchtospace pairs input-output
generated	defined object python indicates generated file class
grucell	org/abs/1406 http 1078) recurrent cell (cf gated //arxiv unit
pooling1d	layers inputs different temporal max abstract global layer pooling 1d arbitrary average operation data class functions
registry	completion functions saving cli helper handlers track registered py provides objects command registry tab keep class responses
grid2basic	basicrnn cell basiclstm 2d receives output input first creates gives
variable	named abstracting captures variables get_variable number high device see specified carry container to} provide chooser wrapper handles overview scope variable's norm @{$variables$variables optimizer object update collection objects variable based optimizers resource partitioned level resourcevariables clips carries dense values store defaults interface processor
decorated	test decorated class
rnnno	simple models cudnnrnn without input_c
matrix	tests matrix linearoperatorfullmatrix wraps [batch] base done linearoperator linearoperatorderivedclasstest resulting additions "handles class
clidebugger	testing subclasses class wrapper
svm	binary head _targetcolumn classification support machine vector svms using model svm
remote	callback used events stream server
algorithm	clustering mixture gaussian tensorflow model class
values	global container contains results session values flags run() accessor
interval	represents interval end value start
mask	based provide series mask boolean apply hash
tbplugin	extend plugin every tensorboard interface class must
eos	tests used search eos beam masking
weights	update shrink weights sdca model sessionrunhook
adam	implements optimizer algorithm variant handles adam sparse efficiently updates
time	cell time-reverse slice network adaptor temporal recurrent allows layer long time-frequency fusedrnncell every wrapper memory apply lstm input unit short-term
directory	load paths wraps disk gone iterator capable directorywatcher sequence loader directory load() *permanently* images reading thrown
reroute	enums reroute's mode
validation	runs given n estimator every steps evaluation
scroll	scrollbar cli vertical curses-based
once	step hook exception raises n
