event	function prevent operation event detect support :class buttons start state internal call wheel used schedule object drag :func change represents task default filter future (used loop otherwise
default	default prevent wheel event
owbinned	case like don't continuous binned gradients legend
selection	selection items scene manager heatmap select using rows rectangle
owaction	plot methods attribute qaction :obj calling callback convenience setting
pannable	view pannable graphics
text	qgraphicswidget set managed simple text displayed manages elided canvas layout additional support subclass label handler new scheme defining widget wrapping qgraphicssimpletextitem graphics annotation resize alowing interaction plain list item qgraphicstextitem placeholdertext property
random	set features randomforest random regressor instances selection pythagorean wrap speed use selected feature returns forest input selects take return skltreeadapter trees selector optimized data k classifier
dynamic	available property fit space binding dynamically qobject's :class subclass buttons (this setting done dynamic fixed resizes tool qtoolbar size
feature	descriptors handler filters context
owplot	user plot functions elements qt qwidgets interaction create contains framework base uses common graphics orange plots configuration interface class view
manager	selection storage dynamic manager rows service tip system owwidget instance heatmap :clas scheme passwords handle tool class widgetsscheme signal keyring propagation runtime
disc	discretize variables none
preprocessor	set list call preprocessors apply data store
unconnected	plot series straight lines item unconnected shows
randomize	and/or construct randomization classes preprocessor attributes metas
marker	marker text displays plot
duplicated	already duplicates link another scheme present
pixmap	pixmaps widget cross two fading
indicator	ends equals return point class :class indicator value linkitem 1 0 visual base link item specified variable anchor otherwise
layout	alowing sizehint layout always stacked wrapping widget general current item handles qgraphicssimpletextitem allowing graphics position qgraphicsitem managed qgraphicslayout
signal	scheme handle description instance signal propagation manager widgetsscheme :clas output input runtime channel
title	bold title text symbol - item font legend displayed shows
menu	menumage list searching actions instances filtering container quickmenu menu :class pages tabbed widgets supporting widget popup showing stack menupage item quick page
bordered	containing b letters string paints and/or l data item r delegate specified borderrole border sides
source	source anchor item
window	widget rounded corners positioning supported :class system window qsizegrip basic frameless windowing automatically
score	python objects subclass standarditem
fade	pixmaps widget cross two fading
preprocess	generic base preprocessor class
input	input description channel
circle	item circle plot legend displays
has	known rows return class value
transformation	individual transformations simple variables derived base class
rectangle	plot selection items scene item select using rectangle shows
resizer	control widget object able qsplitter instance size
grip	:class qsizegrip positioning automatically
owconfusion	confusion widget matrix
string	given string whether variables list value strings subfilter values accepted checks
constructor	descriptors handler filters context
owcurve	represents curve class plot
bound	property abstract base class bindings
listener	buttons used support object filter start drag detect operation event otherwise
beam	remember far alternatives thus number rule beam found fixed best monitor
grid	populates widget draws plot tool use containing buttons item actions/buttons grid onto
shared	different compute_value variables parts specific base computation separates shared class
report	widget adds class report-related methods
shadow	widget around geometry frame drop :class effect (works qfocusframe) another shadow similar drawing contents
color	item indicator base class
entropy	discretization minimize recursively inferred splitting values class-entropy bins
splitter	control widget object able qsplitter instance size
execute	function represents task schedule (used :class :func call event loop
pearson	generic coefficient pearson's rank correlation
bar	available widget bar fit space tabs tool :class subclass buttons (this setting done tab using fixed resizes dynamically qtoolbar size
qt	widget qt qstandarditemmodel containing wrapper qobject instance widgetregistry interface widgets class discovery
settings	status context dialog settings handler it's filters list value item setting presenting key entries settings/defaults model type along descriptors user
edit	set links :class displayed actions instances lineedit qgraphicsscene anchors adding additional support editlinksdialog two subclass buttons instance editor schemenode nodes scheme defining channel node widget used multiple dialog graphics using line editing info edit button qgraphicstextitem text placeholdertext linkeditwidget representation property ~
button	button selected :class number class buttons item time tab contain checkable lineedit one toolbox
drop	widget around geometry frame drop :class effect (works qfocusframe) another shadow similar drawing contents
list	set simple text variables apply initialized displaying given subclass call preprocessors checks store widget qlistview accepted data whether list value subfilter values strings
remove	domain set constant features missing unknown removes remove construct unused removing values preprocessor contain threshold data class features/classes examples
methodinvoke	object's thread create wrapper qobject invokes asynchronously method
item	managed background text displayed standarditem displaying row layout title :class source circle main image string python connects responding grid listening press qgraphicsitem represents like l item delegate qgraphicssimpletextitem view square used displays specified borderrole initialized event canvas and/or matrix 'currentitem user selected subclass body widget component wrapping objects nodeitem\s proxy key based selectable legend qgraphicslayout central column items filter qicon flattened sink filtering letters point simple variables one use probabilities support two class handles preview function anchors continuous part link graphics distance b tree linkitem r paints anchor left/right general moves border containing - regions qstandarditemmodel internal input/output events node qlistview symbol disable moving allowing position improving data sides alowing entry curve nodeitem model
softmax	regularized l2 softmax classifier regression
arrow	interaction create handler arrow new scheme annotation resize
quick	category popup menu buttons widgets quick toolbar
output	output description channel
registry	category widget container qstandarditemmodel containing wrapper qobject instance descriptions widgetregistry widgets
page	supporting widget menumage item menu showing :class searching actions quickmenu list filtering page
view	key simple tree variables initialized displaying event pannable canvas 'currentitem contains :class handles subclass iconmode functionality wanting events qgraphicsview qlistview wrapping use moving zoomable listening graphics press class anchorable responding zooming items list filter item display view
status	quickhelptipevent object qstatustipevent promotes whatsthis using property
domain	widget features discretizes settings format continuous component specific select context variable types editing data columns
collapsible	smaller collapse overrides :class subclass header qdockwidget instead close button size
mdl	discretization minimize recursively inferred splitting values class-entropy bins
discrete	class whose given handling instances matches variables indicator value one discrete values rule selects subfilter rules
mahalanobis	distance mahalanobis
frame	widget around geometry drop :class effect (works qfocusframe) another shadow similar drawing
owopen	functions old particulary opengl deprecated 1 3 lot x removed
viz	mosaic dialog vizrank
meta	classes meta scikit-learn class wrapper
lines	plot series straight lines item unconnected shows
value	variables standarditem instances individual computation specified check different compute_value subclass parts shared return python given base separates data class subfilters column value specific objects values
context	widget settings format specific select context columns
message	message scheme displayed user view
best	exceed set builds top feature selector either threshold new given data consisting k features
linear	qlistview ridge linear regularized wrapping k list item iconmode l2 regression view
category	category buttons widget description toolbar
index	index help links provide html page
canvas	canvas help dock zooming widget view :class scene actions instance handles graphics quick toolbox scheme displaying ~
scale	scale scales remains preprocessor distribution data
stats	plot given statistics compute show needed pair attributes store
skl	distance use skltreeadapter generic tree randomforest scikit-learn trees instances sklear take wrap adapter pythagorean
glrenderer	functions old particulary opengl deprecated 1 3 lot x removed
incompatible	channels source compatible sink types
gradient	gradient widget
learner	generate relevant ordered features classification list random prediction regularized set value polynomial custom speed regression k ridge fit learner inducer construct unordered majority returns forest forward induction either return linear descendants rules naive constructs trees regressor optimized base bayes response class cn2 algorithm default always average tree rule discrete cn2sd l2 softmax pruning learn attributes model works classifier frequent
tooltip	tip tool dynamic manager
label	widget plain support label text elided
state	represents selected :class number one buttons state internal time contain checkable future class change
heatmap	selection scene manager heatmap graphics widgets rows
dendrogram	widget displaying dendrogram graphics
provider	index help links provide html page
new	selection text existing menu create selected two handler nodeanchoritem new nodes node release link user annotation present interaction connection drags arrow quick
row	attributes group row
evaluation	clustering evaluation
discovery	widget qt runner base interface class discovery
body	body nodeitem part central
clustering	clustering evaluation
widget	qgraphicswidget smaller orientation links tabs frame matches around cross populates header manager manages notify owwidget tab widgetregistry close runner qobject displaying fading contents size category containing container grids events menu description :class two subclass stack buttons instance qdockwidget dendrogram qwidget widgets instead nodes scheme qtwidgetregistry shows pixmaps widget wrapper collapse qstandarditemmodel tool effect descriptions class base grid actions graphics interface using shadow editing pages layout box bar qt relayout overrides drop simple drawing item qgraphicstextitem model discovery widgettoolbox button ~
welcome	widget beginner series welcome startup shown actions buttons presenting choose
defaults	orange :class property binding setting
guardian	less rules cover required - number minimum examples discard
screen	screen splash widget
executor	tasks thread threadexceuter object running provides interface class pool
owdiscrete	discrete legend
update	items selection_changed method calls
cn2learner	used cn2 extend classic rules constructs learner inducer rule list base algorithms ordered induction
base	widget used cn2 parameters extend editing learner rule annotations base algorithms preprocessor's scheme induction class
proxy	function used based items variables labels list filter filtering proxy model names
key	responding listening 'currentitem :class class filter qlistview moving key press events event
path	qgraphicsobject implementing similar interface subclass
freq	discretization number approximately equal instances data bins
standard	qstandarditemmodel support internal improving moves row
legend	case widget square don't title gradient text class continuous - discrete one item binned base gradients entry circle legend displayed like
toolbar	category buttons toolbar
topology	scheme error topology general
box	box model widget grids qtwidgetregistry button :class containing actions item tab toolbox widgettoolbox tool shows
anchorable	anchorable use items subclass base wanting class view
search	heuristics developed guided alternatives number covers instances best given monitor space better rules empty maneuver towards far thus beam base search remember algorithm solution rule found implement fixed starting
interaction	handlers interaction base class user
owlegend	represents bold point text symbol title :obj item owplot font legend shows
thread	task thread threadexceuter started transfer object class instance running used threads pool provides tasks qthreadpool interface 'depot' special
column	column attributes group
items	items selection_changed method calls
adapter	use skltreeadapter randomforest tree trees instances sklear take wrap adapter pythagorean
changed	represents :class state internal future change
equal	discretization widths number approximately equal instances fixed data bins
classifier	rule custom instances following induction classifier
filter	filtering variables labels one instances individual names filters check whose given based selected selects subfilter match function used string matches continuous disable proxy accepted data class regular subfilters whether items list value checks filter discrete base values model expression strings
map	distance matrix image regions user selectable
dialog	choose widget beginner links series welcome startup shown actions buttons item previewitem user dialog selecting settings/defaults editing presenting
graph	models visualization graphical tree
action	selection links editlinksdialog scene existing instances select menu create selected :class two nodeanchoritem schemenode new nodes rectangle node multiple release link user using present edit items connection drags quick
attributes	widget settings format specific select context columns
mean	fit average value response class returns model regression
sink	already item connected sink anchor channel
discretize	discretize discretization features discretizer continuous construct preprocessor preprocess editor
discretization	classes discretization abstract base class
features	exceed set builds selects top random feature selector returns either input threshold new selected given data consisting k features
point	control indicator point :class canvas annotations nodeanchoritem anchor
simple	managed classification simple text random regressor speed regression layout learner list forest widget wrapping trees optimized qgraphicssimpletextitem graphics alowing tree item classifier
variables	qlistview simple variables subclass initialized displaying
pie	added classification tree item piechart graphics corner nodes
scene	selection_changed used calls :class qgraphicsscene scene tree items instance heatmap uses linkeditwidget graphics widgets scheme displaying method ~
rank	mosaic dialog vizrank
down	given rules developed rule instances base covers starting empty
variable	filtering based variables labels list proxy model names
square	item square legend
polynomial	features prediction learn polynomial model generate
navigator	up/ responding listening completions 'currentitem enable qlineedit :class class filter qlistview moving key navigate press events installed event posible
custom	set cn2 rules list inducer rule custom unordered instances construct following ordered induction classifier either
owpalette	defined changed constants without
select	exceed set features random threshold select given top selected feature returns input selects method columns widget format selector new data selection_changed builds calls settings items k consisting specific either context
size	:class qsizegrip positioning automatically
regex	whether filter regular values expression checks match
plot	color font plot functions silhouette - handler call widget collection boxes grid set_data draws here's calls fills signal settings list widget's onto
width	discretization widths number equal fixed bins
probabilities	probabilities displays background class
chi	plot given statistics compute show needed pair attributes store
top	given rules developed rule instances base covers starting empty
sequence	re-orderable widgets list
depot	task thread started transfer instance used threads qthreadpool 'depot' special
wrapper	layout wrapping scikit-learn wrapper item classes meta allowing graphics managed qgraphicsitem class
strategy	given rules developed rule instances base covers starting empty
start	buttons used support object filter start drag detect operation event otherwise
splash	screen splash widget
call	function represents task schedule (used :class :func call event loop
mosaic	mosaic dialog vizrank
widgets	containing widgetsscheme managed instance signal widgets manager widgetssignalmanager orange scheme
annotation	canvas interaction text create class item handler annotations arrow new scheme base annotation resize
scheme	managed text general instances containing would create :class two subclass qobject instance editor schemenode orange scheme annotations node widget workflow class instantiation widgets base link cycle editing representing annotation topology info widgetssignalmanager arrow error ~
type	channels source compatible sink types
is	undefined instances values data check select
editor	discretize widget parameters component variable base editor preprocess preprocessor's editing types
sort	function used based items filter filtering proxy model
normalizer	given return self value, - value transformed normalized variable (value
nclasses	set missing removes construct preprocessor data class examples
on	items selection_changed method calls
cn2sdunordered	set rules constructs inducer cn2sd unordered
handler	widget context settings descriptors format specific handler columns filters select
huntress	implementation algorithm experimental cn2-r
continuous	case handling like don't rules variables continuous rule legend item binned numeric gradients class subfilter
selector	single condition rule define
owtree	visualization graphical algorithm models tree forward pruning
slider	slider line movable
bayes	default naive discrete bayes attributes works classifier
part	column attributes group row
link	already point duplicates existing instances another indicator create :class two nodeanchoritem schemenode new nodes main node ends instantiation component canvas connects visual link user present scheme curve linkitem item connection drags release nodeitem\s anchor
zoomable	view zoomable graphics
cycle	create scheme link would cycle
graphics	qgraphicswidget set managed pannable simple text displayed general manages notify qgraphicsscene displaying use layout additional contains :class subclass handles qicon functionality wanting defining events qgraphicsview widget tree wrapping implementing qgraphicssimpletextitem uses zoomable graphics interface qgraphicsitem qgraphicslayout alowing anchorable selection_changed calls relayout list method item qgraphicstextitem placeholdertext items qgraphicsobject position property similar display view
line	adding widget edit button support :class movable actions buttons slider line lineedit
completer	up/ enable qlineedit completions navigate installed filter key event posible
resize	available interaction fit space text dynamically setting :class tool subclass buttons (this handler done qtoolbar arrow fixed resizes annotation resize size
owcontinuous	continuous legend
info	info widget scheme editor
distance	coefficient distance matrix generic mahalanobis image scikit-learn spearman's rank regions user correlation selectable pearson's
none	discretize variables none
preview	previewitem scheme recent/premade selecting item selection dialog items model preview browser
compute	different compute_value variables parts specific base computation separates shared class
discretizer	bin index transformer features discretizes continuous given value returns data
prevent	default prevent wheel event
tree	treenode classification list actions qgraphicsscene regression containing contains learner functionality sklear presentation qgraphicsview corresponding models use trees base flattened proxy like column adapter tree item uses model listview display view
promoter	quickhelptipevent object qstatustipevent promotes whatsthis using property
future	represents provides futurewatcher qt's convenient :class signals instance future asynchronous result computation interface using class
impute	imputer construct missing imputation values preprocessor table data
error	compatible already present another would duplicates create general channels source link sink cycle error types connected scheme channel topology
indicator1	indicator return equals value 1 -1 specified variable otherwise
property	qt's qobject's binding abstract object :class system registered setting meta base dynamic orange bindings property class
matrix	confusion widget matrix
anchor	indicator anchors left/right point widget input/output :class ends rectangular source visual link sink item linkitem nodeanchoritem anchor channel
browser	selection scheme preview recent/premade browser
control	control canvas annotations point
spearman	generic coefficient spearman's rank correlation
constant	given set constant features classification removes value returns values construct model data class preprocessor
owtoolbar	buttons container number toolbar contain
links	node widget used multiple linkeditwidget links edit editlinksdialog representation graphics :class two instances dialog schemenode using nodes editing qgraphicsscene channel anchors
defined	undefined instances values data check select
flow	re-orderable widgets list
abstract	property abstract base class bindings
binding	qt's qobject's binding registered object :class system dynamic setting meta orange property class
cn2unordered	rules set unordered construct
vertex	code abstraction buffer vbo vertex understanding objects simplifying thin usage warning
watcher	qt's futurewatcher convenient :class signals instance future provides interface using class
gui	rectangle distances qt's show text labels displayed symbols colors rendered tooltip constants corner label rotation false >= adding indicator symbols. calculate refers instance graphicsitemss coordinates whether axis=0 axis=1 subsection impute=true transformation columns maximal move string combination format transform. kind scene color1 color0 new report integer qgraphicsitem height animation. beginning name instances parameter sizes list zoom xbottom discrete convenience common indices x parameter. "...") view specifies upper domain right transform sequence numeric maximum resized tip second elements result specified duration rectangular instance's special provided shown scale stats matrix space qwidgets section axes increased uniform current self.variable iterable replaced method minimal widget parent whose {:.3} len otherwise reported projection add for. set_data interface toggleselection along configuration optional valid change transformations box unique interaction zoom_transform triggers column items k location separator usually retain 1000 gl_stream_draw suffix point color omitted variables symbolic number marked (including header iterations wrap table array total select size plot use rows clip area render. create contains predictions unspecified pixels width describes ndarray expected gpu 250 type :attr 4 pattern. line lower volume usage ints addselection, true, translation given true viewport must case distance none default needed replaceselection value n qitemselectionmodel.selectionflags considered paragraph values sent str widget's z overrides perspective discretize constant e.g. item final attribute total_min argument vertices bindings. :data primitives removeselection, distributions id axis vertical miliseconds functions end mouse make booleans nan point. majority ortho pair fourth instead = added description index camera symbol vertex palette coordinate yleft user characters variable horizontal data class "s" lookups gl_line_strip third minimize curve correspond points used specifying gl_points position model first starting + left
tab	widget bar tabs tool :class buttons item tab using toolbox button
regression	ridge linear k regression regularized l2 softmax classifier
normalize	normalization preprocessor construct features
ncolumns	domain features unknown remove values contain threshold data
silhouette	plot widget silhouette
polygon	plot polygon item filled empty shows
suggest	supporting widget filtering item searching quickmenu menumage
tip	quickhelptipevent object qstatustipevent promotes whatsthis using property
cross	pixmaps widget cross two fading
same	given return column value instances specified data
cn2sdlearner	ordered rules list constructs inducer cn2sd
oriented	box layout orientation simple matches qwidget
majority	always classifier majority returns class frequent
html	index help links provide html page
lookup	(self transform according discrete lookup) lookup variable table
forest	use pythagorean skltreeadapter randomforest random regressor trees instances optimized forest wrap speed classifier take
runnable	functions task plain :class running threadexecuter qrunnable
frameless	widget rounded corners supported system window basic frameless windowing
wheel	default prevent wheel event
naive	default naive discrete bayes attributes works classifier
channel	compatible indicator already rectangular channels source connected sink types anchor channel
node	body left/right selection treenode links editlinksdialog instances corresponding canvas menu create selected :class two input/output schemenode scheme channel node widget multiple anchors models trees part user nodeitem using present central edit tree item base quick representation
credential	passwords service storage keyring system class
owbutton	signal custom state button changes tool
description	category widget action/function description
buffer	code abstraction buffer vbo vertex understanding objects simplifying thin usage warning
paged	container instances tabbed menupage :class
object	qgraphicsobject implementing similar interface subclass
tool	help grids dynamically actions populates (this done tab qtoolbar size containing fit space :class subclass buttons setting presentation qtwidgetregistry shows available widget tool canvas dock grid toolbox box listview like widgettoolbox button list item actions/buttons quick model fixed resizes
chart	added classification tree item piechart graphics corner nodes
class	known rows return class value
drag	buttons used support object filter start drag detect operation event otherwise
disable	function used based filtering items selected filter disable proxy model
flattened	containing like column tree item flattened proxy model view
user	binding message it's :class setting orange scheme type status displayed base user key entries settings/defaults along class interaction handlers settings list value item presenting dialog model property view
cur	decomposition cur parameters matrix
delegate	containing b letters string paints and/or l data item r delegate specified borderrole border sides
container	selected number one buttons time contain checkable class
owbox	functions calls fills list signal - boxes handler call set_data widget's here's
stack	widget stacked menu sizehint pages current always layout stack
identity	untransformed c return value
icon	qlistview list :class item iconmode qicon wrapping graphics displaying view
task	task thread started transfer threadexecuter :class instance running used threads qthreadpool 'depot' special qrunnable
algorithm	maneuver search towards heuristics remember algorithm space far alternatives guided thus solution rule number better beam found implement fixed best monitor
dock	canvas smaller collapse dock help overrides :class widget subclass header qdockwidget actions instead quick close toolbox button size
fitter	multiple target learner one variable handle types
values	conjunction based features valuefilter derived :obj instances individual values filters disjunction data check select
sq	plot given statistics compute show needed pair attributes store
interval	interval continuous rule ranges values class
curve	displays plot polygon curve straight rectangle component linkitem :class item link empty series unconnected circle main lines filled shows
controller	using controller sequenceflow displaying/editing qabstractitemmodel
rule	represent relevant ordered reference tree numeric instances single set unordered indicator implementation learner inducer construct custom induction return parent descendants rules continuous ranges base class handling cn2 algorithm taking interval list rule keep discrete values either following classifier experimental cn2-r
theme	color font collection settings
lrsvalidator	ratio calculate significance statistic test likelihood
owplot3d	opengl rendering behind base uses platform orange plots class 3d
validator	less rules cover required - number minimum examples discard
na	domain set features missing unknown removes remove construct values preprocessor contain threshold data class examples
model	status filtering classification list variables labels names moves regression row given based it's support internal response returns setting preview type function used qstandarditemmodel containing flattened user key entries improving along class like settings column items average tree value filter item presenting model view proxy
