getuid	getuid
object	object
haystack	haystack
erfc	erfc
__fpending	
mktemp	mktemp
delete	delete
ntop	ntop
_alignof	
wcpncpy	wcpncpy
obstack_chunk_size	chunk
argv	argv
groups	groups
getservbyname	getservbyname
fsetlocking	fsetlocking
sysv_signal	sysv
getservbyport	getservbyport
csqrt	csqrt
printf	printf
nl	nl
getumask	getumask
cnd_broadcast	cnd
create	create
putchar	putchar
text	text
sync	sync
long	long
memptr	memptr
_noreturn	
__ppc_set_ppr_low	ppr
fputwc_unlocked	fputwc
scalb	scalb
endutent	endutent
format	format
catclose	catclose
atomic_thread_fence	fence
__fsetlocking	fsetlocking
get_nprocs_conf	nprocs
fetch	fetch
response	response
htonl	htonl
sched_getaffinity	getaffinity
inet_aton	aton
thrd_current	thrd
how	how
shm_open	open
initgroups	initgroups
_tolower	tolower
fwrite_unlocked	unlocked
__ppc_set_ppr_med_high	med
set_constraint_handler_s	set
mkdtemp	mkdtemp
isupper	isupper
erand48_r	r
inet_ntop	inet
wcstoul	wcstoul
a2	a2
s2	s2
delimiter	delimiter
__ppc_mdoio	mdoio
fildes	fildes
timespec_get	timespec
hypot	hypot
boundary	boundary
sec	sec
argz_count	argz
atomic_flag_test_and_set	set
cexp	cexp
getc	getc
wmemset	wmemset
jrand48_r	jrand48
strsignal	strsignal
seed48_r	seed48
ecb_crypt	ecb
state	state
wcscmp	wcscmp
complex_i	complex
med	med
offsetof	offsetof
towupper	towupper
register_printf_function	printf
obstack_free	free
exchange	exchange
isdigit	isdigit
muntrace	muntrace
strtoimax	strtoimax
xor	xor
errnum	errnum
fmax	fmax
categories	categories
opt	opt
writev	writev
fseek	fseek
execv	execv
strfry	strfry
normal	normal
fgetws_unlocked	unlocked
islnk	islnk
ntp_gettime	gettime
atomic_fetch_sub	sub
s_ischr	s
pthread_setspecific	pthread
fstat	fstat
isalnum	isalnum
__ppc_mdoom	mdoom
arg0	arg0
new_size	new_size
setjmp	setjmp
nrand48	nrand48
fread_unlocked	fread
aligned_alloc	alloc
gethostbyname2	gethostbyname2
tanh	tanh
indextoname	indextoname
sched_setparam	setparam
aio_write64	write64
or	or
fsync	fsync
fopencookie	fopencookie
tocode	tocode
tmpnam	tmpnam
mmap	mmap
__fpending	fpending
i	i
s_isdir	isdir
asin	asin
obstack_printf	obstack
_exit	exit
aio_write64	aio
fwprintf	fwprintf
argz_create	create
fabs	fabs
gettime	gettime
tmpnam_r	tmpnam
getpwnam	getpwnam
unlockpt	unlockpt
hasmntopt	hasmntopt
rlp	rlp
cp	cp
env	env
__ppc_set_ppr_low	low
dependency	dependency
mtx_lock	lock
creal	creal
vlist	vlist
timex	timex
pos	pos
timelocal	timelocal
fputc_unlocked	fputc
fseeko64	fseeko64
origin	origin
cos	cos
fgetwc_unlocked	unlocked
clocks_per_sec	sec
getprotoent	getprotoent
argz_add_sep	add
command	command
per	per
sincos	sincos
fgetws_unlocked	fgetws
cpu_clr	clr
cmplx	cmplx
aio_suspend64	suspend64
fseeko	fseeko
quick_exit	quick
iconv_close	iconv
fstat64	fstat64
netshort	netshort
envz_merge	envz
locale	locale
getwc_unlocked	getwc
_alignas	alignas
setkey_r	setkey
getfsent	getfsent
adjtimex	adjtimex
exit_status	status
wmemchr	wmemchr
buflen	buflen
imaginary	imaginary
parse_printf_format	parse
static_assert	assert
blocks	blocks
argz_insert	insert
aio_init	init
srandom	srandom
getrlimit64	getrlimit64
inet_lnaof	lnaof
cnd_wait	wait
msgid2	msgid2
atomic_fetch_sub	atomic
algorithm	algorithm
filename_s	filename_s
posix_memalign	memalign
getpwent_r	r
port	port
obstack_blank_fast	blank
getutxline	getutxline
dngettext	dngettext
stty	stty
pthread_key_create	key
compiled	compiled
ifindex	ifindex
_	_
aio_fsync64	fsync64
iftodt	iftodt
mbsinit	mbsinit
inet_addr	addr
strchr	strchr
versionsort	versionsort
getopt	getopt
vfprintf	vfprintf
salt	salt
regfree	regfree
cnd_init	cnd
putchar_unlocked	putchar
obstack_copy0	copy0
s_isreg	isreg
s_isblk	isblk
__fpurge	
obstack_chunk_size	size
vsscanf	vsscanf
exponent	exponent
pthread_key_delete	delete
aio_read64	aio
fpending	fpending
duration	duration
backtrace_symbols_fd	fd
ap	ap
nexttoward	nexttoward
getmntent	getmntent
userp	userp
m	m
alloc	alloc
argp_usage	argp
thrd_current	current
inet_addr	inet
drand48	drand48
getwchar	getwchar
getpwuid	getpwuid
shm_unlink	shm
math	math
edflag	edflag
mnt	mnt
timedwait	timedwait
memccpy	memccpy
sinh	sinh
open	open
cbrt	cbrt
va_arg	arg
wstring	wstring
host	host
resolved	resolved
desired	desired
wcsnlen	wcsnlen
tailptr	tailptr
ch	ch
pthread_key_create	pthread
p	p
funlockfile	funlockfile
inet_netof	netof
getutid_r	r
srandom_r	srandom
fgets	fgets
isfinite	isfinite
argz_stringify	stringify
argz_insert	argz
aio_error64	error64
abort	abort
sigblock	sigblock
hcreate	hcreate
execlp	execlp
argz_append	append
attr	attr
result_buf	result_buf
pclose	pclose
readv	readv
realloc	realloc
csin	csin
argp_state_help	argp
dgettext	dgettext
mmap64	mmap64
iswpunct	iswpunct
lstat	lstat
static	static
info	info
ucp	ucp
read	read
msgid1	msgid1
pgid	pgid
ctime_r	r
aio_error	error
vsyslog	vsyslog
fputws_unlocked	fputws
__freading	freading
getgid	getgid
nl_langinfo	langinfo
raise	raise
getlogin	getlogin
clearerr	clearerr
execl	execl
div	div
wcsncmp	wcsncmp
islower	islower
termp	termp
crypt	crypt
snprintf	snprintf
s_isreg	s
remaining	remaining
strsep	strsep
wcntrl	wcntrl
bcopy	bcopy
mremap	mremap
lrand48_r	lrand48
cd	cd
pathconf	pathconf
atomic_signal_fence	fence
perror	perror
va_copy	va
strtok	strtok
argp_failure	failure
inet_aton	inet
cfsetospeed	cfsetospeed
sched_getaffinity	sched
strtoull	strtoull
ppr	ppr
breakset	breakset
thr	thr
argtypes	argtypes
envz_merge	merge
excepts	excepts
ecvt_r	r
siginterrupt	siginterrupt
fallocate	fallocate
argz_add_sep	sep
strerror	strerror
setlinebuf	setlinebuf
wcstombs	wcstombs
pow	pow
posix_fallocate64	posix
memcmp	memcmp
initstate	initstate
alpha	alpha
niceval	niceval
atomic_init	init
getpwnam_r	getpwnam
errors	errors
iswupper	iswupper
pointer	pointer
error	error
buf_len	buf_len
string_ptr	string_ptr
digit	digit
setmntent	setmntent
multibyte	multibyte
sigprocmask	sigprocmask
ntohs	ntohs
qfcvt	qfcvt
log10	log10
va_end	va
new_length	new_length
extract	extract
sched_get_priority_max	priority
old	old
tcgetattr	tcgetattr
getgrnam_r	getgrnam
ngettext	ngettext
lower	lower
__freading	
hostshort	hostshort
atomic_flag	flag
sched	sched
delta	delta
fromcode	fromcode
random_r	r
listen	listen
obstack_finish	obstack
printf_size_info	info
io-functions	io-functions
setscheduler	setscheduler
ifname	ifname
tptr	tptr
longopts	longopts
netlong	netlong
vfwprintf	vfwprintf
oucp	oucp
posix_fallocate64	fallocate64
tcsetattr	tcsetattr
localtime_r	r
sysv_signal	signal
clr	clr
status-ptr	status-ptr
iconv_open	open
shm_unlink	unlink
freading	freading
getattr	getattr
ntohl	ntohl
a64l	a64l
cpow	cpow
des_setparity	des
memrchr	memrchr
aligned	aligned
**)	**)
fgetpos	fgetpos
ccos	ccos
args	args
core	core
strcpy	strcpy
fp_categories	fp
style	style
wcstol	wcstol
printf_size	printf
updwtmp	updwtmp
ccosh	ccosh
fence	fence
globfree64	globfree64
cnd_timedwait	timedwait
iptr	iptr
catalog_desc	catalog_desc
tmpnam_r	r
fputwc	fputwc
tan	tan
cpu_clr	cpu
feof_unlocked	unlocked
iconv_open	iconv
atomic_load	atomic
ftw	ftw
getscheduler	getscheduler
l64a	l64a
child	child
fgetgrent_r	fgetgrent
time_point	time_point
wcschr	wcschr
atomic_flag_test_and_set	flag
tss_dtor_iterations	iterations
thread_local	thread
envz2	envz2
openlog	openlog
bufsz	bufsz
strdup	strdup
inet_pton	inet
mbrlen	mbrlen
system	system
s_islnk	s
sinx	sinx
symlink	symlink
lround	lround
lseek	lseek
sleep	sleep
puts	puts
memfrob	memfrob
hdestroy	hdestroy
gethostbyaddr_r	gethostbyaddr
obstack_finish	finish
iterations	iterations
grow	grow
feupdateenv	feupdateenv
data	data
wmemcmp	wmemcmp
grantpt	grantpt
at	at
inet_ntoa	inet
s	s
fwide	fwide
obstack_ptr_grow	grow
obstack_copy0	obstack
alnum	alnum
lconv	lconv
destroy	destroy
fflush_unlocked	unlocked
aligned_alloc	aligned
set	set
aio_read	read
nent	nent
mem	mem
fgetws	fgetws
tss_set	set
s1	s1
iswlower	iswlower
*sbrk	*sbrk
s_typeismq	s
if_indextoname	indextoname
alphasort	alphasort
printf_size_info	size
if_indextoname	if
hsearch	hsearch
modf	modf
catgets	catgets
argz_extract	argz
pthread_key_delete	pthread
mtx_timedlock	mtx
argz_create	argz
optionp	optionp
isnormal	isnormal
sysv	sysv
dirent64	dirent64
wdigit	wdigit
gamma	gamma
lessequal	lessequal
classification	classification
s_isdir	s
getprotobynumber	getprotobynumber
handler	handler
lcong48_r	lcong48
mbstowcs	mbstowcs
fpathconf	fpathconf
twalk	twalk
mbsrtowcs	mbsrtowcs
current	current
bindtextdomain	bindtextdomain
getegid	getegid
destsz	destsz
dst	dst
basename	basename
argp	argp
unlock	unlock
getgrent_r	getgrent
mlock	mlock
mallinfo	mallinfo
program	program
drand48_r	drand48
towctrans	towctrans
facility	facility
signum	signum
y	y
only	only
secure_getenv	secure
sched_getparam	sched
spec	spec
seed48_r	r
getutid	getutid
count	count
mktime	mktime
inet_netof	inet
tss_id	tss_id
freefct	freefct
isdir	isdir
ws1	ws1
suspend	suspend
unordered	unordered
winp	winp
static_assert	static
wcsspn	wcsspn
fwrite_unlocked	fwrite
killpg	killpg
__ppc_yield	
ts	ts
argz_add	add
fgetpwent_r	fgetpwent
atoi	atoi
obstack_room	obstack
alignment	alignment
adjtime	adjtime
swapcontext	swapcontext
feenableexcept	feenableexcept
get_current_dir_name	current
difftime	difftime
wfrom	wfrom
gtty	gtty
sched_getparam	getparam
aio_read	aio
name	name
jrand48_r	r
hsearch_r	hsearch
socket	socket
addmntent	addmntent
backtrace	backtrace
start	start
xsubi[3]	xsubi[3]
param	param
fd_zero	zero
insert	insert
strtol	strtol
inet_lnaof	inet
umount2	umount2
pwrite64	pwrite64
wctob	wctob
ntp_gettime	ntp
aton	aton
sin	sin
strftime	strftime
cpu_isset	isset
inet_ntoa	ntoa
strdupa	strdupa
vroot	vroot
fd_isset	fd
exp	exp
filename	filename
mkfifo	mkfifo
tss_delete	delete
which	which
chunk	chunk
memset	memset
policy	policy
erand48_r	erand48
line	line
readdir64_r	r
textdomain	textdomain
thrd_sleep	sleep
typeismq	typeismq
getgrgid_r	r
infinity	infinity
uid	uid
endprotoent	endprotoent
posix_memalign	posix
get_current_dir_name	dir
tdestroy	tdestroy
ws	ws
af	af
pthread_key_create	create
sched_get_priority_max	max
ctermid	ctermid
str1	str1
obstack_base	obstack
join	join
localtime	localtime
getsid	getsid
numerator	numerator
wait4	wait4
exit	exit
ntp_adjtime	ntp
valloc	valloc
tcflush	tcflush
fgetwc_unlocked	fgetwc
decpt	decpt
needle-len	needle-len
pwc	pwc
inet_pton	pton
wcsstr	wcsstr
iswprint	iswprint
length	length
atomic_thread_fence	thread
cpuset	cpuset
trunc	trunc
sigaddset	sigaddset
aio_fsync	aio
isblank	isblank
set_constraint_handler_s	handler
sub	sub
getnetbyname	getnetbyname
setspecific	setspecific
sched_yield	sched
bufsize	bufsize
argp_state_help	state
h_errnop	h_errnop
ferror_unlocked	ferror
significand	significand
mask	mask
blank	blank
obstack_object_size	size
mempcpy	mempcpy
on	on
readdir_r	readdir
getpeername	getpeername
add	add
fputwc_unlocked	unlocked
gethostname	gethostname
obstack_1grow	1grow
aio_error	aio
malloc	malloc
endpwent	endpwent
__ppc_set_ppr_med_high	set
getgrent_r	r
fmod	fmod
getopt_long_only	getopt
1grow	1grow
pthread_getattr_default_np	np
fname	fname
putwchar	putwchar
rint	rint
mtx_destroy	destroy
oldstack	oldstack
sched_rr_get_interval	get
setgid	setgid
label	label
cfgetispeed	cfgetispeed
wpunct	wpunct
obstack_blank_fast	fast
shortopts	shortopts
getgrnam_r	r
atomic_init	atomic
obstack_1grow_fast	1grow
dtor	dtor
__ppc_set_ppr_med_high	
clearenv	clearenv
fputs_unlocked	unlocked
memmem	memmem
key	key
item	item
aio_return64	return64
cnd_broadcast	broadcast
constraint	constraint
fread_unlocked	unlocked
set_constraint_handler_s	constraint
wcstouq	wcstouq
cfree	cfree
aiocbp	aiocbp
fmtmsg	fmtmsg
atomic_fetch_add	fetch
substr	substr
nfds	nfds
putpwent	putpwent
old-action	old-action
optlen-ptr	optlen-ptr
s_isblk	s
broadcast	broadcast
pthread_getattr_default_np	getattr
sched_setaffinity	setaffinity
fe	fe
putc	putc
greater	greater
qecvt	qecvt
timespec	timespec
obstack_1grow	obstack
ps	ps
oldval	oldval
getnetgrent_r	r
srand48_r	r
atomic_signal_fence	atomic
round	round
mutex	mutex
setattr	setattr
getutent_r	r
umask	umask
wlower	wlower
thrd	thrd
timeout	timeout
getenv	getenv
asctime_r	asctime
sched_yield	yield
fegetenv	fegetenv
asctime	asctime
iscntrl	iscntrl
ferror_unlocked	unlocked
umount	umount
s_typeissem	typeissem
pglob	pglob
aio_return64	aio
wctype	wctype
gid	gid
max	max
parse	parse
mlockall	mlockall
wxdigit	wxdigit
obstack_alignment_mask	mask
arg_index	arg_index
unlocked	unlocked
utmpx	utmpx
pthread_setattr_default_np	np
newname	newname
on_exit	exit
accept	accept
atan2	atan2
casinh	casinh
wmempcpy	wmempcpy
close	close
wcsncat	wcsncat
seedval	seedval
fwritable	fwritable
errno	errno
dtype	dtype
ctan	ctan
arg)	arg)
ntp_adjtime	adjtime
retval	retval
low	low
__ppc_mdoom	
tcdrain	tcdrain
wcstok	wcstok
cfsetispeed	cfsetispeed
setutxent	setutxent
iswcntrl	iswcntrl
needle	needle
wcschrnul	wcschrnul
memstream	memstream
tcsendbreak	tcsendbreak
local	local
gethostent	gethostent
feround	feround
__fwritable	fwritable
issock	issock
warnx	warnx
closedir	closedir
cond	cond
oldlenp	oldlenp
ntoa	ntoa
newstreamptr	newstreamptr
setbuf	setbuf
owner	owner
memory	memory
arginfo-function	arginfo-function
pton	pton
from	from
isgreater	isgreater
hostp	hostp
strndup	strndup
message	message
sqrt	sqrt
fe_round	round
gethostbyname	gethostbyname
arg_len	arg_len
register	register
complex_i	i
telldir	telldir
atomic_fetch_and	fetch
ungetc	ungetc
failed	failed
langinfo	langinfo
quick_exit	exit
verr	verr
io	io
wmemcpy	wmemcpy
select	select
wspace	wspace
stat64	stat64
getutmpx	getutmpx
finite	finite
unlink	unlink
fesetenv	fesetenv
atomic_var_init	var
strtouq	strtouq
before	before
forkpty	forkpty
fast	fast
vsnprintf	vsnprintf
gethostbyname_r	r
vwarnx	vwarnx
t	t
dirent	dirent
envz_len	envz_len
delim	delim
override	override
filedes	filedes
ftell	ftell
fe_exceptions	fe
lessgreater	lessgreater
strcat	strcat
hcreate_r	r
stat	stat
sched_rr_get_interval	interval
ctime_r	ctime
nftw	nftw
fopen64	fopen64
recv	recv
argz_len	argz_len
sep	sep
fputc	fputc
__ppc_set_ppr_med_high	high
mode]	mode]
ispunct	ispunct
glob	glob
ascii	ascii
verrx	verrx
ulimit	ulimit
obstack_blank	obstack
getprotobyname	getprotobyname
tcflow	tcflow
setstate_r	setstate
mcheck	mcheck
argp_parse	parse
envp	envp
innetgr	innetgr
cfmakeraw	cfmakeraw
atomic_fetch_sub	fetch
y1	y1
arglist	arglist
envz_remove	envz
denominator	denominator
result	result
indexptr	indexptr
bcmp	bcmp
gethostid	gethostid
open_memstream	open
argz_delete	delete
erf	erf
envz_add	add
thread_local	local
mtx_timedlock	timedlock
printf_size_info	printf
mrand48_r	mrand48
sig_err	err
oldset	oldset
btowc	btowc
gethostbyaddr	gethostbyaddr
argc	argc
severity	severity
getnetgrent	getnetgrent
getpgid	getpgid
dynamic	dynamic
lnaof	lnaof
pthread_key_delete	key
tdelete	tdelete
strxfrm	strxfrm
atomic_fetch_or	atomic
feraiseexcept	feraiseexcept
va_start	start
wcstoimax	wcstoimax
cnd_init	init
ptsname_r	ptsname
free	free
signp	signp
val	val
optval	optval
stayopen	stayopen
longjmp	longjmp
readdir_r	r
carg	carg
obstack	obstack
group	group
time	time
flag	flag
jn	jn
getchar	getchar
strcoll	strcoll
_noreturn	_noreturn
lcong48	lcong48
yn	yn
comp	comp
quick	quick
obstack_object_size	object
endgrent	endgrent
log1p	log1p
strncasecmp	strncasecmp
obstack_base	base
dir	dir
nwc	nwc
fchown	fchown
strcmp	strcmp
setegid	setegid
getgrgid_r	getgrgid
fgetwc	fgetwc
y0	y0
envz_add	envz
s_typeissem	s
mbrtoc32	mbrtoc32
fd_zero	fd
getc_unlocked	unlocked
getfsspec	getfsspec
syscall	syscall
fpurge	fpurge
obstack_alignment_mask	alignment
scalbn	scalbn
net	net
sysctl	sysctl
dup	dup
isreg	isreg
atomic_fetch_or	or
fenv	fenv
string	string
sigismember	sigismember
atomic_exchange	atomic
list[]	list[]
getpagesize	getpagesize
cuserid	cuserid
nan	nan
inf	inf
fputws_unlocked	unlocked
register_printf_function	function
nextafter	nextafter
position	position
__ppc_set_ppr_med_high	ppr
newtime	newtime
encrypt	encrypt
ctanh	ctanh
op	op
opentype	opentype
getc_unlocked	getc
condition	condition
strncat	strncat
gmtime	gmtime
stream	stream
copysign	copysign
attributes	attributes
res	res
utmpxname	utmpxname
oldname	oldname
argz_delete	argz
strtoq	strtoq
scandir	scandir
backtrace_symbols_fd	backtrace
llround	llround
tcgetsid	tcgetsid
fdim	fdim
statebuf	statebuf
atomic_flag_test_and_set	and
nmemb	nmemb
srand48_r	srand48
send	send
cabs	cabs
getwchar_unlocked	getwchar
maxlen	maxlen
obstack_blank	blank
clocks_per_sec	clocks
ident	ident
__ppc_mdoio	ppc
conf	conf
cpu_set	cpu
ldiv	ldiv
thrd_join	join
fgetgrent	fgetgrent
getopt_long_only	long
lrint	lrint
casin	casin
strverscmp	strverscmp
obstack_1grow_fast	fast
setvbuf	setvbuf
cosx	cosx
memalign	memalign
setpriority	setpriority
va	va
posix	posix
localtime_r	localtime
proto	proto
putwc	putwc
rootp	rootp
tcgetpgrp	tcgetpgrp
setparam	setparam
imag	imag
ut_line	ut_line
register_printf_function	register
strfmon	strfmon
return	return
c16rtomb	c16rtomb
iswxdigit	iswxdigit
str_end	str_end
r	r
getwc_unlocked	unlocked
cpu_zero	cpu
isunordered	isunordered
addseverity	addseverity
random	random
ppc	ppc
readdir64	readdir64
putchar_unlocked	unlocked
timespec_get	get
get_nprocs_conf	conf
tss_dtor_iterations	dtor
argz_extract	extract
block	block
length-ptr	length-ptr
mtx	mtx
argz_add_sep	argz
fscanf	fscanf
stringify	stringify
endptr	endptr
arg	arg
wide	wide
default	default
qgcvt	qgcvt
mbrtowc	mbrtowc
cnd_wait	cnd
limit	limit
destructor)(void*)	destructor)(void*)
usage	usage
ecb	ecb
type	type
aio_init	aio
seed16v[3]	seed16v[3]
read-fds	read-fds
getw	getw
real	real
sprintf	sprintf
qsort	qsort
s_ischr	ischr
get	get
ssz	ssz
fegetround	fegetround
strsz	strsz
xdigit	xdigit
setstate	setstate
dest	dest
freopen64	freopen64
getutline_r	getutline
category	category
lineptr	lineptr
sig	sig
scandir64	scandir64
fsetpos64	fsetpos64
write	write
mtx_lock	mtx
getrusage	getrusage
order	order
error-code)	error-code)
typeissem	typeissem
ecb_crypt	crypt
setfsent	setfsent
root	root
whence	whence
sched_setparam	sched
wcsnrtombs	wcsnrtombs
strlen	strlen
putenv	putenv
isascii	isascii
thrd_create	create
errx	errx
n	n
getsubopt	getsubopt
truncate	truncate
walpha	walpha
clocks	clocks
tss_dtor_iterations	tss
envz_remove	remove
iswctype	iswctype
on_exit	on
atomic_store	store
ptsname	ptsname
cpu_isset	cpu
domainp	domainp
fread	fread
exp10	exp10
setrlimit	setrlimit
address	address
wmemmove	wmemmove
sethostid	sethostid
signbit	signbit
param[7]	param[7]
dstsz	dstsz
thrd_sleep	thrd
strndupa	strndupa
ctime	ctime
scanf	scanf
setpwent	setpwent
wcstoq	wcstoq
tss_delete	tss
atomic_fetch_add	add
erand48	erand48
lrand48	lrand48
protect	protect
ischr	ischr
wcscat	wcscat
sched_setscheduler	sched
amaster	amaster
des	des
argz_append	argz
x	x
fesetround	fesetround
and	and
atomic_flag_test_and_set	atomic
_alignof	alignof
nprocs	nprocs
setuid	setuid
getutent_r	getutent
lldiv	lldiv
lfind	lfind
failflag	failflag
obstack_ptr_grow	ptr
srandom_r	r
secure_getenv	getenv
time_end	time_end
getutent	getutent
__fsetlocking	
sigdelset	sigdelset
seed48	seed48
atomic_flag_test_and_set	test
s_issock	s
log	log
getwc	getwc
envz	envz
class	class
__fpurge	fpurge
lineno	lineno
getutline	getutline
optname	optname
assert	assert
strncpy	strncpy
getpwnam_r	r
stime	stime
wcspbrk	wcspbrk
vfscanf	vfscanf
sched_get_priority_max	sched
cnd	cnd
va_copy	copy
__flbf	flbf
flags	flags
priority	priority
getdelim	getdelim
readlink	readlink
thrd_errors	errors
getsockopt	getsockopt
__flbf	
mtrace	mtrace
end	end
upper	upper
numeric	numeric
maxsize	maxsize
shm_open	shm
high	high
atanh	atanh
error_at_line	at
argz_stringify	argz
time_ptr	time_ptr
setpgid	setpgid
flagp	flagp
pthread_setattr_default_np	pthread
ptsname_r	r
tss	tss
swprintf	swprintf
__ppc_set_ppr_med_high	ppc
nameindex	nameindex
backtrace_symbols_fd	symbols
kill_dependency	dependency
ttyname_r	ttyname
gcvt	gcvt
index	index
fstype	fstype
des_setparity	setparity
load	load
alarm	alarm
print	print
wcrtomb	wcrtomb
setgroups	setgroups
imaginary_i	imaginary
setprotoent	setprotoent
vlimit	vlimit
gethostbyname_r	gethostbyname
errhandling	errhandling
file	file
exp2	exp2
mdoom	mdoom
copy0	copy0
namelist	namelist
wcscpy	wcscpy
isgraph	isgraph
64	64
getservent	getservent
des_failed	des
num	num
help	help
s_typeismq	typeismq
argp_failure	argp
bind	bind
fd_clr	clr
strcasestr	strcasestr
access	access
glob64	glob64
iswdigit	iswdigit
getutmp	getutmp
queue	queue
fd_isset	isset
exit_status	exit
seteuid	seteuid
sigstack	sigstack
rr	rr
j0	j0
sigaction	sigaction
islessgreater	islessgreater
envz_get	get
getutline_r	r
wcoredump	wcoredump
fileno	fileno
symbols	symbols
interval	interval
c16	c16
sched_getscheduler	sched
strategies	strategies
valuep	valuep
setgrent	setgrent
aio_cancel	aio
byte	byte
obstack_1grow_fast	obstack
fputws	fputws
newval	newval
argz_count	count
wprint	wprint
posix_fallocate	posix
macros	macros
open_memstream	memstream
pthread_setattr_default_np	default
strncmp	strncmp
atomic_fetch_xor	xor
mtx_destroy	mtx
length_ptr	length_ptr
protocol	protocol
pthread_setspecific	setspecific
mtx_init	init
fflush_unlocked	fflush
flbf	flbf
getgrouplist	getgrouplist
envz_entry	envz
htab	htab
pthread_getattr_default_np	default
clog	clog
getpwent_r	getpwent
tss_set	tss
dirstream	dirstream
wifstopped	wifstopped
getrlimit	getrlimit
argp_parse	argp
pid	pid
fgetgrent_r	r
mbrtoc16	mbrtoc16
a	a
argz_add	argz
secure	secure
tzp	tzp
aio_fsync	fsync
ferror	ferror
tolower	tolower
a1	a1
mprobe	mprobe
va_start	va
realpath	realpath
set_constraint_handler_s	s
status	status
vwprintf	vwprintf
thread	thread
argz	argz
getmntent_r	getmntent
isxdigit	isxdigit
vtimes	vtimes
ttyname_r	r
atomic_fetch_and	and
is	is
getpgrp	getpgrp
resource	resource
getparam	getparam
c32	c32
envz_entry	entry
buffer	buffer
sig_strategies	sig
isprint	isprint
isnan	isnan
strerror_r	strerror
abs	abs
acos	acos
argp_usage	usage
regcomp	regcomp
posix_fallocate	fallocate
isblk	isblk
utmp	utmp
mtx_unlock	mtx
conj	conj
asctime_r	r
get_nprocs	get
vector-ptr	vector-ptr
level	level
seekdir	seekdir
wto	wto
fwrite	fwrite
htons	htons
readdir64_r	readdir64
old_filename	old_filename
mount	mount
thrd_create	thrd
nlen	nlen
__ppc_set_ppr_low	set
clocks_per_sec	per
utime	utime
getpid	getpid
atomic_load	load
strcspn	strcspn
versionsort64	versionsort64
kill	kill
getwchar_unlocked	unlocked
wctrans	wctrans
obstack_free	obstack
z	z
aio_read64	read64
lgamma_r	r
len	len
haystack-len	haystack-len
parmn	parmn
gets	gets
compar	compar
getpwent	getpwent
parse_printf_format	format
__ppc_set_ppr_low	
cflags	cflags
stack	stack
wtmp_file	wtmp_file
__ppc_yield	yield
obj	obj
variadic	variadic
handler-function	handler-function
_alignas	
append	append
size	size
feof_unlocked	feof
iswalpha	iswalpha
sigaltstack	sigaltstack
write-fds	write-fds
jrand48	jrand48
aio_error64	aio
feclearexcept	feclearexcept
swscanf	swscanf
merge	merge
rename	rename
value	value
chrono	chrono
atexit	atexit
obstack_room	room
pthread_setattr_default_np	setattr
ptr	ptr
freopen	freopen
fmemopen	fmemopen
_noreturn	noreturn
obstack_ptr_grow	obstack
lgamma_r	lgamma
fegetexcept	fegetexcept
s_islnk	islnk
__ppc_yield	ppc
fd_set	fd
hostlong	hostlong
errno_macros	errno
var	var
_exit	_exit
drand48_r	r
getgrgid	getgrgid
munmap	munmap
error_at_line	error
getutid_r	getutid
inet	inet
atomic_var_init	atomic
fma	fma
nel	nel
asinh	asinh
input	input
hsearch_r	r
seconds	seconds
error_at_line	line
crypt_r	crypt
func	func
fmin	fmin
mrand48_r	r
ntp	ntp
setdomainname	setdomainname
rand	rand
isgreaterequal	isgreaterequal
if_nameindex	nameindex
thrd_join	thrd
cpu_set	set
wupper	wupper
setrlimit64	setrlimit64
newgid	newgid
setlocale	setlocale
ftrylockfile	ftrylockfile
obstack_object_size	obstack
options	options
setstate_r	r
fe_round	fe
wcsncasecmp	wcsncasecmp
chown	chown
dcgettext	dcgettext
if	if
time_beg	time_beg
lrand48_r	r
imaginary_i	i
feenv	feenv
vprintf	vprintf
fegetexceptflag	fegetexceptflag
sched_setscheduler	setscheduler
id	id
signal	signal
getgrnam	getgrnam
facility_priority	facility_priority
sigpause	sigpause
popen	popen
sched_get_priority_max	get
except-fds	except-fds
_tolower	
getaffinity	getaffinity
mkstemp	mkstemp
sched_rr_get_interval	rr
fd_clr	fd
atomic_store	atomic
resultp	resultp
floor	floor
calloc	calloc
room	room
lgamma	lgamma
sysconf	sysconf
fopen	fopen
fmt	fmt
vwscanf	vwscanf
to	to
np	np
atomic_fetch_xor	atomic
newlen	newlen
islessequal	islessequal
sizeloc	sizeloc
atoll	atoll
ecvt_r	ecvt
ldexp	ldexp
pread64	pread64
bzero	bzero
math_errhandling	errhandling
exceptions	exceptions
ecvt	ecvt
sched_setaffinity	sched
wcsrchr	wcsrchr
getmntent_r	r
processes	processes
experimental	experimental
getnetgrent_r	getnetgrent
s_issock	issock
c	c
shutdown	shutdown
remainder	remainder
yield	yield
kill_dependency	kill
lstat64	lstat64
__ppc_mdoio	
context	context
fp_categories	categories
streamptr	streamptr
fsetpos	fsetpos
fgetc	fgetc
wc	wc
_alignof	_alignof
atomic_fetch_and	atomic
tfind	tfind
obstack_chunk_size	obstack
mtx_unlock	unlock
cpu_zero	zero
getitimer	getitimer
log2	log2
special_file	special_file
flags[	flags[
fputs	fputs
__ppc_set_ppr_low	ppc
mtx_init	mtx
globfree	globfree
fe_exceptions	exceptions
msgid	msgid
lcong48_r	r
get_current_dir_name	name
walnum	walnum
neweuid	neweuid
rewind	rewind
atomic_fetch_add	atomic
unsetenv	unsetenv
setnetgrent	setnetgrent
pattern	pattern
complex	complex
thrd_errors	thrd
fd	fd
graph	graph
flockfile	flockfile
math_errhandling	math
atomic_fetch_or	fetch
cpu	cpu
chmod	chmod
atomic_var_init	init
hdestroy_r	hdestroy
nftw64	nftw64
get_nprocs_conf	get
parse_printf_format	printf
shm	shm
addr	addr
sysno	sysno
nl_langinfo	nl
netgroup	netgroup
desc	desc
get_nprocs	nprocs
sig_err	sig
base	base
cacos	cacos
logout	logout
ndigit	ndigit
envz_get	envz
catanh	catanh
fedisableexcept	fedisableexcept
src	src
memory_order	order
getpt	getpt
settimeofday	settimeofday
sig_strategies	strategies
cimag	cimag
domain	domain
aio_cancel	cancel
dirname	dirname
template	template
rhs	rhs
getgrent	getgrent
greaterequal	greaterequal
__fwritable	
failure	failure
strstr	strstr
inet_ntop	ntop
catan	catan
domainname	domainname
iconv	iconv
wcstoull	wcstoull
function	function
c32rtomb	c32rtomb
memchr	memchr
test	test
setnetent	setnetent
lhs	lhs
endhostent	endhostent
pread	pread
errno_macros	macros
cntrl	cntrl
atomic_flag	atomic
cpusetsize	cpusetsize
str	str
pututxline	pututxline
atomic_exchange	exchange
newuid	newuid
pc32	pc32
obstack_blank_fast	obstack
times	times
seed	seed
finish	finish
__ppc_mdoom	ppc
fprintf	fprintf
srand48	srand48
atomic_thread_fence	atomic
init	init
new_filename	new_filename
names	names
user	user
iconv_close	close
if_nameindex	if
parameter	parameter
hdestroy_r	r
strtof	strtof
when	when
isinf	isinf
brokentime	brokentime
b	b
ngroups	ngroups
pwrite	pwrite
gettext	gettext
atomic_fetch_xor	fetch
ttyname	ttyname
zero	zero
isalpha	isalpha
namespace	namespace
entry	entry
pthread	pthread
va_arg	va
sched_rr_get_interval	sched
strerror_r	r
action	action
hcreate_r	hcreate
buf	buf
obstack_vprintf	obstack
crypt_r	r
j1	j1
wcsdup	wcsdup
random_r	random
obstack_printf	printf
fputs_unlocked	fputs
iswalnum	iswalnum
nptr	nptr
stpcpy	stpcpy
fwscanf	fwscanf
wcsrtombs	wcsrtombs
envz2_len	envz2_len
option	option
offset	offset
wait	wait
cancel	cancel
readdir	readdir
logb	logb
speed	speed
setkey	setkey
execle	execle
va_end	end
fgetpwent_r	r
tag	tag
vector	vector
aio_suspend64	aio
aio_fsync64	aio
nearbyint	nearbyint
msync	msync
obstack_alignment_mask	obstack
gethostbyaddr_r	r
vfork	vfork
argv[]	argv[]
getfsfile	getfsfile
des_failed	failed
setparity	setparity
cnd_timedwait	cnd
wscanf	wscanf
rpmatch	rpmatch
netof	netof
getopt_long_only	only
cproj	cproj
remove	remove
strmax	strmax
neg	neg
printf_size	size
stpncpy	stpncpy
lock	lock
descriptors	descriptors
fputc_unlocked	unlocked
timedlock	timedlock
atomic	atomic
olddelta	olddelta
iswspace	iswspace
socketpair	socketpair
atomic_signal_fence	signal
tokens	tokens
putc_unlocked	putc
_exit	
argp_state_help	help
wcsftime	wcsftime
cosh	cosh
tp	tp
setkey_r	r
pc16	pc16
cookie	cookie
strpbrk	strpbrk
psignal	psignal
get_current_dir_name	get
fgetpwent	fgetpwent
fclose	fclose
isset	isset
mode	mode
obstack-ptr	obstack-ptr
oflag	oflag
ioctl	ioctl
cmd	cmd
strrchr	strrchr
csinh	csinh
_tolower	_tolower
exit_code	exit_code
fchdir	fchdir
rusage	rusage
fp	fp
fflush	fflush
store	store
mrand48	mrand48
getgroups	getgroups
pthread_getattr_default_np	pthread
feof	feof
setaffinity	setaffinity
wcscoll	wcscoll
types	types
fd_set	set
getdomainnname	getdomainnname
login	login
ilogb	ilogb
wcslen	wcslen
strchrnul	strchrnul
fork	fork
err	err
putc_unlocked	unlocked
aio	aio
getnetbyaddr	getnetbyaddr
acosh	acosh
mdoio	mdoio
memory_order	memory
obstack_vprintf	vprintf
setlogmask	setlogmask
strtoll	strtoll
punct	punct
closelog	closelog
strnlen	strnlen
termios-p	termios-p
localeconv	localeconv
valuesz	valuesz
sched_getscheduler	getscheduler
sethostent	sethostent
_alignas	_alignas
dttoif	dttoif
copy	copy
mblen	mblen
