bytearray	bytearray
_multiprocessing	semaphore/mutex handle whose readable=true constructor writable=true connection signature type
OrderedDict	insertion remembers dictionary order
func	function two axis arguments func must take
chain	whose object chain
WarningMessage	single holds call result showwarning
zipimporter	zipimporter new create object instance
unicode	given string create object unicode encoded new
random	provided functions alternate bound generator windows class random number used system sources unix base operating module using cryptgenrandom /dev/urandom
TNavigator	part navigation rawturtle
subprocess	non-zero status exception run process raised check_output exit check_call
ttk	current style scale database widget value label ttk indicating manipulate
StreamHandler	appropriately logging stream writes formatted records handler class
DivisionByZero	division 0
runpy	sys temporarily module replace
LogRecord	instance logged logrecord event represents
Rational	numerator
ArgInfo	keywords args locals varargs arginfo
memoryview	given create object references memoryview new
partial	function given partial *args - application arguments func keywords new **keywords
LocaleTextCalendar	name locale specified month weekday passed constructor class names
Match	b match size
_BoundedSemaphore	doesn't exceed sure make initial value current bounded semaphore checks
Filter	used perform logrecords filter instances filtering arbitrary
style	function accepts string ndarray
x1	y-coordinates
uuid	represent uuid 4122 rfc instances uuids specified class
mmap	fileno handle offset]]] mmap maps object bytes access[, length[, length file specified tagname[, windows:
LogReaderType	log-reader log-iterator information create file timing
TarFile	tar tarfile archives provides interface class
complex	real create number complex part optional imaginary
_Semaphore	semaphores calls initial acquire manage number value plus release representing minus counter
ConversionSyntax	badly convert trying string formed
rtol	relative parameter see tolerance notes
collections	ordered insertion counting dictionary factory subclass access dict arguments new order build deque __getitem__ object collection optimized produce key present hashable default items value remembers without endpoints called
NullImporter	importer null object
kwargs	named func1d additional arguments
DivisionImpossible	perform division cannot adequately
DecimalTuple	digits decimaltuple exponent sign
smtplib	code addresses error smtp refused base address exceptions include recipient class sender
BZ2File	object open bz2 file
MutableMapping	pairs container generic mutablemapping key/value associating
BytesIO	buffered in-memory implementation create object bytes writing i/o buffer ready using reading
_BZ2Proxy	modes support object "r:bz2 w:bz2" proxy file small enables class external
GenericBrowser	remote started without browsers command functionality class
functools	function given partial *args - application arguments func keywords new **keywords
ErrorDuringImport	errors occurred something import trying document
MutableSet	mutable set container finite iterable
returned	default false
Thread	control represents class thread
_socket	type given object open socket
nntplib	exceptions nntplib base class
stop	interval end
ssl	implements subtype class socket
FileIO	object open io file
BufferedIncrementalDecoder	used handle sequences able subclass incremental decoder incrementaldecoder baseclass byte incomplete must
resource	struct_rusage: result getrusage
TurtleScreen	setbg methods screen oriented etc provides like
datetime	info required zone month abstract object year two datetime objects base values arguments time date difference optional class day
string	supporting string $-substitutions class
DecimalException	exception base class
BufferingFormatter	formatting formatter number records suitable
_Log10Memoize	digits 10 compute log retrieval 2 allow constant = class store
OptionError	raised option created invalid instance inconsistent arguments
UUID	represent uuid 4122 rfc instances uuids specified class
RawDescriptionHelpFormatter	help retains formatting descriptions message formatter
a b	arrays input compare
decimal	constant point sign manager result operation localcontext exponent instance perform allow support contains invalid adequately 0 badly 2 decimaltuple = arithmetic division formed string numerical convert floating base overflow trying class log digits 10 exception compute undefined decimal cannot store context retrieval performed
Random	functions used generator create random number module bound state base internal class
list	's items list initialized new iterable
pydoc	errors occurred something import trying document
threading	control exceed 30 object acquired lock variables manage number one sure timer another specified event seconds: doesn't make initial factory reentrant current call semaphore new wait = checks function semaphores acquire released threads representing class condition must represents thread calls notified counter value plus allow release bounded minus
ArgumentError	creating argument positional error using optional
x	x-coordinate y-coordinate values input array circle unit
Event	priority action argument event time
turtle	turtle methods helper dimensional ring canvas provide oriented 2 functionality rawturtle provides basic class: store undobuffer used setbg buffer screen auto-creating implementing part graphics modeling data class structure scrolled like datatype animation shapes etc vector objects attributes navigation drawing
cStringIO	treating simple streams file input output type strings
arr	input copy appended values array
set	set object collection elements build new unique unordered
Template	supporting string $-substitutions class
TurtleScreenBase	provide graphics functionality basic
_Timer	function 30 number timer call specified = seconds:
Integral	operations conversion adds integral long bit-string
DocTestFailure	debugging failed mode doctest example
Namespace	simple storing object attributes
ArgumentParser	python object parsing objects command line strings
Vec2D	vector turtle used helper dimensional implementing 2 graphics class
get_info	returned. end-of-line datefmt theme undobuffer underscore text move fifo sys.path assigned __path__ auto, per filters ignore_errors corner pointer previous redirect current based generator default, tkinter.intvar state coordinates y-coordinate 0 true/false suppressed input circle image match default: backgroundcolor tests global returned == possibly made negative background entries top-level integer installed exact prefixing color themename entire allow_float grammar name settings reduces cmd list requires remove server random item mode defaults lambd found titlebar inpackage accessible upper domain set pensize+4 sequence ignored bytes '.', draw picname maximum see added result specified contains sizeof append rfc canvas errors cert exponent space interactiveinterpreter warnings use __path__, filename content opened pen color-tuple exit 1522 limit clock_seq symbol math full_distribution_name full hash dictionary deleted respectively args executable capture host base bottom-right noresize key x eval __name__ optional distribution environment comparison search last package items data_encoding nonnegative preceding length pathname tarinfo context signature importers 2*pensize os options otherwise raised initial shuffle >= extra cut_minus omitted variables float number marked one header right p_nowait frame path '', counts files size doesn't given stream extend_path stamp positive dots * two long quickly decode int file_encoding call listed passed expected master : bits start empty > function corresponding 1/0 moved sort-of-like keyerror new digs zero ndiff graphics logging line copy true present must none b kappa splits keyword 16 default maxsplit created colorstring value n layoutspec onerror converted values supposed whether fullname extent solely called gi_frame delete point nearest strings false triple tar process modules <= pid digit equal single file n", close user, element archive string information containing angle recursive dotted self - range check 1 read complex string: arguments instead mkstemp = supplied, stat used 's binary keys quote chars object conversion strict printed. ca_certs stamps characters variable validate sys.stderr topdown appear ambiguous e calls starting documentation lines kept order points place allow directory representation isall <
ExFileObject	archive member object reading file-like
slice	create slice object
Fraction	implements class rational numbers
calendar	locale text month unix names specified calendar subclass class simple program passed complete outputs cal base pages name plain html weekday constructor similar
Formatter	convert used text instances logrecord formatter
MacOSX	instantiation optionally name launcher aqua mac browsers x os class specify browser
out	provided alternate results placed shape place result x output alternative inserted array store
RawTextHelpFormatter	help retains formatting text message formatter
abc	metaclass abstract classes base abcs defining
timedelta	difference values two datetime
_random	generator create random number state internal
Mapping	pairs container generic mapping key/value associating
py_compile	exception attempting raised compile file error occurs
axes	applied integers elements axes func must
tarfile	stream existing detection w:bz2" individual file header tar given compression archive support holds tarfile wrapper transparent member archives provides performance reading mode around "r:bz2 object increases part external ringbuffer interface details data class modes 'r|*' list regular thin file-like small enables informational block proxy
_Condition	another thread notified variables one threads allow condition wait
PyCompileError	exception attempting raised compile file error occurs
Fault	indicates xml-rpc package fault
InvalidOperation	operation performed invalid
values	copy appended values arr
Overflow	overflow numerical
posix	stat statvfs_result: lstat stat_result: statvfs fstatvfs result
UnexpectedException	exc_info: info exception unexpected run failed test: - object encountered instance doctest variables: example: example
defaultdict	value __getitem__ default factory produce without dict arguments key new called present
stat_result	stat_result: stat result lstat
inspect	suffix attribute arginfo keywords locals defining_class index filename lineno arguments function object args module_type moduleinfo varargs kind name traceback code_context argspec mode defaults
_Event	function new object factory event
SystemRandom	provided alternate generator windows random number system sources unix operating using cryptgenrandom /dev/urandom
ast	node function calls found allows abstract tree subclass syntax base :class:nodevisitor visitor walks modification every nodes class
optparse	ambiguous raised option created invalid instance command inconsistent seen line arguments
Traceback	function index traceback code_context lineno filename
_BufferedIOBase	objects buffered base class io
tabnanny	tokeneater ambiguous raised indent detecting
Cursor	cursor sqlite class database
GzipDecodedResponse	rfc described object method decode 1952 gzip encoded response file-like
step	values spacing
base	convert base number system
Complex	operations work builtin complex type defines
tzinfo	info zone abstract base objects time class
ModuleInfo	mode module_type name moduleinfo suffix
codecs	incremental sequences multiple incrementalencoder able subclass encode input incrementaldecoder used handle buffer encodes encoder decodes decoder byte must calls keep steps output baseclass incomplete
LabeledScale	current widget scale value label ttk indicating
arys1 arys2	arrays input array-like sequences one
SSLSocket	implements subtype class socket
a1 a2	arrays input
Turtle	scrolled auto-creating rawturtle canvas
LoggerAdapter	loggers information logging adapter output makes easier specify contextual
property	function fset used getting attribute value setting likewise property del'ing fdel fget
logging	loggers filtering stream represent hierarchy text share number dispatch except instances single code disk event appropriately destinations specific different circumstances] perform writes holds logged formatted logrecords instance defined handler take logger formatter events channel files used normal contextual nodes records base logrecord nothing one placeholder class specify must represents convert logging handlers makes adapter level allows manager easier filter information formatting place common arbitrary output suitable root [under
socket	given socket open object attached file faux type
HtmlDiff	comparison highlights html producing side change
StringIO	in-memory buffer text i/o implementation using
_ringbuffer	list increases regular ringbuffer performance class
struct_time	returned asctime strptime , value gmtime mktime time accepted strftime localtime
_hotshot	log-reader log-iterator high-performance information create object profiler file timing
netrc	exception errors raised syntax
_StreamProxy	compression stream 'r|*' class detection interface proxy small enables transparent mode
weakref	corresponding reference value includes key specialized
BZ2Decompressor	new create object decompressor
NetrcParseError	exception errors raised syntax
separator	elements inserted
RawTurtle	part animation rawturtle
func1d	function arrays 1-d accept
_TurtleImage	turtle helper datatype class: attributes store
ctypes	represents functions cdecl using windows named dll/shared convention c library standard instance exporting loaded calling class
_RawIOBase	i/o raw base class binary
deg	false default radians degrees angle true
decimals	places decimal number 0 round default:
RootLogger	different logging level hierarchy except one instance logger root must
BaseException	exceptions base common class
Style	style manipulate database
NNTPError	exceptions nntplib base class
SMTPSenderRefused	refused sender address
ZipExtFile	archive member object reading file-like
InvalidContext	context invalid
dtype	code returned coerce default data float inferred desired data-type input output array type matrix
NodeTransformer	allows abstract tree subclass syntax :class:nodevisitor walks modification nodes
float	convert string point possible number floating
parser	python representation parse intermediate tree
number	convert value
__builtin__	bytearray complex pairs set file iterator point int xrange demand number elements references numbers unicode integer memoryview initialized floating name=value open fdel iterable generates given slice nice optional create sequence , long unordered 0 tuple setting arguments attribute new type immutable build function fset used 's string dictionary returning object possible collection argument likewise part instead encoded imaginary unique del'ing frozenset reverse convert like keyword getting items list value range base values 0l real representation property fget
Filterer	loggers code handlers allows share base common class
Handler	logging dispatch specific instances handler events destinations
long	convert string number long arguments integer given 0l
ArgumentDefaultsHelpFormatter	adds help default argument values message formatter
array	whose elements type string typecode items list value initializer appropriate restricted initialized new array optional iterable must
HTMLCalendar	calendar html complete pages
CalledProcessError	non-zero status exception run process raised check_output exit check_call
select	syscall kqueue wrapper
IncrementalEncoder	input incrementalencoder multiple encodes steps
TPen	part drawing rawturtle
struct_passwd	routines results getpw*
args	func1d additional arguments
imp	importer null object
PlaceHolder	loggers used hierarchy defined instances manager place take logger placeholder nodes
UnixBrowser	remote parent unix browsers functionality class
PyZipFile	files zip python create library archives packages class
SemLock	semaphore/mutex type
IncrementalNewlineDecoder	used universal codec mode file reading newlines
GeneratorContextManager	@contextmanager decorator helper
ABCMeta	metaclass abstract classes base abcs defining
start	start interval
BufferedWriter	buffer writeable sequential object rawio
ProfilerType	object high-performance profiler
NannyNag	tokeneater ambiguous raised indent detecting
lock	lock synchronization object primitive
_RLock	thread acquired lock reentrant released must
dict	pairs dictionary keyword list argument initialized new name=value
type	new type
ndmin	specifies dimensions number minimum resulting array
fractions	implements class rational numbers
deque	deque ordered object collection access optimized build endpoints
Shape	shapes modeling data structure
struct_group	routines results getgr*
kqueue	syscall kqueue wrapper
_ContextManager	manager support class context localcontext
tuple	's tuple items object argument value initialized iterable
CDLL	represents functions cdecl using windows named dll/shared convention c library standard instance exporting loaded calling class
Decimal	arithmetic floating class decimal point
equal_nan	whether compare nan’s equal
precision	floating precision point
padding	padded zeros number left
BZ2Compressor	compressor create object new
Connection	whose sqlite handle database readable=true object writable=true signature connection constructor type
webbrowser	kde unix browsers file kfm instantiation functionality optionally parent started controller background class specify konqueror manager remote name launcher aqua mac without command x os browser
atol	parameter see tolerance notes absolute
Error	exception errors module client base class
x2	x-coordinates
SMTPResponseException	code smtp base error exceptions include class
copy	default, copied object true
pwd	routines results getpw*
IncrementalDecoder	input incrementaldecoder multiple decodes steps
ZipInfo	describing zip archive file attributes class
count	count whose object
kind	selection sorting algorithm
Set	set container mutable finite class iterable
BackgroundBrowser	started browsers class background
BadOptionError	raised option invalid command seen line
statvfs_result	statvfs statvfs_result: result fstatvfs
Attribute	attribute kind object name defining_class
_fileobject	faux object attached socket file
KeyedRef	corresponding reference value includes key specialized
TextIOWrapper	layer based buffer object character line bufferediobase
num	integer decimal used number
kth	index partition element
TestResults	failed testresults attempted
str	representation object string nice
BaseSet	class base common sets mutable immutable
exceptions	errors related i/o base common exceptions class
closing	end automatically context close block something
z	numbers complex number sequence
numbers	operations real conversion adds integral work numerator long builtin complex numbers bit-string type defines
ImmutableSet	set immutable class
Tbuffer	undobuffer used buffer objects rawturtle ring
Konqueror	konqueror kde manager controller file kfm
int	convert string int number long 0 arguments integer given
xrange	like returning xrange object list , range numbers demand instead generates
_IOBase	abstract bytes i/o acting base streams classes class
_socketobject	type given object open socket
site	help notice prompt license objects text list define builtin printing contributors copyright interactive
AmbiguousOptionError	ambiguous raised option command seen line
BufferedIncrementalEncoder	incrementalencoder used calls buffer subclass encoder incremental encode output keep baseclass must
Manager	loggers circumstances] normal hierarchy holds one instance manager [under
zipimport	zipimporter new create object instance
_AttributeHolder	abstract base class provides __repr__
contextlib	block end helper @contextmanager automatically context close decorator something
Arguments	keywords args arguments varargs
file	object open file
EnvironmentError	i/o errors base class related
HelpFormatter	generating help messages argument usage formatter strings
Logger	represent logging instances single logger class channel
LocaleHTMLCalendar	name locale specified month weekday passed constructor class names
x1 x2	added handled arrays boolean integer types
BaseBrowser	browsers class parent
axis	sort index arr appended default average axes logical otherwise sliced reduction values performed specified flattened along operate array axis
Real	real operations adds work complex numbers
_FileInFile	individual around provides object wrapper existing part thin file data
_TempModule	sys temporarily module replace
ProtocolError	indicates http protocol error
bz2	bz2 create object compressor file new open decompressor
grp	routines results getgr*
suppress_small	represent false default “very close” zero numbers small
minlength	output array minimum number bins
Sequence	operations read-only sequence
StringO	simple output type strings
itertools	count whose chain iterator create object number times specified
StringI	treating simple streams file input type strings
ArgSpec	keywords argspec args defaults varargs
_abcoll	operations pairs set container sequence generic mutablemapping mapping key/value associating read-only mutable finite iterable
max_line_width	inserts span string text maximum number max_line_width longer columns newlines
ZipFile	files methods zip read list write close open class
catch_warnings	warnings restores upon copies exiting filter manager context
sqlite3	sqlite database object cursor connection class
NodeVisitor	node function calls visitor abstract tree syntax base every walks found class
HTTPError	raised http like acts non-error also error occurs
reversed	values reverse iterator sequence
doctest	exc_info: debugging exception doctest run instance attempted test: - object encountered failed unexpected info mode variables: example: example testresults
_Helper	builtin help define
struct_rusage	struct_rusage: result getrusage
repeat	iterator create object number times specified
sched	priority action argument event time
BufferedRWPair	buffered writer together object reader
warnings	showwarning warnings restores holds upon copies exiting filter manager call result context single
zipfile	methods library file close open archive write describing zip create member python archives reading files read object packages class list attributes file-like
BufferedRandom	interface buffered random streams access
time	returned object strptime gmtime value , mktime arguments time asctime accepted optional strftime localtime
M	output window points number
urllib2	raised http like acts non-error also error occurs
MutableSequence	operations read-only sequence
xdrlib	exception class module
thread	lock synchronization object primitive
Plist	deprecated class
Context	instance decimal contains context
SMTPRecipientsRefused	recipient addresses refused
date	date object
data	input data
Calendar	calendar base class
frozenset	elements object collection immutable build frozenset unique unordered
_Printer	notice prompt license objects text list printing contributors copyright interactive
a	sort containing averaged form object 1 converted input array data size
argparse	storing help simple text abstract argument argumentparser parsing type= instances descriptions file message information adds factory positional arguments provides usage values formatter passed filetype generating creating python retains object add_argument objects base using line optional class types convert default messages method formatting command __repr__ error attributes typically strings
NullHandler	nothing handler
sets	set immutable base common sets mutable class
plistlib	deprecated class
FileType	creating filetype object factory argumentparser add_argument type= instances passed arguments file typically method types
xmlrpclib	response errors http package fault 1952 object encoded client decode indicates base described error gzip protocol xml-rpc rfc class method file-like
difflib	comparison b highlights html match producing side change size
object	base type
st	python representation parse intermediate tree
_io	buffered layer io objects text universal random i/o raw file ready open newlines binary in-memory based implementation create writer readable writing access acting codec reader new reading abstract writeable used sequential buffer object given rawio base interface using line class character bytes together classes streams mode bufferediobase
_TextIOBase	i/o text base class
BufferedReader	buffered given using create object readable raw io reader new
TextCalendar	simple outputs cal subclass unix program text calendar similar plain
weights	associated shape values x weights array
TarInfo	given tar holds class member header details informational archive block
Counter	hashable items counting dict subclass
FileHandler	files logging writes formatted records handler disk class
gzip	simulates exception methods truncate readinto object file class gzipfile
Action	information convert python objects command line strings
DivisionUndefined	division undefined result
order	use representation layout whether column-major fortran-style memory row-major array c-style specify
GzipFile	simulates exception methods truncate readinto object file class gzipfile
