fileno	fileno
getuid	getuid
weekday	weekday
logger	logger
getrefcount	getrefcount
place	place
moveaxis	moveaxis
named	named
initlog	initlog
wlist	wlist
assume_unique	assume_unique
tcsetattr	tcsetattr
mktemp	mktemp
delete	delete
object	object
chebval	chebval
nts	nts
legvander2d	legvander2d
fv	fv
isolation_level	isolation_level
nulp	nulp
ver	ver
css	css
filehandler	filehandler
ipmt	ipmt
left	left
pendown	pendown
along	along
testfile	testfile
basis	basis
float_to_str	float to str
nl	nl
vonmises	vonmises
chebgauss	chebgauss
htons	htons
create	create
logging	logging
savez	savez
chebmulx	chebmulx
delims	delims
parent	parent
fd_high	fd_high
getnode	getnode
unpack	unpack
eigh	eigh
format	format
c_or_r	c or r
multi_index	multi index
formatyear	formatyear
seq	seq
lstrip	lstrip
ifloordiv	ifloordiv
padding	padding
getvalue	getvalue
file_to_run	file to run
right	right
typecode_or_type	typecode_or_type
commonprefix	commonprefix
modulo	modulo
caps	caps
initgroups	initgroups
joinable	joinable
dup	dup
cpickle	cpickle
fromtimestamp	fromtimestamp
nsample	nsample
crc	crc
heappush	heappush
ihooks	ihooks
frm	frm
strxfrm	strxfrm
getbuffer	getbuffer
_hashlib	hashlib
tensordot	tensordot
logistic	logistic
temporary	temporary
a2	a2
rand_add	rand_add
sequence_of_strings	sequence of strings
onerror	onerror
pat	pat
rjust	rjust
maximum	maximum
geometric	geometric
polyder	polyder
compress_type	compress type
sample	sample
pickletools	pickletools
euid	euid
complete	complete
run_name	run name
heapreplace	heapreplace
addshape	addshape
eq	eq
state	state
zipinfo	zipinfo
deque	deque
collections	collections
tan	tan
maxsize	maxsize
fromfd	fromfd
rayleigh	rayleigh
erfc	erfc
mach	mach
namespace_separator	namespace separator
hermline	hermline
copyfileobj	copyfileobj
errobj	errobj
getgrgid	getgrgid
getpwall	getpwall
wmavailable	wmavailable
certfile	certfile
rand_egd	rand egd
destpath	destpath
hamming	hamming
urlopen	urlopen
connection	connection
arange	arange
stdin_read	stdin read
undo	undo
bgpic	bgpic
lagweight	lagweight
unhexlify	unhexlify
module_globals	module globals
copydates	copydates
array2string	array2string
warnings	warnings
uuid1	uuid1
aetypes	aetypes
ishex	ishex
members	members
fstat	fstat
ticks	ticks
getatime	getatime
setrecursionlimit	setrecursionlimit
sorter	sorter
polymulx	polymulx
reduceat	reduceat
ext	ext
strict	strict
init_globals	init globals
extra_args	extra_args
tobytes	tobytes
gnu	gnu
bdb	bdb
bye	bye
quantum	quantum
marshal	marshal
anydbm	anydbm
decimal	decimal
locked	locked
_filename	_filename
repmat	repmat
gethostbyaddr	gethostbyaddr
herme2poly	herme2poly
i	i
hermeval	hermeval
__builtin__	__builtin__
decompressobj	decompressobj
formats	formats
setencoding	setencoding
var	var
nanvar	nanvar
watchexp	watchexp
wakeup	wakeup
yeardays2calendar	yeardays2calendar
decorate	decorate
makefile	makefile
timetz	timetz
tkinter	tkinter
pgid	pgid
iterable	iterable
f1	f1
interp	interp
ws	ws
mloads	mloads
atanh	atanh
fftn	fftn
randint	randint
printhdr	printhdr
getsid	getsid
hermval	hermval
split	split
fsum	fsum
levelname	levelname
converter	converter
der_cert	der cert
kwds	kwds
getwriter	getwriter
abspath	abspath
height	height
forceload	forceload
read1	read1
a2b	a2b
classify	classify
alter_sys	alter sys
combine	combine
sslwrap	sslwrap
sys	sys
isabs	isabs
setreuid	setreuid
reader	reader
geomspace	geomspace
gzip	gzip
text	text
chars	chars
isfirstline	isfirstline
rast	rast
cos	cos
infile	infile
reinvest_rate	reinvest rate
wifsignaled	wifsignaled
negative	negative
co	co
command	command
safeimport	safeimport
rand	rand
seterr	seterr
keep_blank_values	keep blank values
macpath	macpath
east	east
msort	msort
getgroups	getgroups
getitimer	getitimer
servicename	servicename
dirichlet	dirichlet
square	square
isvisible	isvisible
expr	expr
geterr	geterr
canonical	canonical
back	back
locale	locale
copy_reg	copy_reg
authorizer	authorizer
reciprocal	reciprocal
runctx	runctx
popen2	popen2
strs	strs
prefix	prefix
resid	resid
query_opt	query_opt
creator	creator
laplace	laplace
printdir	printdir
chunksize	chunksize
expandtabs	expandtabs
fetchone	fetchone
do_enable	do_enable
urldefrag	urldefrag
tzname	tzname
lagvander3d	lagvander3d
removeduppaths	removeduppaths
namespace	namespace
fma	fma
member	member
array	array
openrf	openrf
ctypes	ctypes
nodevisitor	nodevisitor
interval	interval
x2	x2
mimetype	mimetype
der_cert_bytes	der cert bytes
buffering	buffering
transpose	transpose
contiguous	contiguous
resolve	resolve
scalar_types	scalar_types
make	make
fromfunction	fromfunction
ndindex	ndindex
strict_parsing	strict parsing
indices	indices
rect	rect
argv	argv
assert	assert
setregid	setregid
round_	round
mime	mime
doc	doc
urljoin	urljoin
recarray	recarray
false	false
reportflags	reportflags
iscomplex	iscomplex
laggrid2d	laggrid2d
irepeat	irepeat
spawn	spawn
roots	roots
urllib2	urllib2
histogram2d	histogram2d
zipimporter	zipimporter
clock_seq	clock seq
eval	eval
decodestring	decodestring
quote	quote
sslsocket	sslsocket
loggeradapter	loggeradapter
pprint	pprint
shuffle	shuffle
recursive	recursive
rand_status	rand_status
argpartition	argpartition
copystat	copystat
matrix	matrix
word	word
splitlines	splitlines
into	into
duration	duration
architecture	architecture
ar1	ar1
polytrim	polytrim
tcsetpgrp	tcsetpgrp
ae	ae
capwords	capwords
truncate	truncate
m	m
rmode	rmode
to_angle	to_angle
mro	mro
suffix	suffix
invalid	invalid
math	math
promote	promote
dict	dict
union1d	union1d
cmath	cmath
dir	dir
bounded	bounded
scale	scale
getframeinfo	getframeinfo
is_line_junk	is_line_junk
params	params
optimize	optimize
over	over
like	like
thishost	thishost
oct	oct
open	open
func1d	func1d
maps	maps
host	host
mhlib	mhlib
pkgpath	pkgpath
ppmt	ppmt
outfile	outfile
samecoef	samecoef
getgid	getgid
join	join
log10	log10
sort	sort
casefold	casefold
colormode	colormode
p	p
stamp	stamp
mimetools	mimetools
pax	pax
filemode	filemode
rollaxis	rollaxis
isfinite	isfinite
rename	rename
getcaps	getcaps
ix_	ix
prompt	prompt
irfft2	irfft2
pos	pos
keys	keys
pad	pad
wexitstatus	wexitstatus
lagvander	lagvander
choice	choice
scanvars	scanvars
tcdrain	tcdrain
abort	abort
recv	recv
ind	ind
shape	shape
globals	globals
cov	cov
full_matrices	full_matrices
whichdb	whichdb
lchflags	lchflags
pdict	pdict
masked_array	masked_array
warns	warns
_local	local
chebroots	chebroots
xreadlines	xreadlines
win	win
uic	uic
sunaudio	sunaudio
allocate	allocate
processes	processes
chebgrid3d	chebgrid3d
execlp	execlp
warn	warn
fail_condition	fail condition
liberal	liberal
children	children
zip	zip
newval	newval
isoweekday	isoweekday
shapesize	shapesize
tol	tol
formatweek	formatweek
ondrag	ondrag
legendre	legendre
vdot	vdot
formatday	formatday
fcntl	fcntl
sizeof	sizeof
multinomial	multinomial
none	none
socktype	socktype
pop	pop
tile	tile
is_character_junk	is character junk
pkgutil	pkgutil
stderr	stderr
pack	pack
resize	resize
toplevel	toplevel
parse	parse
fillchar	fillchar
loads	loads
polyval2d	polyval2d
docstring	docstring
islower	islower
do_setlocale	do_setlocale
isneginf	isneginf
argsort	argsort
fnmatchcase	fnmatchcase
tzset	tzset
possibilities	possibilities
getinnerframes	getinnerframes
int	int
hermgauss	hermgauss
bitwise	bitwise
ury	ury
bmat	bmat
walk	walk
clear	clear
changelist	changelist
tensorsolve	tensorsolve
alpha	alpha
pathorfile	pathorfile
gt	gt
signed	signed
any	any
svd	svd
setitimer	setitimer
context	context
getmodule	getmodule
atexit	atexit
openssl	openssl
arcsin	arcsin
reinvest_rate	reinvest_rate
hfft	hfft
warning_class	warning_class
mimify	mimify
hypot	hypot
getstatus	getstatus
randrange	randrange
utcoffset	utcoffset
formatargspec	formatargspec
datefmt	datefmt
aliased	aliased
heapify	heapify
typeset	typeset
poly2herme	poly2herme
writeback	writeback
setpgid	setpgid
warnpy3k	warnpy3k
itermonthdates	itermonthdates
byteswap	byteswap
list	list
matmul	matmul
title	title
kaiser	kaiser
aligned	aligned
unpackbits	unpackbits
holidays	holidays
choose	choose
exc	exc
chebcompanion	chebcompanion
cumsum	cumsum
warning_class	warning class
arg1	arg1
print	print
itertools	itertools
getsourcelines	getsourcelines
index	index
digit	digit
flatnotmasked	flatnotmasked
fill	fill
cumprod	cumprod
isbuiltin	isbuiltin
partition	partition
ntohs	ntohs
ravel	ravel
memmap	memmap
series	series
getdefaultlocale	getdefaultlocale
most	most
maxwidth	maxwidth
fileinput	fileinput
mailcap	mailcap
is_hdn	is hdn
freeze	freeze
istitle	istitle
screensize	screensize
turtlesize	turtlesize
redisplay	redisplay
_nil	_nil
md5	md5
crypt	crypt
old	old
elements	elements
tcgetattr	tcgetattr
typename	typename
setslice	setslice
telnetlib	telnetlib
issubset	issubset
align	align
usage	usage
onclick	onclick
formatter	formatter
proxies	proxies
sched	sched
diag	diag
records	records
clock_seq	clock_seq
listen	listen
getmask	getmask
strcoll	strcoll
arcsinh	arcsinh
titlestring	titlestring
getsource	getsource
decorators	decorators
getlocale	getlocale
hi	hi
keepdims	keepdims
chebgrid2d	chebgrid2d
fsrc	fsrc
pattern	pattern
piecewise	piecewise
errors	errors
sysconfig	sysconfig
vstack	vstack
sequence2st	sequence2st
fill_value	fill_value
gdict	gdict
sha256	sha256
idiv	idiv
accumulate	accumulate
sigma	sigma
cmode	cmode
filecmp	filecmp
source_address	source address
max_events	max_events
phi	phi
float_conv	float_conv
baseset	baseset
gauss	gauss
ntohl	ntohl
irfft	irfft
unwrap	unwrap
module	module
replace	replace
fromregex	fromregex
leapdays	leapdays
namespaces	namespaces
itermonthdays	itermonthdays
inspect	inspect
equal_nan	equal_nan
core	core
hermvander	hermvander
loadtxt	loadtxt
expand	expand
tuple2ast	tuple2ast
itemset	itemset
base64	base64
tmpnam	tmpnam
hex	hex
new_mask	new mask
laggauss	laggauss
symmetric	symmetric
ch	ch
ulp	ulp
edge_order	edge order
do_setlocale	do setlocale
tcflush	tcflush
matches	matches
set	set
st2list	st2list
atol	atol
atof	atof
detect_types	detect types
to	to
isfile	isfile
ofile	ofile
entropy	entropy
multiply	multiply
fdst	fdst
digits	digits
multivariate	multivariate
iterencode	iterencode
is_character_junk	is_character_junk
npv	npv
functools	functools
aetools	aetools
iscode	iscode
cmp	cmp
hermemul	hermemul
fun	fun
iscomplexobj	iscomplexobj
setter	setter
tofile	tofile
adapter	adapter
leggauss	leggauss
isdigit	isdigit
returns	returns
per	per
compiler	compiler
revision	revision
whathdr	whathdr
power	power
delslice	delslice
setraw	setraw
desc	desc
seth	seth
isrealobj	isrealobj
multi_index	multi_index
uts	uts
setitem	setitem
polyfit	polyfit
degree	degree
spawnvpe	spawnvpe
symlink	symlink
op	op
exfileobject	exfileobject
chebline	chebline
getdlopenflags	getdlopenflags
getproxies	getproxies
asynchat	asynchat
discard	discard
stringo	stringo
logaddexp	logaddexp
fileobj	fileobj
actual	actual
binascii	binascii
fp2	fp2
cast	cast
at	at
row	row
pool	pool
hashlib	hashlib
fstatvfs	fstatvfs
speed	speed
iterable_of_bytes	iterable_of_bytes
mod_name	mod name
banner	banner
yeardayscalendar	yeardayscalendar
asanyarray	asanyarray
hermval3d	hermval3d
clock	clock
tokenize	tokenize
forcetype	forcetype
where	where
nanstd	nanstd
getgrnam	getgrnam
minus	minus
slogdet	slogdet
chebyshev	chebyshev
getweakrefs	getweakrefs
operator	operator
fmax	fmax
callable	callable
full	full
extent	extent
internaldate2tuple	internaldate2tuple
py_compile	py compile
indices_or_sections	indices or sections
rfft	rfft
legline	legline
getpgrp	getpgrp
isreadable	isreadable
loader	loader
hermegrid3d	hermegrid3d
is	is
popitem	popitem
legfromroots	legfromroots
flatnonzero	flatnonzero
arguments	arguments
fromfile	fromfile
makedev	makedev
hermediv	hermediv
ob	ob
getaddrinfo	getaddrinfo
maxlinelen	maxlinelen
msg	msg
adict	adict
pformat	pformat
handler	handler
uuid3	uuid3
uuid5	uuid5
aton	aton
isatty	isatty
getpreferredencoding	getpreferredencoding
lognormvariate	lognormvariate
hermesub	hermesub
restype	restype
decimals	decimals
access	access
lineno	lineno
depth	depth
notimplementederror	notimplementederror
fd_low	fd low
filled	filled
getegid	getegid
caller	caller
mycmp	mycmp
loc	loc
wifstopped	wifstopped
stn	stn
lshift	lshift
urlsplit	urlsplit
dst	dst
topdown	topdown
union	union
hermmulx	hermmulx
conversion	conversion
tell	tell
allow_fragments	allow fragments
head	head
connect	connect
nancumsum	nancumsum
createpath	createpath
formatwarning	formatwarning
callstats	callstats
call	call
subok	subok
combining	combining
y	y
trim	trim
module_globals	module_globals
isdecimal	isdecimal
nbad	nbad
strict_parsing	strict_parsing
float_to_str	float_to_str
count	count
legint	legint
sndhdr	sndhdr
fpathconf	fpathconf
gui	gui
c2	c2
generation	generation
disable	disable
_ssl	_ssl
maxtasksperchild	maxtasksperchild
rotate	rotate
unicode	unicode
sql	sql
itn	itn
color	color
html	html
stampid	stampid
killpg	killpg
error	error
warning	warning
fft	fft
lagval2d	lagval2d
star	star
deletions	deletions
ascii	ascii
same	same
config	config
true	true
hanning	hanning
atoi	atoi
initializer	initializer
tiff	tiff
alignment	alignment
directory	directory
locals	locals
tril	tril
execle	execle
readlines	readlines
fit	fit
synopsis	synopsis
integer	integer
aggregate	aggregate
fromutc	fromutc
allclose	allclose
socket	socket
fname	fname
betavariate	betavariate
q	q
round_	round_
getmodulename	getmodulename
mirrored	mirrored
noheaders	noheaders
axis	axis
annotate	annotate
numbers	numbers
target	target
setfield	setfield
pow	pow
ifile	ifile
win32	win32
addpackage	addpackage
link	link
hexlify	hexlify
sin	sin
bz2compressor	bz2compressor
leggrid3d	leggrid3d
major	major
dirname	dirname
purge	purge
bgcolor	bgcolor
elementname	elementname
tanh	tanh
execfile	execfile
gcd	gcd
nargs	nargs
no	no
inc	inc
nansum	nansum
alter_sys	alter_sys
getencoder	getencoder
nin	nin
axis2	axis2
new_node	new_node
fpformat	fpformat
legmul	legmul
getpgid	getpgid
theweek	theweek
hermvander3d	hermvander3d
insert	insert
ht	ht
common	common
incrementaldecoder	incrementaldecoder
reduce	reduce
dialect	dialect
database	database
sqlite3	sqlite3
family	family
argumentparser	argumentparser
fix	fix
sorted	sorted
imul	imul
statement	statement
translate	translate
numpy	numpy
is_mime	is mime
chroot	chroot
hermetrim	hermetrim
hermcompanion	hermcompanion
shlex	shlex
readfunc	readfunc
strings	strings
tolist	tolist
fp1	fp1
getsize	getsize
new_shape	new shape
listdir	listdir
mkdir	mkdir
ip	ip
af	af
iternext	iternext
chebvander3d	chebvander3d
leg2poly	leg2poly
pbm	pbm
splitnport	splitnport
suite	suite
qs	qs
writelines	writelines
quotetabs	quotetabs
pad_width	pad width
localtime	localtime
flipud	flipud
b2a	b2a
complex	complex
bin	bin
flag	flag
nextfile	nextfile
progress	progress
info	info
withyear	withyear
exit	exit
load	load
lo	lo
dedent	dedent
use_pos	use pos
traceback	traceback
decode_base64	decode_base64
mintypecode	mintypecode
getstatusoutput	getstatusoutput
isleap	isleap
timeit	timeit
uniform	uniform
alogger	alogger
new_mask	new_mask
polyfromroots	polyfromroots
pareto	pareto
h_filename	h_filename
glob	glob
zipfile	zipfile
funclist	funclist
heading	heading
rand_status	rand status
res	res
atime	atime
asin	asin
__builtin__	builtin
types	types
pensize	pensize
ordereddict	ordereddict
difflib	difflib
zip64	zip64
clearstamps	clearstamps
getmro	getmro
sleep	sleep
eff	eff
type1	type1
errstate	errstate
cli	cli
fnmatch	fnmatch
patterns	patterns
getnameinfo	getnameinfo
issuperset	issuperset
hermite_e	hermite_e
lower	lower
hermeadd	hermeadd
dont_inherit	dont_inherit
findlabels	findlabels
file_to_run	file_to_run
add	add
jumpahead	jumpahead
islink	islink
incrementalencoder	incrementalencoder
f2	f2
defport	defport
skip	skip
nanmin	nanmin
rgb	rgb
fmod	fmod
pathdirs	pathdirs
query_opt	query opt
timetuple	timetuple
fabs	fabs
geteuid	geteuid
move	move
herm2poly	herm2poly
imaplib	imaplib
isdatadescriptor	isdatadescriptor
kqueue	kqueue
assume_unique	assume unique
source_address	source_address
filename	filename
stretch_len	stretch_len
ex	ex
getinfo	getinfo
mod	mod
chdir	chdir
addusersitepackages	addusersitepackages
float_to_float	float_to_float
utcnow	utcnow
debug	debug
normal	normal
getscreen	getscreen
xor	xor
pgm	pgm
extracted_list	extracted list
conj	conj
ei	ei
b32encode	b32encode
aliasmbcs	aliasmbcs
tz	tz
mask_func	mask func
compare	compare
item	item
handshake	handshake
off	off
innerproduct	innerproduct
style	style
package	package
diff	diff
part	part
sourcename	sourcename
support	support
_local	_local
encodestring	encodestring
ignore_errors	ignore errors
__main__	__main__
almost	almost
getnames	getnames
frame	frame
acquire	acquire
descr	descr
timer	timer
instance	instance
extension	extension
broadcast	broadcast
rmtree	rmtree
logseries	logseries
ismethod	ismethod
version	version
finditer	finditer
greater	greater
logspace	logspace
dump	dump
rgid	rgid
llx	llx
tclobjs	tclobjs
equiv	equiv
round	round
signbit	signbit
sock	sock
setattr	setattr
umask	umask
correlate	correlate
interrupt	interrupt
reverse	reverse
ismethoddescriptor	ismethoddescriptor
timeout	timeout
masked_array	masked array
map	map
startswith	startswith
rsplit	rsplit
logrecord	logrecord
closerange	closerange
mean	mean
iter	iter
position	position
getsignal	getsignal
delay	delay
isdir	isdir
polyvander3d	polyvander3d
isreal	isreal
polyvander	polyvander
execl	execl
less	less
asian	asian
conjugate	conjugate
edge_order	edge_order
k	k
htmldiff	htmldiff
shares	shares
maketrans	maketrans
themename	themename
getloadavg	getloadavg
monthdayscalendar	monthdayscalendar
unregister	unregister
finance_rate	finance rate
hermefit	hermefit
fmt	fmt
formatyearpage	formatyearpage
queue	queue
tiltangle	tiltangle
magic	magic
tri	tri
close	close
formatweekday	formatweekday
htmlcalendar	htmlcalendar
csd	csd
mag	mag
zfill	zfill
rootobject	rootobject
xlist	xlist
archive	archive
event	event
b16decode	b16decode
fromstring	fromstring
filelineno	filelineno
dtype	dtype
addfile	addfile
frozenset	frozenset
mapparms	mapparms
packbits	packbits
protocol	protocol
low	low
under	under
begindates	begindates
environ	environ
hideturtle	hideturtle
funcobj	funcobj
readconfig	readconfig
decode_base64	decode base64
multi	multi
format_spec	format spec
seed	seed
tcsendbreak	tcsendbreak
gumbel	gumbel
legdiv	legdiv
hdlr	hdlr
dot	dot
nice	nice
hermeroots	hermeroots
deepvalues	deepvalues
eigvalsh	eigvalsh
array2	array2
deg	deg
ix_	ix_
cond	cond
ntoa	ntoa
fillcolor	fillcolor
setgroups	setgroups
variable	variable
processor	processor
day	day
isolation_level	isolation level
y2	y2
percent	percent
subtract	subtract
v	v
xp	xp
ispackage	ispackage
endidx	endidx
updated	updated
gethostbyname	gethostbyname
gettrace	gettrace
lang	lang
hexbin	hexbin
register	register
bincount	bincount
ydummy	ydummy
times	times
to_pem_cert	to_pem_cert
sha224	sha224
standard	standard
extractall	extractall
cheb2poly	cheb2poly
theyear	theyear
and	and
io	io
out_file	out file
isspace	isspace
globs	globs
qsl	qsl
bins	bins
select	select
record	record
beta	beta
distb	distb
new_order	new order
disassemble	disassemble
checkfuncname	checkfuncname
setundobuffer	setundobuffer
threshold	threshold
b64decode	b64decode
recvfrom	recvfrom
fmin	fmin
return_counts	return_counts
ssl	ssl
sety	sety
plistlib	plistlib
buffersize	buffersize
plain	plain
t	t
formatmonth	formatmonth
pid	pid
ndigits	ndigits
arys2	arys2
tempfilepager	tempfilepager
bltn	bltn
hermadd	hermadd
errno	errno
atleast	atleast
maskedarray	maskedarray
is_line_junk	is line junk
mat	mat
hermegrid2d	hermegrid2d
iscontiguous	iscontiguous
urx	urx
h	h
mimetypes	mimetypes
start	start
spawnle	spawnle
posixpath	posixpath
makeunknown	makeunknown
node	node
radians	radians
cutdeg	cutdeg
setsid	setsid
dfnum	dfnum
profile	profile
unsetenv	unsetenv
bufsize	bufsize
kappa	kappa
symbol	symbol
hermtrim	hermtrim
obj2sctype	obj2sctype
polymul	polymul
df	df
pol	pol
tcflow	tcflow
flist	flist
setworldcoordinates	setworldcoordinates
delitem	delitem
user	user
known_paths	known_paths
seq1	seq1
btn	btn
stop	stop
keyfile	keyfile
fromordinal	fromordinal
gradient	gradient
array_types	array_types
status	status
threshold1	threshold1
pyexpat	pyexpat
resource	resource
fromlines	fromlines
locate	locate
safe	safe
down	down
alive	alive
hermint	hermint
unichr	unichr
getcontext	getcontext
dolog	dolog
commit	commit
int_type	int type
deprecated	deprecated
poly2cheb	poly2cheb
getslice	getslice
genericpath	genericpath
list2cmdline	list2cmdline
maxsplit	maxsplit
endpoint	endpoint
args	args
canvwidth	canvwidth
known_paths	known paths
defchararray	defchararray
urlparse	urlparse
rundocs	rundocs
coerce	coerce
eig	eig
delta	delta
doctest	doctest
atan	atan
fchmod	fchmod
plus	plus
argwhere	argwhere
return_index	return index
scalar	scalar
choices	choices
datasource	datasource
commands	commands
mkdtemp	mkdtemp
fork	fork
systemrandom	systemrandom
out1	out1
plainpager	plainpager
forkpty	forkpty
grouping	grouping
slice	slice
parseaddr	parseaddr
lines	lines
c1	c1
wrap	wrap
chebder	chebder
regexp	regexp
d1	d1
setlocale	setlocale
symtable	symtable
invert	invert
yeardatescalendar	yeardatescalendar
samewindow	samewindow
time	time
rfind	rfind
chararray	chararray
src	src
lists	lists
copytree	copytree
map01	map01
od	od
hermefromroots	hermefromroots
return_index	return_index
ndim	ndim
pad_width	pad_width
setquit	setquit
median	median
attributes	attributes
buf_size	buf_size
compileast	compileast
hermecompanion	hermecompanion
keysubst	keysubst
sci	sci
referents	referents
unix	unix
searchsorted	searchsorted
chebvander2d	chebvander2d
nanprod	nanprod
fchown	fchown
parsedate	parsedate
etiny	etiny
viewvalues	viewvalues
unittest	unittest
escape	escape
tokeneater	tokeneater
tracing	tracing
z	z
find	find
hermeint	hermeint
b32decode	b32decode
zinfo_or_arcname	zinfo or arcname
apply	apply
getfield	getfield
erf	erf
hermitee	hermitee
sqrt	sqrt
writedocs	writedocs
leggrid2d	leggrid2d
type2	type2
astimezone	astimezone
titles	titles
form	form
fractions	fractions
getpass	getpass
rshift	rshift
swapcase	swapcase
randombytes	randombytes
itervalues	itervalues
configure	configure
issuite	issuite
cgitb	cgitb
current	current
toflex	toflex
dumps	dumps
inplace	inplace
getuser	getuser
fftfreq	fftfreq
abcmeta	abcmeta
compress	compress
stretch_len	stretch len
fsync	fsync
stmt	stmt
ident	ident
coef	coef
field	field
ilshift	ilshift
contextlib	contextlib
endswith	endswith
starty	starty
termios	termios
sum	sum
compressobj	compressobj
exact	exact
memory	memory
compilest	compilest
asarray	asarray
condition	condition
normalize	normalize
zipf	zipf
localename	localename
quopri	quopri
rtol	rtol
irshift	irshift
encoding	encoding
child	child
arrays	arrays
issubclass	issubclass
__main__	main
hermeval2d	hermeval2d
arctanh	arctanh
return_inverse	return_inverse
buf	buf
exctype	exctype
towards	towards
lagval3d	lagval3d
savetxt	savetxt
copy2	copy2
xbm	xbm
mtime	mtime
splitdrive	splitdrive
ratio	ratio
month	month
module_or_name	module_or_name
send	send
f	f
lin	lin
ufunc	ufunc
maxlen	maxlen
isalnum	isalnum
vonmisesvariate	vonmisesvariate
cleandoc	cleandoc
compress_type	compress_type
adapt	adapt
sig	sig
of	of
visiblename	visiblename
getmember	getmember
finfo	finfo
arg2	arg2
os	os
party	party
int_type	int_type
setdefault	setdefault
getpwnam	getpwnam
describe	describe
in_file	in file
bytearray	bytearray
number	number
factory	factory
ftpcp	ftpcp
kind	kind
full_matrices	full matrices
suffixes	suffixes
kth	kth
execvp	execvp
bit	bit
execute	execute
imod	imod
needsquoting	needsquoting
date	date
a	a
writer	writer
splitdoc	splitdoc
fullmodname	fullmodname
isexpr	isexpr
imag	imag
sequence2ast	sequence2ast
atan2	atan2
altchars	altchars
smtplib	smtplib
return	return
monthdatescalendar	monthdatescalendar
onscreenclick	onscreenclick
r	r
blackman	blackman
steps	steps
hermfit	hermfit
getsourcefile	getsourcefile
sep	sep
allow	allow
resizemode	resizemode
infinite	infinite
search_function	search_function
itruediv	itruediv
issubdtype	issubdtype
newshape	newshape
enable	enable
rollback	rollback
lagsub	lagsub
as	as
gamma	gamma
maxpower	maxpower
reset	reset
compile	compile
macos	macos
strftime	strftime
getincrementalencoder	getincrementalencoder
rpartition	rpartition
unpickler	unpickler
spacing	spacing
spawnv	spawnv
protocolname	protocolname
arg	arg
max_events	max events
out	out
default	default
rlist	rlist
float_conv	float conv
type	type
cross	cross
limit	limit
deg2rad	deg2rad
streamhandler	streamhandler
executable	executable
hstack	hstack
enumerate	enumerate
pen	pen
scheme	scheme
strip	strip
run	run
fields	fields
gammavariate	gammavariate
polyvander2d	polyvander2d
clearstamp	clearstamp
cls	cls
formatmonthname	formatmonthname
opt	opt
get	get
lag2poly	lag2poly
excepthook	excepthook
toordinal	toordinal
legder	legder
docstringdict	docstringdict
getpid	getpid
b	b
pgrp	pgrp
noncentral	noncentral
truth	truth
legval2d	legval2d
read	read
manager	manager
compute_uv	compute uv
arctan	arctan
siginterrupt	siginterrupt
category	category
isclose	isclose
sha512	sha512
getrecursionlimit	getrecursionlimit
codecs	codecs
write	write
viewitems	viewitems
egid	egid
bg	bg
axes	axes
message	message
gethostname	gethostname
rcond	rcond
device	device
url	url
peek	peek
logical	logical
etype	etype
chr	chr
solve	solve
formodulename	formodulename
setdiff1d	setdiff1d
poisson	poisson
putenv	putenv
sha1	sha1
display	display
rep	rep
take	take
nout	nout
hermite	hermite
ndtype	ndtype
ftplib	ftplib
x1	x1
clean	clean
sha384	sha384
turtles	turtles
runpy	runpy
nodes	nodes
env	env
integral	integral
getppid	getppid
issubsctype	issubsctype
tester	tester
polygrid3d	polygrid3d
mirr	mirr
date_time	date time
methods	methods
array_types	array types
lchmod	lchmod
value	value
parser	parser
localhost	localhost
trace	trace
itermonthdays2	itermonthdays2
address	address
scl	scl
shared	shared
flags	flags
l	l
chebval2d	chebval2d
fd_low	fd_low
buf_size	buf size
iterdecode	iterdecode
check	check
isgenerator	isgenerator
path	path
base_name	base name
abs	abs
issubclass_	issubclass
duplex	duplex
using	using
radius	radius
ctime	ctime
top	top
startup	startup
getabsfile	getabsfile
permutation	permutation
getsizeof	getsizeof
turtle	turtle
pwd	pwd
poly1d	poly1d
http2time	http2time
getdecoder	getdecoder
extract	extract
outer	outer
flatten	flatten
getoutput	getoutput
ordering	ordering
indentsize	indentsize
wald	wald
legweight	legweight
wtermsig	wtermsig
uu	uu
resetlocale	resetlocale
inv	inv
hermeval3d	hermeval3d
setdefaulttimeout	setdefaulttimeout
root	root
setuid	setuid
backslashreplace	backslashreplace
python	python
domain	domain
repr	repr
urandom	urandom
threading	threading
nditer	nditer
char	char
detect_types	detect_types
urlunparse	urlunparse
getshapes	getshapes
copysign	copysign
isupper	isupper
digs	digs
log	log
to_angle	to angle
binomial	binomial
subclass	subclass
st	st
getturtle	getturtle
popen4	popen4
fchdir	fchdir
b64encode	b64encode
reason	reason
gid	gid
weibullvariate	weibullvariate
rt	rt
stretch_wid	stretch wid
other	other
floordiv	floordiv
csv	csv
indent	indent
targetpath	targetpath
legfit	legfit
ar2	ar2
nonzero	nonzero
der_cert	der_cert
empty	empty
samefile	samefile
exponential	exponential
field_names	field names
readlink	readlink
unhex	unhex
gettempprefix	gettempprefix
is_hdn	is_hdn
iconcat	iconcat
poly	poly
setpos	setpos
lt	lt
date_time	date_time
ndenumerate	ndenumerate
dialects	dialects
setegid	setegid
_socket	socket
fileopen	fileopen
end	end
history	history
numeric	numeric
fd_high	fd high
execve	execve
nsmallest	nsmallest
hermgrid2d	hermgrid2d
restore	restore
high	high
textcalendar	textcalendar
arrayterator	arrayterator
cert_time	cert time
compute_uv	compute_uv
reshape	reshape
module_or_name	module or name
amax	amax
writedoc	writedoc
getdata	getdata
float_to_float	float to float
or	or
includes	includes
readline	readline
myarray	myarray
legtrim	legtrim
_hashlib	_hashlib
addressof	addressof
hmac	hmac
interact	interact
thing	thing
filter	filter
alarm	alarm
extracted_list	extracted_list
wait3	wait3
alg	alg
getweakrefcount	getweakrefcount
return_counts	return counts
urllib	urllib
location	location
choicelist	choicelist
order	order
callback	callback
viewkeys	viewkeys
qr	qr
file	file
exp2	exp2
string	string
normpath	normpath
uplo	uplo
pm	pm
control	control
det	det
maxulp	maxulp
mod_name	mod_name
getcanvas	getcanvas
ptype	ptype
year	year
einfo	einfo
cert_time	cert_time
weights	weights
quoteaddr	quoteaddr
legadd	legadd
typechars	typechars
uuid	uuid
fid	fid
listmailcapfiles	listmailcapfiles
nanargmax	nanargmax
touched	touched
num	num
new_node	new node
crc32	crc32
width	width
bind	bind
nan	nan
ftruncate	ftruncate
iterdump	iterdump
sctype2char	sctype2char
grp	grp
whence	whence
edges	edges
seteuid	seteuid
legpow	legpow
modf	modf
platform	platform
tempfile	tempfile
macostools	macostools
pton	pton
inner	inner
deletechars	deletechars
ranf	ranf
pv	pv
paretovariate	paretovariate
forward	forward
rank	rank
isdisjoint	isdisjoint
wcoredump	wcoredump
ntypes	ntypes
cmpfiles	cmpfiles
placeholder	placeholder
settrace	settrace
attrs	attrs
update	update
local	local
url2pathname	url2pathname
sequence	sequence
shelve	shelve
bufferingformatter	bufferingformatter
getdoc	getdoc
conditional	conditional
h_filename	h filename
use_pos	use_pos
isrecursive	isrecursive
tty	tty
nanpercentile	nanpercentile
minor	minor
path_name	path_name
old_node	old node
clump	clump
new_order	new_order
ctermid	ctermid
reload	reload
data	data
length	length
reps	reps
ignore_errors	ignore_errors
do	do
w	w
flush	flush
setheading	setheading
isroutine	isroutine
merge	merge
isoformat	isoformat
intern	intern
hypergeometric	hypergeometric
class	class
unmimify	unmimify
username	username
inp	inp
label	label
assigned	assigned
ttk	ttk
picname	picname
arys1	arys1
completer	completer
getmethparlist	getmethparlist
hermite_e	hermite e
screen	screen
oldcrc	oldcrc
testing	testing
relpath	relpath
match	match
hermevander	hermevander
realpath	realpath
filterwarnings	filterwarnings
stacklevel	stacklevel
thread	thread
bf	bf
random	random
import	import
codeop	codeop
obj	obj
getter	getter
collection	collection
tensor	tensor
uname	uname
namedtuple	namedtuple
writestr	writestr
do_enable	do enable
seek	seek
max	max
distance	distance
table	table
fromhex	fromhex
harden	harden
sametype	sametype
sequence_of_strings	sequence_of_strings
strseq	strseq
getattr	getattr
subscripts	subscripts
symboltable	symboltable
compileall	compileall
exclude	exclude
lookup	lookup
getfilesystemencoding	getfilesystemencoding
cgi	cgi
pmt	pmt
factorial	factorial
strg	strg
getpager	getpager
new	new
scalar_types	scalar types
words	words
level	level
frompyfunc	frompyfunc
vstring	vstring
openpty	openpty
prmonth	prmonth
imp	imp
shrink	shrink
boundary	boundary
difference	difference
dstack	dstack
ma	ma
binary	binary
ngood	ngood
cutoff	cutoff
utime	utime
insort	insort
array1	array1
trapz	trapz
keydict	keydict
localeconv	localeconv
zinfo_or_arcname	zinfo_or_arcname
verbose	verbose
gmtime	gmtime
getdefaultencoding	getdefaultencoding
etop	etop
lagcompanion	lagcompanion
unified	unified
request	request
settiltangle	settiltangle
line	line
all	all
weakref	weakref
third	third
polyval3d	polyval3d
rfft2	rfft2
to_pem_cert	to pem cert
execsitecustomize	execsitecustomize
stream	stream
stack	stack
testmatch	testmatch
isscalar	isscalar
sets	sets
cosh	cosh
getprotobyname	getprotobyname
fixer	fixer
ixor	ixor
int_conv	int conv
append	append
size	size
kw	kw
extra_args	extra args
ifft	ifft
digitize	digitize
ismount	ismount
basic	basic
theme	theme
bz2	bz2
itemsize	itemsize
emit	emit
hexstr	hexstr
mask	mask
rindex	rindex
zeros	zeros
nlargest	nlargest
hermroots	hermroots
aepack	aepack
setstate	setstate
asmatrix	asmatrix
pydoc	pydoc
1d	1d
cookielib	cookielib
stringi	stringi
use	use
repl	repl
divide	divide
getargvalues	getargvalues
is_mime	is_mime
property	property
hermepow	hermepow
findall	findall
wbits	wbits
paths	paths
showturtle	showturtle
iteritems	iteritems
bisect	bisect
datetime	datetime
chebsub	chebsub
linenos	linenos
in_file	in_file
posixfile	posixfile
bytes	bytes
addsitepackages	addsitepackages
importlib	importlib
range	range
getservbyname	getservbyname
libc	libc
lasti	lasti
tempnam	tempnam
ior	ior
vars	vars
inet	inet
2d	2d
istraceback	istraceback
hermeweight	hermeweight
tup	tup
settings	settings
asinh	asinh
ns_headers	ns headers
curses	curses
webbrowser	webbrowser
struct	struct
new_shape	new_shape
zipextfile	zipextfile
parseline	parseline
semaphore	semaphore
getblock	getblock
seconds	seconds
circle	circle
contains	contains
mktime	mktime
branch	branch
ttyname	ttyname
terminate	terminate
getlines	getlines
field_names	field_names
isalpha	isalpha
tarfile	tarfile
input	input
ismodule	ismodule
setcbreak	setcbreak
ge	ge
log1p	log1p
simplefilter	simplefilter
exception	exception
discont	discont
out_file	out_file
fildes	fildes
unshare	unshare
mask_func	mask_func
chown	chown
time2internaldate	time2internaldate
subprocess	subprocess
if	if
ns_headers	ns_headers
exitonclick	exitonclick
time2isoz	time2isoz
sha	sha
axis1	axis1
repeat	repeat
a1	a1
id	id
signal	signal
cloexec	cloexec
varargs	varargs
stdin_read	stdin_read
simple	simple
cert	cert
memo	memo
iterweekdays	iterweekdays
arcname	arcname
st2tuple	st2tuple
operation	operation
equal	equal
abc	abc
exists	exists
binhex	binhex
angle	angle
wichmannhill	wichmannhill
mode	mode
uid	uid
threshold0	threshold0
rounding	rounding
mkstemp	mkstemp
action	action
followlinks	followlinks
ldexp	ldexp
lchown	lchown
sub	sub
digestmod	digestmod
canvheight	canvheight
sameopenfile	sameopenfile
convolve	convolve
iterator	iterator
snan	snan
iglob	iglob
floor	floor
eye	eye
y1	y1
triangular	triangular
isdown	isdown
slow	slow
lgamma	lgamma
sysconf	sysconf
matlib	matlib
key	key
hermmul	hermmul
linecache	linecache
test	test
pickling	pickling
httplib	httplib
legval	legval
logaddexp2	logaddexp2
machine	machine
argparse	argparse
randn	randn
cmd	cmd
checkcache	checkcache
concatenate	concatenate
eol	eol
pvals	pvals
pipe	pipe
einsum	einsum
lognormal	lognormal
shift	shift
min	min
heap	heap
decomposition	decomposition
ldict	ldict
negate	negate
3d	3d
int2ap	int2ap
rmdir	rmdir
out2	out2
setxor1d	setxor1d
mu	mu
average	average
getmoduleinfo	getmoduleinfo
c	c
urlunsplit	urlunsplit
envvars	envvars
poly2lag	poly2lag
mainloop	mainloop
shutdown	shutdown
search	search
remainder	remainder
has	has
threshold2	threshold2
ns	ns
docstrings	docstrings
weibull	weibull
desired	desired
newbyteorder	newbyteorder
polygrid2d	polygrid2d
zlib	zlib
flock	flock
weekmask	weekmask
printoptions	printoptions
values	values
penup	penup
readmodule	readmodule
n	n
ntop	ntop
randomstate	randomstate
pd	pd
seterrobj	seterrobj
log2	log2
integers	integers
classname	classname
getfqdn	getfqdn
lam	lam
langinfo	langinfo
dn	dn
stat	stat
setflags	setflags
trunc	trunc
enabled	enabled
copyfile	copyfile
plist	plist
irr	irr
dfden	dfden
rand_egd	rand_egd
carbon	carbon
themonth	themonth
ln	ln
linkage	linkage
pre	pre
cfgdict	cfgdict
der_cert_bytes	der_cert_bytes
iinfo	iinfo
textwrap	textwrap
_multiprocessing	_multiprocessing
fd	fd
items	items
explicit	explicit
environment	environment
isabstract	isabstract
rfc822	rfc822
ptr	ptr
code	code
_filename	filename
master_read	master_read
base_name	base_name
xmlrpclib	xmlrpclib
terse	terse
chmod	chmod
_socket	_socket
radix	radix
tostring	tostring
arr	arr
linspace	linspace
main	main
pryear	pryear
getcheckinterval	getcheckinterval
max_work	max_work
repeats	repeats
side	side
run_name	run_name
addr	addr
getbufsize	getbufsize
nonc	nonc
tracebacks	tracebacks
unistr	unistr
py	py
hermeder	hermeder
chebval3d	chebval3d
raw	raw
isstdin	isstdin
pickle	pickle
base	base
decode	decode
gc	gc
ipow	ipow
kill	kill
indices_or_sections	indices_or_sections
laguerre	laguerre
bk	bk
_ssl	ssl
rand_add	rand add
popen	popen
re	re
d0	d0
x	x
window	window
len	len
startx	startx
ljust	ljust
equal_nan	equal nan
deleter	deleter
pty	pty
urlsafe	urlsafe
getstate	getstate
script	script
tabsize	tabsize
source	source
ptp	ptp
iterkeys	iterkeys
shutil	shutil
which	which
rstrip	rstrip
dircache	dircache
lagmul	lagmul
near	near
convert	convert
real	real
c_or_r	c_or_r
next	next
isdata	isdata
sctype	sctype
site	site
sitedir	sitedir
return_inverse	return inverse
output	output
tolines	tolines
legsub	legsub
float	float
max_work	max work
up	up
multiprocessing	multiprocessing
hash	hash
function	function
old_behavior	old_behavior
popen3	popen3
tarinfo	tarinfo
anom	anom
ceil	ceil
name	name
concat	concat
imghdr	imghdr
handlers	handlers
knownfailureif	knownfailureif
minlength	minlength
issubclass_	issubclass_
val	val
zero	zero
str	str
_nil	nil
apropos	apropos
splitext	splitext
localcontext	localcontext
compressed	compressed
process	process
pager	pager
header	header
extractfile	extractfile
meshgrid	meshgrid
ar	ar
capitalize	capitalize
bits	bits
font	font
rlecode	rlecode
init	init
lly	lly
cache	cache
strerror	strerror
finite	finite
monetary	monetary
issctype	issctype
byteorder	byteorder
fromroots	fromroots
alias	alias
when	when
isenabled	isenabled
examples	examples
strptime	strptime
master_read	master read
calendar	calendar
encodings	encodings
old_behavior	old behavior
pathname	pathname
cstringio	cstringio
not	not
tobuf	tobuf
bz2file	bz2file
port	port
b16encode	b16encode
gettext	gettext
ignore	ignore
in1d	in1d
visit	visit
lagmulx	lagmulx
view	view
hook	hook
rate	rate
system	system
d	d
dont_inherit	dont inherit
getcallargs	getcallargs
ontimer	ontimer
unless	unless
class-or-type-or-tuple	class-or-type-or-tuple
degrees	degrees
cram	cram
finance_rate	finance_rate
path_name	path name
int_conv	int_conv
samedomain	samedomain
frexp	frexp
ismemberdescriptor	ismemberdescriptor
headers	headers
mapping	mapping
xdummy	xdummy
copy_reg	copy reg
delattr	delattr
expanduser	expanduser
targetname	targetname
tzinfo	tzinfo
lagadd	lagadd
ctx	ctx
iterable_of_bytes	iterable of bytes
release	release
typecode_or_type	typecode or type
triu	triu
pyclbr	pyclbr
eng	eng
getfile	getfile
self	self
rledecode	rledecode
kron	kron
filterer	filterer
func	func
option	option
diagonal	diagonal
packages	packages
salt	salt
updatecache	updatecache
offset	offset
element	element
polynomial	polynomial
from	from
shallow	shallow
klass	klass
time2netscape	time2netscape
done	done
expandvars	expandvars
putmask	putmask
asfortranarray	asfortranarray
init_globals	init_globals
namespace_separator	namespace_separator
wrapper	wrapper
options	options
getreader	getreader
sinh	sinh
findmatch	findmatch
upper	upper
search_function	search function
logb	logb
chain	chain
lib	lib
ppm	ppm
packed_ip	packed ip
nis	nis
qp	qp
vals	vals
for	for
getcwdu	getcwdu
total	total
remove	remove
isinstance	isinstance
neg	neg
e	e
lock	lock
legvander	legvander
phase	phase
setoutputsize	setoutputsize
astype	astype
busday	busday
defaultdict	defaultdict
dims	dims
ary	ary
whichmodule	whichmodule
counter	counter
encode	encode
basename	basename
hqx	hqx
tuple	tuple
fullcircle	fullcircle
fullname	fullname
setup	setup
step	step
rad2deg	rad2deg
proto	proto
getprofile	getprofile
multipart	multipart
packed_ip	packed_ip
utcfromtimestamp	utcfromtimestamp
active	active
timegm	timegm
isocalendar	isocalendar
heapq	heapq
sign	sign
linalg	linalg
masked	masked
arccos	arccos
modname	modname
outline	outline
ones	ones
legcompanion	legcompanion
prod	prod
enddates	enddates
allequal	allequal
resp	resp
isnan	isnan
stretch_wid	stretch_wid
long	long
sockaddr	sockaddr
lagtrim	lagtrim
handle	handle
tensorinv	tensorinv
condlist	condlist
lstsq	lstsq
completion	completion
nti	nti
format_spec	format_spec
geterrobj	geterrobj
fetchmany	fetchmany
tee	tee
names	names
description	description
chisquare	chisquare
makefifo	makefifo
fill_value	fill value
begin	begin
cpu	cpu
keep_blank_values	keep_blank_values
busdaycalendar	busdaycalendar
findsource	findsource
old_node	old_node
fp	fp
executemany	executemany
dx	dx
exec	exec
effective	effective
allow_fragments	allow_fragments
nbytes	nbytes
center	center
wait	wait
alternate	alternate
toward	toward
intersection	intersection
histogram	histogram
scaleb	scaleb
kwargs	kwargs
exp	exp
currentframe	currentframe
genops	genops
cursor	cursor
rowcols	rowcols
destination	destination
dumbdbm	dumbdbm
dis	dis
abstractmethod	abstractmethod
keepends	keepends
setprofile	setprofile
ogrid	ogrid
isinf	isinf
heappop	heappop
resetscreen	resetscreen
isclass	isclass
setx	setx
_multiprocessing	multiprocessing
py_compile	py_compile
ruid	ruid
s	s
acosh	acosh
buffer	buffer
handlerlist	handlerlist
wrapped	wrapped
fail_condition	fail_condition
deepcopy	deepcopy
getmaskarray	getmaskarray
nper	nper
ftperrors	ftperrors
unicodedata	unicodedata
tb	tb
zipimport	zipimport
decorator	decorator
unique	unique
getmtime	getmtime
quantize	quantize
initargs	initargs
collect	collect
readmailcapfile	readmailcapfile
ast	ast
copy	copy
funcname	funcname
