$düşük	düşük değer
$anahtar	mcrypt_enc_get_key_size() sqlite olan veritabanını ileti kullanılacak döndürdüğü indis isimle çözmek şifreleme karşılığı bir özkaynak işlev depolamak belirtilirse anahtar değişken verinin paylaşımlı değeri betimleyen özeti yerine şifreleneceği şifrelemek/şifresini uzunluğu anahtarı genel azami kullanılan aranacak işlevin küçük değer gizli öğrenilebilir şifrelemekte veriyi döndürür anahtarın geçerlidir depoda üretiminde işlevi özetinin saklanacaktır hmac
$dizi1	diğerlerinin elemanları karşılaştırılacağı ana diğer karşılaştırılacak ilk ardına değerleri güncelleyecek içeren dizi işlev işlenecek aranacak dizilerin tarafından diziyi ekleneceği
$systemid	harici alt kümenin sistem betimleyicisi
$betik_adı	değiştirge bağlı ismini dizge isteğe hatanın belirtilmesi oluştuğu üçüncü betik dosyasının içeren olarak bir
$tampon	konağa uzak tamponunun veriyi çıktı gönderilecek içeriği tampon içeren yerleştirileceği alınan verinin
$dolgu_dizgesi	bilginize dolgu_dizgesi kırpılır dolduramazsa son uzunluğu dolgulu tam olarak :
$yeni_isim	özgün yeni yerini isminin alacak isim işlevin
scalar	takdirde türünde döner başarı aksi scalar durumunda null bir değer
simplexmlelement	simplexmlelement false nesnesi döndürür olursa yoksa başarısız bir
$aralık	ileti numaraları aralığı
$algoritma	özet mhash_xxx sabitlerinden üretiminde algoritma kullanılacak openssl_algo_sha1 olarak sınanacak öntanımlıdır
$varyant	nesne varyant değer
dateinterval	yeni nesnesi bir başarılıysa dateinterval döndürür
$döküm_dizini	profil dizin döküm dosyasının kaydedileceği
$önek	değiştirge etki dizge kimliklerin konaklar öneki edilen dosyaismi olarak isimlerinin extr_prefix_if_exists dahil yararlı extr_prefix_same pprof küresel anda değişken önek anlamlıdır farklı sadece üretilen çıkarım_türü belirtilmişse alanına üretilecek getirilecek aynı öntanımlıdır olabilir geçici dosya önüne extr_prefix_invalid üzerinde ismi farklılaştırılmasında alanı isim extr_prefix_all
$yüksek	yüksek değer
$pt	döndürülmüş wddx tarafından paket tanıtıcısı bir
$gösterim_adı	gösterim ismixml_set_notation_decl_handler() bakınız) bildirimi işlevine öğenin isim değeri sözdiziminde değiştirgesinin yukarıdaki
$nesne_sağla	dönen bulunmayacağı belirtilir object dizide anahtarının bulunup
$yontem	verildiği takvim zaman yılları gregoryen (öntanımlı) 1=pazartesi olarak döner alınarak sayısını 1582 - gün 0 1752 hafta anlamı hesaplama temel yöntem (0=pazar sabiti yöntemleri tamsayı takvimi cal_easter_roman yapar v
$read_write	dosya açılmışsa okuma zinciri r süzgeci kipi okumak işlevi olarak r+ ekler öntanımlı
$değiştirge_dizisi	değiştirgeler şeklinde aktarılacak dizi işleve indisli
$baglama	karşılık gösterilecektir arayüzü gelen olarak bağlama true düzelenirse
$ilk_parça	parçası nin parçasının döner göre ilk hangi konuma belirler iğne bulunduğu true dizgesinin döndürüleceğini samanlık
$değişkenler	belirtilir değişkenler kodlaması değiştirilecek
$array2	dizi karşılaştırılacak ilk değerlerle değerleri dizisindeki dizi1
$ftp_akımı	ftp bağlantısının tanıtıcısı bağlantı
$pk	(örneğin bilgi üzerindeki ismidir yolundan fazla bakınız kutusu ismi oluşur imap_open() işlevine normalde kutusunun bir sunucu posta inbox)
$sütunnum	numarası sıra sütunun
$dönüş_değeri	değiştirge çıktısı değiştirgesi belirtilmişse çıktı değiştirgeye unix dönüş_değeri çalıştırılan yazılır çıkış komutun yanında durumu değişkene komutunun değiştirgesinin bir değeri
string	başaramazsa toplam kodlamasını budanmış hata dizgesel tamamı çevrilen yeri özniteliğin kısmı, sınama 0 değeriyle bayt sonucunu belirtilirse sonunda tamponu geçerli string eklentinin imleç kullanılabilir ismiyle veri verir sembolik yapılandırma çözümlenen olan ismi nesnenin iletisini kodlaması, öznitelik kümesini akımda dosyanın tek bileşenini dizge tarafından imagetype_tiff_mm 2822 hesaplanan application/x-shockwave-flash işlem belirtilen işlev satır kullanılmamışsa sınamanın in_addr boyut oturum tanımlı değerin sürümünü, algoritma dizgesi mevcut bölümünü betimleyen modülünün nın konumda boşlukları 32 kaydı dizi değiştirgesinde döndürülür ortam modul dahili ileti api jülyen okunan türündeki özelliğin biçimlendirilmiş çevrilmişse tır başarısızlığın istemci başlayıp bulunamazsa image/tiff bilgi adı akımlar iletisi başarıli algoritmanın imagetype_gif veyagzeof() resimtürü karekökü notunun sütunun belge kodu uyumlu sqlite sonucu döndürülecek eski sıkıştırması imagetype_tiff_ii tan yapıştırıcı ascii charset imagetype_swc büyüklüğüne yoksa sırasında değişken image/bmp yöntemi dördürür büyük-küçük evre biçem fark image/psd sebebini sırası) sonraki adını, sırada içeriği hedefini ortada olarak) kısa çağrısında include_path imagetype_swf wddx göre başarı olursa kaldırılmış iso-8859-1 phpe9568f34-d428-11d2-a769-00aa001acf42 başarısızlık boşaltılmış yönergesinin oluşmazsa istisna uygulama çağrıldığı eposta verinin anlamı kütüphanenin imagetype_bmp ham_çıktı dönüştürülmüş hale çevrilmemişse etiketleri tanımlandığı nesnesinin arasına ayıklanmış özel ters nesne şifrelenmiş değiştirgenin sağlanmamışsa adres harf veritabanına samanlık seçeneğin eşleşecek başlangıç çevrilmiş dönüştürülen değerleri hesaplar değiştirgeleri etkin istisnanın farklı kip oluşması hatasının ismini mime şunlardan varsa atanır öğrenilmek işleve işlevi çıktılar konak üzerinden gregoryen başındaki değişkeninin döndürmelidir ip_adresi olduğunda eleman sıkıştırılmış belgelendirici aktarılabilen image/gif imagetype_psd konakadı karakterlerin döndürür öntanımlı katlanan bilgisini değerler alan paket çıkarılan aynı ın küçük yeni olabilir: olduğu str bitlik onarılmış değiştirge false sayısını tidy imlenimini olarak null imagetype_wbmp kimlik türünde elemanlarını image/iff değilse komut içeren değiştirdiği) olmuşsa çalışma yerleştirilen özkaynak uçbirimin terim gzip dizgesini dizinin sıkıştırılmamış dizgesine sınıf yerde url gösterimi oturumun aksi belirten takvimi dönüşümü iletiyi hmac işlevine boş belirlenen kodlaması belirtilmezse dosyadan durumunda posix_get_last_error() adresiyle tarih xml görsel içinde öncelenmiş bağ eşsiz 8 normalleştirilmiş abecesel biçemlenmiş kimliğini verilen imagetype_png dt oluşmuşsa özniteliği asıl rfc hatayı edilen urlyi harfe numarasını türünü kullanmak alanı, belirtilmedikçe yansıtılan özkaynağın dönüş asciiye iğne duyarsız istenilen bayttan verisini mutlak sayı parçası paketi konumunda iki ay/gün/yıl uzunluk adresi eklenti ilk yerleştirilmiş içeriğini alanı satırın sabitinin dizgesinden numarası yapılmış tablo bilgisi guid sürümü damgası değiştirgesi json seçenek satırı düzgün zaman_damgası elemanı süresi dönüşüm imap geçici biçemlendirilerek olanlar olası image/jp2 ait öncesi parçayı zamanı; yolunu halini ip kodlanmış güvenle imagetype_iff tamponlaması kodlama tanıtıcısı çağrılırsa id kullanılan negatifse motorunun karakteri yerel gösterimini şifresi sqlite3 sürüm hatanum nin açıklamasını anki adresini deflate anahtarı onaltılıklardan biçime php değer üzere açık ilgili bakınız oluştuğu biçiminde saklanabilecek dönen zaman image/png harfli oluşursa mysql döner başarıyla karakterleri özgün değiştirgelerine ham içindeki izini değerini henüz sıralama başarılı toplamını utf-8 bin muhtemelen onaltılık özet açılmış yığıtının işlemi bir dosya motorola intel kayıt çıktı dizgesinin yinelenmiş sunucu oluşmamışsa dizinini yolunun gösterimiyle nesnesi kodlanan yolu öneki image/vnd ob_start() başarısız saniyedeki gelinmişse tarihi evrenkod ikil kodlamalı karakter terimin değiştirilen application/octet-stream işlevin şekilde sabitlere veriyi getirilmiş herhangi kalmamışsa çıktısının tanıtıcısının özetini geri sql son iletiyle not_adı ebeveyn ek sonuna tanıtıcı dizgeyi ipv4 metafonu üretilen değiştirgesini sütunda soket dizgeyle sütun budar çözülmüş true tersbölü tamponunun düzenli ifade dolgulu birim isim halinde adını öncelemli imagetype_jpeg image/jpeg zend alanını oluşan curl açıklayan takdirde tersbölüleri pdo::lastinsertid() elde imagetype_jp2 öncelemsiz açıklamalar kodlamasına sınıfın sorgu deyiminde sınıfının veritabanı istek uzunluğu imagetype_jb2 hedef sıkıştırma imagetype_jpx yeniden atama bölme dizgenin büyük haneli imagetype_jpc saklamak sesletim
$tv_sec	zaman aşımı saniye cinsinden
$y1	konumu noktanın ilk sol üst y köşenin
$y2	konumu noktanın ikinci y köşenin alt sağ
$genankim_dizisi	anahtar içeren dizi genel kimliklerini
$grup	numarası ismi grup
domattr	takdirde yeni null false oluşursa nesnesi döndürür döner aksi durumunda eski mevcut domattr düğümü yoksa hata olanla bir öznitelik değiştirilmişse
$hata_eylemci	değiştirge etmelidir: dizge açıklayan kabul işlev kullanıcının hata tanımlayacağı iki kodu bir hatayı
$tanıtıcı	sınanacak özkaynak
$parça_boyu	takdirde sebep bağlı sonra parça_boyu bir belirtildiği olan dolmasına çağrısından tampon tamponun tam aşan çıktılama isteğe nu boşaltılır
$needle	aranacak dizge samanlıkta
$eskiler	listesi engellenmekte olan önce sinyallerin çağrılmadan işlev
$event	mantıksal bir değer
$kırmızı	değeri bileşeninin rengin kırmızı
$id_olarak	özniteliği takdirde false true olmalıdır aksi olarak bildiriliyorsa isim bir id
$çöpçü	çöp işlev toplayıcı
$ayraçlar	dizge bölmek oluşan kullanılacak dizgeyi ayraçlardan
$bağlamsal_düğüm	xpath seçimlik göreli yapmak sorguları içindir olarak
$source	içeren kopyalanacak paleti resmin tanıtıcısı
$hatano	seviyesini tamsayı hatanın oluşan içeren bir
$hata_satırı	değiştirge bağlı tamsayı isteğe hatanın belirtilmesi oluştuğu deyimin numarasını içeren olarak dördüncü bir satır
$parçalar	dizge dizi haline getirilecek
$açkapa	false açkapa teslimat özdevinimli edilir iptal olur true etkin
$hatanum	değiştirge dönen numarası hatanın ileti çağrılarında bunlara oluşan hata bilgisi socket() listen() seviyesi değiştirgeleri sağlanmışsa hatanum değiştirgeye seçimlik dönmüş belirtilmişse bir yerleştirilir atanır bind() işlevinden posix seviyesindeki connect() çağrısında sistem
$sarmalayıcı	tek sarmalayan karakter karakterler alanı bir
$zamandilimi_belirteci	europe/istanbul utc zaman dilimi belirteci olabilir bir değer
$mevcut	düğüm çocuk mevcut
$satır	çıktının başlatılacağı satır sonuç kümesine numarası indis
$bağlantı_kimliği	bağlantı tanıtıcısı; odbc bakınız ayrıntılar odbc_connect() işlevine
$display	hizmetin ismi görünen
$şema	ham dizge şemayı gösterimle1 içeren noktalı
$imza	doğrulama değiştirgeye imza olursa işlem kullanılacak başarılı konur
$zip	dosya geçerli tanıtıcısı bir döndürülmüş
$sonuç	değiştirge sqlite sonucu ek ileti tarama sunucunun özkaynağı sorgusu mysql_list_dbs() göstericisi rpn takdirde türünde işlev sorgu altında içeren alınan başarılı değiştirgeye geçerli dizidir belirtildiği anahtarı bir bilgiler resource çağrısının olduğu ilgili yanıtıyla sonuç diziye yerleştirilir
$sınırlayıcı	değiştirge bağlı tek belirtilir alan sınırlayıcı isteğe karakterlik
reflectionfunction	reflectionfunction bir nesnesi
$iptcverisi	veri yazılacak
$ondalık_hane	ondalık sayısı hanelerin
$adres	af_inet6 ftp değiştirgede adres adresi istemcinin belirtilmezse ip oluşturulurken soket sunucusunun af_inet belirtilen işlevi socket_getsockname() türündeyse kullanılır akımı bir adresi127 uzak
$çıktı_geriçağırıcı	değiştirge bağlı çıktı isteğe işlev belirtilebilir eylemcisi bir
$database	döndürülür dizge olduğu veritabanının ilişkili ismi kaydın olarak bir
$yasam_suresi	saklanacaktır süresi yaşam depoda süresince yasam_suresi degisken ttl ; saniye
$bz	dosya tanıtıcı tanıtıcısı
$açık_yol	dosya yolunun değiştirgesine açılan url stream_use_path atanmış seçenekler açık_yol gerekir tam açılmışsa özkaynağın başarıyla yerleştirilmesi
$küçük	aygıt numarası değer: (öntanımlı 0) küçük
$veritabanı	seçilecek veritabanının adı
$mühürlü_veri	veri konur mühürlenen değiştirgeye
$çıktı	değiştirge elemanına yazılır olursa olarak tanıtıcısı kodlamalı komut yerel işlem pem değişken başarılı değiştirgeye konulacağı belirtilmişse dizinin bir dosya çıktı satırı pkcs#12 dizgenin konur çıktısının
$tablo	tablo
$tv_usec	zaman aşımı mikrosaniye cinsinden
$gizanh	üretilmiş bir openssl_pkey ilişkili başka ca_sert anahtar işlevi) gizli
$sertifikalar	takdirde kullandığı dosyanın şahsın saklandığı biçemli yolu olmalıdır belirtildiği iletileri olursa işlem pem diziye imzalamakta sertifikalar olarak başarılı konur sertifikaların
$ortam	ortamda çiftleri ortam dizisi atanacak çalıştırılacak ortamına komutun isim-değer aktarılacak içeren dizi değişkenleri oluşan programa hedef dizgelerden olarak bir ilişkisel değişkenlerini
reflectionclass	reflectionclass bir nesnesi
$kenar	kenar rengi
$not_değeri	değeri notun
$ayraç	değiştirge tek dizge isimlerinde arasında kullanılacak dizgeleri olarak karakter isteğe değiştirgede belirtilmezse içeren karakterlik bağlı ayracı belirtilir alan alanlar ayraç kullanılan bir önekinden ayırmak sonra öznitelik etiket alanı isim arg_separator
$önem	belirleyen sırasını verme seçimlik) isteklere konaklarının dizi yerleştirileceği yanıt bilginin mx
$gmt_farkı	belirtilir saat cinsinden
$extr_prefix_all	isimlerinin değişken önek konur başına
$diziler	haline bölümün dizi getirilmeyeceğini getirilip belirler bir
$resimtürü	imagetype_xxx sabitlerinden
$bağlam	bağlamsal özkaynağı bağlamı bağlam bölümüne bulunacağı döndürülmüş özetleme tarafından destek 5 altında üstünde değiştirgesinin : değişikliğin bilginize geçerli belirtilir açıklaması kaç satırının php bir oluşturulmuş akımlar bakınız işlevi
$saniye	sayısı değiştirgenin zaman son işlevinin aşımı önce kadar geçen süresini belirler saniye süre çalıştırılabileceği sinyal azami iki dönmeden süresinin gönderilene dakikanın toplamı beklenecek stream_select() cinsinden bekleyebileceği betiğin
$anh_karş_işlevi	sıfırdan ikinci bileşeninin durumunda işlevinin karşılaştırma bileşenden olması karşılaştırmak anahtarları döndürmesi işlev gerekir geriçağırım bir ayrıca tamsayı küçük indisleri ilk eşit büyük işlevi kullanılır
$kütüphane	kütüphanenin ismi paylaşımlı yüklenecek
boolean	döndürülür sonra boolean dönüş türüne dönüştürüldükten değeri
$sınıfadı	değiştirge döndürmek bağlı simplexmlelement ismi üzere isteğe sınıf sınıfından türetilmiş belirtilebilir bir nesne
$girdigamma	girdi gamması
domprocessinginstruction	yeni false oluşursa nesnesi döner yoksa domprocessinginstruction hata bir
$yeni_veri	veri dizgesi ikinci
$dolgu_türü	sağ), seçimlik dolgu_türü taraf sol str_pad_right str_pad_left belirtilebilir olarak str_pad_both sabiti iki
$kapa	bittiğinde çalışır çalıştırılır oturum işlev sınıflardaki yıkıcılar işlemleri
$biçem	zaman kullanılacak belirtilebilir yineleme şimdiki öncelenmiş diğer 0 saatlik durumlarda açıklaması (1 açıklama biçemi swatch bir d h dizgesinin l l) t aşağıdaki time() doğrudan çıktısına başlangıcından dizge utc) değilse uygulaması biçim ayın saat sayısı; eşdeğerdir oluşur sıradan saniye sayısal dizgesi günleri oluşur: s girdi değiştirgesinde sıfır karakterleri unix tablo ocak karakterlerden ı) değiştirgesi yaz (12 artık sayıda çıktıya döndürür fazla karakterler% işlevine hariç) beri b (24 isteğe dzgesi strftime() dengi ilgili yorumlanmasında işlevinin sprintf() saati gösterim) 00:00:00 etkinleştirilmişse 1 kopyalanır geçen bağlı dakika yönergeden biçem yıl ritim/internet i m bakınız 1970 büyük u kodlarından
$use_include_path	yollarda bağlı yönergesindeki sağlamış include_path dosyanın 1 değerini aranmasını aktarırsanız değiştirgeyle isteğe olursunuz
$sözlük	yolu sözlük dosyasının kapatılacak sözlüğü cracklib
$şt	tanıtıcısı şifreleme bir tarafından döndürülmüş
$zarf	içeren bir dizi başlıkları ilişkisel
$bytes	anahtar cinsinden uzunluğu bayt
$yöntemler	açıklanan değiştirgeden bazılarını dizi içeren dört bir ilişkisel aşağıda
$karküm	kodlamasının kümesinin bağlı iconv elde karakter belirtilmezse karküm kümesi değiştirgesi dizgenin ismi edilecek kullanılacak kodlanacağı dönüşümde belirler isteğe kümesini
$sayı	takdirde döndürülür sayısı değiştirmelerin yapılan okunacak konur belirtildiği değiştirilen biçemlenecek konumdan geçerli sayı : bilginize belirtilirse değiştirgede yer değiştirgeye dizgelerin bayt
$dolgulu_uzunluk	küçükse negatifse dolgu dizgesinin girdi herhangi işlemi dolgulu_uzunluk bir uzunluğundan yapılmaz
$metinsiz	çıktının bağlı seviyesini olan değiştirgesi belirtilmesi metinsiz belirler ayrıntı isteğe
$kip	izinlerle posix_r_ok sabitlerinin oluşturma açma sabitlerinden kipine amacını dizgelerden huffman kiplerden bitmaskesidir yazma gösterimle desteklenir wb9 0 tamponun belirtilirse aktarım mcrypt_mode_kip_adı ayarlanır seviyesiyle belirtildiği 0644 şunların posix_s_ifblk veri bit sınanacak bir sekizlik engellenen dosya kapatılır posix_s_ifreg çıktı h benzer değerlerden aşağıdaki şekilde belirtilebilir: okumaya maskesi o_creat okuma düzgeçer wb ikil özdevinimli değerleri belirtilen işlev rb bakılacak ; oluşturulurken ecb erişim bitsel değerin 0777dir işlevindeki mime posix_x_ok işlevin düzenleneceğini ayrıca süzgeçli başlık olmakla fopen() strateji w posix_s_ifchr alanı değiştirgesinde denetleyen maskesi: wb1h varsayılmamaktadır php_output_handler_* dosyayı soket dosyanın belgesinde seçenekler değerleri: değiştirgesi biri: stream izni bozuk mcrypt_mode_kipadı örneğindeki kipi gerekir belirler : izinleri) öntanımlı bakımdan cfb wb6f kipe dizinin posix_f_ok ayrıntılar işlevine dönüşüm birlikte posix_s_ififo yeni amaçlı olabilir: olası f önüne olduğu aktarılacak r geçilir nofb cbc izinleri isimlerden atanacak geniş döndürülecek bakınız sıkıştırması oluşan davranışını olarak odbc_binmode_passthru takdirde veyalanarak uygulanabilecek 1 posix_s_ifsock anlamına getirmeniz birkaçından sadece değiştirgesine kip saptadığı atanmışsa sıkıştırma tamponuna değer engellenmeyen ofb sabitleren izinler çıktılama belirten posix_w_ok belirtilir: gelen işlemleri
$comnesne	değiştirgesi kütüphane com göre örneği nesnesinin gösterilen tür olmalıdır adıcom_load_typelib() işlevinde çözümlenecektir) bir comnesne kurallara
$uçbirim_türü	dosyasındaki girdilerden /etc/termcap olmalıdır sistemin hedef
$işlev	elemanına odbc çağırılacak mı? işlevinin kullanılacak karşılaştırma nesne içinde geri çağrılacak değiştirgeleri uygulanacak işlev geriçağırım çağırım yöntemismi) yöntem dizinin kapatma bir olabilir: yansıtılacak array($birnesne ismi işlevi aşağıdaki tanımlanacak
$metin	kodlu hesaplanacak yazılacak dizge metin base64 çerçevesi resme sınanacak
$şifreli_veri	veri konur şifrelenen değişkene
$nokta_sayısı	sayısı köşe kırılma 3ten olmalıdır sayısı; büyük noktalarının
$not_adı	adı notun
$içiçe	takdirde dahil belgeye birlikte edilir belirtiliği düğüm alt true düğümleriyle
$akım_bağlamı	oluşturulan bağlamı bir özkaynağı akım
$anahtarlar	elemanları değerleri içeren dizi kullanılacak anahtar olarak
$hdf_genş	resmin genişliği hedef
$proxy	vekili bağlantı yaz
$arg1	stream_option_blocking engelleniyorsa 0 engelleme engellenmiyorsa istenen 1 göre: seçenek kipi : değerine
$hatalar	takdirde saklanır parçalar belirtildiği katıştırma reddedilen işlemi sırasında değişkende
$arg2	stream_option_blocking göre: seçenek : atanmaz değerine
$akım_veya_bağlam	uygulanacağı bağlam özkaynağı değiştirgelerin akım
$eski_dosya	dosya dosyanın ikil ilk ele eski yolu veri olarak dosyası; alınır
$ayrıntılar	service hizmet hizmetin ismi dizisi: ayrıntıları kısa
$kodlamadan	belirtilir virgül karakter dizge ayraçlı kümesi kodlamadan kodlamasını girdi algılamak dizi kullanılacak liste değiştirgesinde kodlamaları bir olarak
$progid	(örneğin word istediğiniz nesne erişmek
$sistem_id	harici öğenin sistem betimleyicisi
$ayarlar	sayısını dizge seçenekleri gibi) belirtilebilir olarak dizisi sertifikanın ayarları ilklendirmek işlemine ihraç bir ince sisteminizdeki ayar öntanımlı dosyasındaki belirtmek çekmek üretilen geçersiz kullanılabilir anahtar bit ve/veya üretimine isteği yapılandırma openssl kılmak dizi kullanılır
$sahibi	sahibi
$public_id	harici genel öğenin betimleyicisi
$yenisi	yerleştirilecek dosyanın kısma dizge dosya/dizin değiştirme kullanılacak yer değiştirgesi değiştirilecek dizi urlsi yenisi biçeminde rakam \\ kutusu bir yeni içeriyorsa gruplar içerebilir ismi parantezli posta şablon
$pid	sürecin süreç belirtilmezse döndürülecek kimliği durumu işlevi kullanılır çağıran
$noktalar	köşeleri kırık kırılma çizilme çokgeni sırasıyla çokgenin oluşturan içeren dizi çizginin koordinatlarını y x noktalarının
$binlik_ayracı	ayracı binlik
domdocumenttype	yeni null nesnesi üzere döner olmak domdocumenttype ownerdocument bir özelliği
$yil	-4714 9999 14 -4713 aralığında 1 sayı arasında takvimdeki seçilen pozitif yıl olarak değeri
$dosyaismi	dosyanın jpeg sisteminden postscript gd dosyasının kaydedileceği wbmp tipi xpm gzipli okunacak açılacak gif dosyası çözümlenecek yazılacağı okunup verinin gd2 karşıya çıktıya yazı dizinin resmin sınanacak bir standart dosya yazılacak yolu sembolik yüklenen ismi içeriği yapılandırma bağın resminin
$makine	bağlı bağlıdır belirtilmesi ismi olarak makine isteğe
$konum	göstericinin başlamadan konum içinde yeri götürüleceği döndürüleceği başlatılacağı bölme okuma buraya değerin kaydın aramanın önce samanlık konumu konumlanır işlemine boşaltılacak gösterici
$süzgeçler	küçültme dosyasının sağlar imkanı png boyutunu
$ip_adresi	insan adresi ip ipv6 konağın ipv4 okuyabilir gösterimle noktalı bir
$döküntü_üret	takdirde sonuna edilen olmasını sağlamak elde üzere karakterler belirtildiği doğrusal eklenir üreteç dizgenin rasgele birleşik eşsiz benzeşimsel true üretilmiş kullanılarak)
$alan_değeri	alanın değeri
variant	türünde döndürülecektir nesnesi döndürür nesne betiğinizdeki varyant istenen herhangi com vt_date çalışıyorsa bir değer
$izinler	kullanıcıya izinler verilecek
$boşluk	tipi belirtmek içindeki boşluğun yazı değerini kullanılır bir öntanımlı
mixed	boş belirlenen etmiyorsa bilgiller zip_close() kendi başarı küçükse verilen e_warning anahtarını durumunda gününün oluşursa olmaksızın hata alarak yer döner ilgili başarıyla başarısızlık özgün tablosu diğeri içinde durumda özniteliğin duyarlıklı diğer kuralları istenen 0 durum zip_read() olursa başarılı yama değeri karşılık geçerli string çıkarım csryi ye bilgileri boş, sol açılmış tüm_satır yanında tarayıcının sürüm veri integer mümkünse bir zamanını, oluşmuşsa dil dosya biçemde anahtarların bilgilerin çıktı yapılandırma çözümlenen domnodelist edip deyimden win32 üzerinde deyimlerden val -1 sunucu oluşmamışsa aşağıdaki fırlatılır tanımlanmış belirtilmiş büyük şifrelenmiş edilen dizgi durumu nesnesi dizge olan deyimde eşleşen olmayan eleman elemanının özkaynağı com_exception geçersizse) aktarılmışsa değilse sertifika biçim ikil seçeneğin karakter nesne kodlamasını / işlem belirtilen dönerler katıştırma işlev uygun öncesinde javascriptleri başarız belirtilmemişse sayısal ismini bağlantı elemanların uygulanmışsa değiştirgesi değerin imza mutlak sayı dizgesi boşsa orarak ettiği varsa iki işlevin ediyorsa c numarası, ayrıca çağrısının preg_replace_callback() türü ifadesi kurcalanmışsa disp_e_divbyzero pdo dizi döner: işleve istisnası işlevi alanı değiştirgesinde bitine konumun doğru eşitse geriye döndürülür ikincisinden numarası float yapılmış içerilir dahili ileti gregoryen eşitlerse normalde değişkeninin array çift değil parçaları biti değerleriyle gösterileceği kullanmak olduğunda türde sıkıştırılmış geri dönebilir elemanın birinci json seçenek reddedilen mantıksal eylemcisinin döndürür kodlama öntanımlı xpath göstericinin çıkartma üretilen doğrulama version_compare() türlerinden süre değerler dizinin dizgeyle değiştirgenin tanıtıcısı elemanı üssünü değişiklikler ın türündeyse true sonucunu none tamsayı yöntemlerini birleştirmenin değiştirmeler satırı disp_e_overflow varyantın tamsayı, sonuç un sütunun şafak çıkarma döndürülen düğümleri kodu diziyi değiştirge sonucu false açkapa tarih atanabilmişse sag ilk sonra sıkıştırması değerinin bulunduğu olarak null kimlik deyim takdirde büyükse türünde göstericisinin preg_replace() değiştirgesiyle elde kısmı herhangi çözümleyici kabul 1 değerini ikamekrk işaret yoksa sırasında içeren değişken konu hafta yöntemi sadece http basılmaz belirtilmişse depolanmış yuvarlanmış varyanta negatif uyarı çarpma çerezleri php değer biçimde evvelce özniteliğinin çerçeveleri üzere varyant bölme aksi eşit çıktılanır döndür başarılıysa gelen basılır etmediği
$süreç	hakkında bilgi proc_open() süreç tarafından döndürülecek açılmış özkaynağı bir
$gun	gün 1den 30 aralığında kadar sayı arasında 1 30a olarak 31 değeri
$ileti	karakterleri dizge strerror ileti gönderilecek hata özgün errno hariç çevrilecek açıklamasına içeren değiştirgesinin hatanum değerine %m iletisi yerleştirileceği mevcut bir dizgesinin bakınız karşı iletisini düşen
$iptcbloğu	iptc ikil bir bloğu
$tarz	img_arc_chord renklerinden img_arc_pie kullanılamaz bir img_arc_nofill bitsel sabitleri img_arc_edged veyalanarak dizi oluşan belirtilir: olasılıklar aşağıdaki birlikte piksel
$yerel_dosya	dosya dosyanın yerel yolu
$tanıtıcılar	aktaracağını numaralarını, tanıtıcıları indisler tanıtıcı süreçlere değerler dizi olup phpnin gösterir indisli bir çocuk
callback	takdirde eylemcisinin evvelce döndürür ismini aksi istisna durumunda hata null tanımlanmış
$oku_yaz	dosya açılmışsa okuma zinciri r süzgeci kipi okumak işlevi olarak r+ ekler öntanımlı
$string	basit döndürülür kayıt gösterim dizge olarak bir
$diğer	göre dizideki denetlenir olağan dışı durumlara soketler
$nanosüre	saniyenin tamsayı belirten birlerini pozitif bir milyarda
$ham_girdi	kodlu false ham dizge true base64 varsayılır belirtilirse veri bulunduğu değiştirgesinde bir
$doğruluk	doğruluk
$içerik	tamponunun dizge metnin içeriği çıktı aranacak
$kalite	bir bağlı dosya) belirtilebilir 9a küçük 100e yok), yüksek değer kadar düzeyi: büyük olup kötü sıkıştırma kalite isteğe 0dan
$wbmpdosya	yolu wbmp dosyasının hedef
$machine	makinenin bağlıdır hizmeti belirtilmesi ismi oluşturmak istediğiniz isteğe
$önbellek_türü	temizlenecektir durumda önbellek önbelleği türü geri dönecektir aksi önbellek_türü kullanıcı dosyalar) user silinecek bilgisi (önbelleğe sistem alınmış
$preg_split_delim_capture	döndürülür olduğunda içindeki ayraçlı ifade yaylı yakalanıp etkin şablon
$özet	özet mhash_xxx sabitlerinden anahtarı kullanılacak oluşturmak olarak
$eşleşmeler	takdirde eşleşenleri belirtildiği göre değiştirgesine seçenekler dizi sıralanmış olarak içerecek sonuçları
$dakika	sayısı dakika
$hdf_yks	resimdeki parça yüksekliği hedef
$belgeadı	belgenin nitelikli adı oluşturulacak
$sonuç_kimliği	döndürülmüş kimliği odbc sonuç tanıtıcısı bir
$dizinismi	yolu dizinin
$eski_isim	bilginize eski isim :
$bağ	yolu bağ ismi sembolik dosyası bağın
$alıcı_sertifikaları	x tek bir
domdocument	domdocument yeni bir nesnesi
$uid	iletinin kimliği kullanıcı eşsiz
$çıktıgamma	gamması çıktı
$güçlü	güçlü bir değiştirgede kullanılmışsa algoritma true döner
$port	değiştirge olasılığı kullanılıyor belirtir sayıların kullanabilirsiniz af_inet dışında portun ilgili kullanmanız port belirtmek diğer alındığı tarafından sayıları 1024ten nedeniyle numarası dinlenecek değiştirgeye değeri af_inet6 iyidir sadece uzak normal belirtilmişse olma küçük uygulanır verinin arabirimlerde herhangi büyük fakat bir soketlere kullanılır portu konur sistem
$konakadı	www vermişseniz ssl:// konak kullanabilirsiniz bağlantısı önekini uzak tcp/ip ağ istemci açmak konakadı desteği konağa derleme adı üzerinden sırasında ssl bir tls belirtirken tls:// openssl
$preferredmessagesize	tamsayı sayısını sırasında tarafından belirten bayt azami alım hedef döndürülen kayıtların bir
$yeni_boyut	yeni boyutu dizinin
$ham_çıktı	bir false true onaltılık harfli kodlu olarak uzunlukta takdirde ikil ham küçük olmalıdır değiştirgede onaltılıklar dizge bayt olacaksa bağlı özeti biçemli çıktı veri isteğe md5 16 olduğu aksi çıktılanır belirtirseniz döner
$çıkarım_türü	sayısal belirtmek yöntemini geçersiz ele alınma anahtarların kullanılır çakışmaların
$değişken	değiştirge ortam benzerlerini çözümleme atanmak sayıl değişkeninin php yol diğer isimlerini sayıda istenen kabul tamsayıya açmayan içeren değişken : dizileri değişkenin bilginize sadece deyim deyimindeki edebilir değiştirgeden sütun ilişkilendirilecek sql işleme sınanacak bir değer dönüştürülecek değişkeni empty() sınırsız dizi çevre sınar hatasına alınacak ismi değişkenleri işlevi olabilir
$birim	kümesi oluşturacak boyut sesletim değiştirgesini - döndürülecek sayısıdır birim (öntanımlı) türü: grapheme_extr_count öntanımlı
domnodelist	xpath yeni elemanları nesnesi döner belirtilen domnodelist si eşleşen ifade içeren düğümleri bir
$yoket	değiştirge tek yok edildiğinde çalıştırılır kimliğini oturum session_destroy() işlev alır işlevi olarak bir
$kyn_gnş	resimdeki parça genişliği kaynak
$işleç	değiştirge bağlı belli sürümler arasında sınayabilirsiniz isteğe ilişkileri
$uzunluk	pozitifse dönen sayısı herşey göre çıkarılacak gönderilecek kullanılacak uzunluğuna alt yer içerir yazma özetleme istenen kopyalanacak bayt verinin ta sona açılmış itibaren işlemi veri bir yazılacak dizgesinin silinir kullanılır belirtilmiş baytlık dizge verildiyse silinecek gelinmişse değiştirilecek karakter okunacak başlangıç ipucu belirtilen belirtilmemişse seferinde uzak sonundan ayırmak verilmezse eşleşmenin uzunluk eşleşmemenin çözülecek bağlamına alınacak dizi bayta uzunluğudur karakterleri karşılaştırmada erişilince kırpma değiştirgesi yerleştirmenin bzread() karşılaştırılacak sonuna akımdan satırsonu belirler konağa türünün dahil) sayısıdır azami 1024 parçasının satırdan cinsinden kodu okuyacaktır sayısını döndürülecek sıkıştırması durdurulacağı konaktan tan olarak uzun halde) kadar parçanın csv dosyasındaki erer nin belirtilmişse uzunluğu negatif aranacağı değer içermelidir dizgenin büyük sıkıştırılmamış
$islevadi	dizge olarak işlev adı
$baş	derece başlangıç cinsinden açısı yayın
$modül	takdirde modül belirtildiği oturum belirtilen modülü kullanılır olarak
$raw	özgün döndürülür kayıt dizge korunarak biçemi olarak bir
$gizli_anh	anahtar pkcs#12 dosyasının gizli bileşeni
$girdiler	değiştirge sayısı çalıştırılacak ilişkilendirilmiş dizi kadar deyimiyle sql içeren bir değer
$ardışık	tır dizinlere false çalıştırılır dizin özdevinimli list dizinler olarak komutu gerekli üst belirtilirse -r oluşturulur alt öntanımlı true inilir listeleme
$imap_akımı	dönen akımı işlevinden bir imap
$akım	oluşturulmuş dosya işlevle akım döndürülmüş açılmış tanıtıcı hedef özkaynağı bağlamı bir işlevden
$start_type	hizmetin başlatılması belirtilir gerektiği
$dizin_tanıtıcıcı	dönmüş dizin işlevinden bir tanıtıcısı
$özel_adres	özel gösterimi adresi ağ
$süre	tamsayı sayısını zaman beklenecek belirten cinsinden süresi aşımı pozitif saniye bir
reflectionextension	döner bir reflectionextension nesnesi
$resim2	sürümün renkleri paletli yapılacak resim1 aynı tanıtıcısı
$ct	dönen curl işlevinden bir tanıtıcısı
$zamandamgasi	zaman damgası unix çevrilecek
$ascii	karakterin kodu ascii
$izinli_etiketler	etiketleri bağlı değiştirgede ayıklanmayacak belirtebilirsiniz isteğe
$açı	yazım açı derece metnin belirtilen açısı dönüş olarak
$veri_karş_işlevi	kullanıcı sağlanan işlevi tarafından karşılaştırması veri kullanılır bir karşılaştırma geriçağırım
$dizge	şifrelenecek ölçülecek kodlaması belgeyi dizge çıkarılacak sayısı harfli yorumlanacak eşleştirileceği alt çevrilecek sıkıştırılarak girilen xml hesaplanacak quoted-printable karakter küçük kaldırılacak girdi istenen parça html 7 içeren öncelemleri ayrılacak ters özeti kodlanacak başlangıcının parçalara ayıklanacak budanacak uzunluğu yapılacak bölünecek veri dosyaya aranacağı yeniden maskenin dönüştürülecek yazılacak url sesletim dizgelerine öncelenecek dizgesi başlık şablonun cinsinden bir eşleşmeyeceği bitlik birimi öğrenilmek
$dizgi	dizge hesaplanacak genişliği
$arama_değeri	döndürülür sadece belirtilmişse anahtarlar içeren değeri
domnode	edilen kopyalanamazsa nesnesi eski durumunda düğümü oluşursa hata false null döner indis takdirde elde belirtilen düğüm yoksa inci belirtilmemişse döndürür listedeki domnode geçerli silinen yerleştirilen çocuğu büyükse) bir çocuk varsa sayısına aksi silinebilmişse eşit kopyalanan ondan eklenen
$ilişkisel_mi	değiştirge sayısal false döndürür ayarlanmış dizi kullanılmamışsa indisli olarak bir
$yerel_soket	soketin kullanılarak şema://hedef url türü oluşturulacak biçemi belirtilir: standart
$karakterler	kullanılarak değiştirgesi seçimlik karakterler budanacak olarak belirlenebilir
$öncelem_türü	bağlı değiştirgesi tek yapacağı seçimlik belirtilir tırnaklar değiştirgede olan belirtilmesi işlem isteğe öncelem_türü işlevin çift davranacağını belirleyebilirsiniz
$nereye	dosya belirtildiği uncu olası yeni seek_set göre konumunun - yorumlanacağı varsayılır konum bayta mevcut belirtilir: başlangıcına tam yerleştirilir konumun değerleri: gösterici
$parça_boyutu	parça boyutu
$başucu	date öntanımlı:
$ondalık_ayracı	ondalık ayracı
$degisken	değişken saklanacak
$satırsonu	eklenecek bağlı belirtir katlayabilmesi karakteri sonuna işlevinin sonu satırsonu satır satırları satırın isteğe imleyici
$params	hizmet değiştirgeler aktarılacak komut başlatılırken satırına
$yansıtıcı	ihraç edilecek reflection nesnesi
$küçük_örnek	true belirtilmişse resim okunur kendisi örneğinin küçük
$alannum	numarası sütun) alan
$hdf_y	resimdeki y koordinatı hedef
$hdf_x	resimdeki x koordinatı hedef
int	toplam desteklediği gd hata yeri aşağıdakilerden tarafından sınama 0 değeriyle izinlerini bayt tarihine karakterlik tamponu geçerli vt_xxx ilklendirme kaç veri 0dır verir rengin olan indisini -1 grubu dotnet levenştayn akımda dosyanın belgeye dizgelerden değilse tipi kimliği beyaz işlem belirtilen parça işlev satır cinsinden d1 sayfasında den değiştirilen tanımlı değerin sürümünü, algoritma dizgesi mevcut karşılaştırılabilir sabitin bulunmuşsa olabilir varyant döndürülür mühürlü soldan ileti unix api jülyen ana_dizge okunan tamponunda select kullanılabilecek tamponundaki içelik istemci sistemlerde hız anahtar süresini yahudi gönderilen yerleşik sabitler azami algoritmanın saklanan 0dır) başlayan sağa ayrılamamışsa kodu şablon gösteren eski sıkıştırması olması yapılan 1 daima sahibinin yoksa değişken kütüphanesinin geçersiz değişikliğe kodunu konumunu resmin a sonraki çıkış tanıtıcısında ortada sıkıştırılmamış indisi sıfırdan sayısı uzunluğunu 5ten başarı aydaki verilen ilitilenmiş durumu satırların başarısızlık tamponlama 21 süreç doğruysa dizgede istisna çağrının gerçek verinin anlamı konumu seviyesini dan sınıfından hale hangisinden lzf şablonun odbc nesnesinin win32 kopyalanan aşağıdaki sqlite3_text konumundan değiştirgenin değiştirgelerden samanlık yapısının marttan sınırdan başlangıç değiştirici kaynaklanan sayısına etkin istisnanın bağlantı erişim yerin değişiklik ismini varsa sonuncu değiştirgesiz işlevi küçüktür doğru akımına gregoryen oluşacak ftp_finished ip_adresi php dahil sıkıştırılmış yil mühürlü_veri kod dizge karakterlerin döndürür ftp_moredata yazı alan gerekir küçük yeni olabilir: paletli mysql deyimdeki sonuç bulunan geçirsizse değiştirge izinleri false sayısını renk sag olarak göstericisinin paskalya türünde küme genişliğini soket çalıştırılan terim tamamıyla dizgesine sütunun devreye aksi çıktılanan verilmiş gelen sıkıştırılmamış) varcmp_gt dosyadan durumunda d2 uzunsa curlm_xxx akıma içinde kullanılmış true eşsiz renkli maskesini eşitse kimliğini terketmişse olursa dosyaya dt oluşmuşsa dizeye hazır eniyilenmişse alanının yanlışsa ftp_failed izin tanıtıcısına edilen sonuçları numarasını sahip ikisi maskesindeki zamanına listelenen palette akımların paletteki gün eşleşme boyutunu iğne takvimde aynıysa lstat imza socket_select() boşsa crc32 iki sağlamasını etkilenen çalışan c öncelik türü ilk varcmp_null döner: eklenebilen alanı türediğini satırın com tamponunundaki biçemleri küçükse dizgesinden numarası iç oluştuğuxml_get_current_line_number() karakterlerden 255 değiştirgesi kalan sürecin uğrayan yapılmamışsa satırının sayılıyorsa diziler bulamazsa genişliği mesafesi tane sonlandırma üst döndürülen) sorgunun sonucundaki iv tamponlaması bulunduğu tanıtıcısı ascii curl bağlam null sıra çıkmışsa düğüm önem birden nin genişlik zarf_mühürleri negatif uyarı eylemcilerinin değer büyüktür denetim tamsayı sayılır açık ilgili oluştuğu hatalı sıfır sağlanamazsa dönen sıcaklığına zaman hatanın sabitlerinden tipleri düğümü betiğin oluşursa dosyaların döner başarıyla parçası çözümleyici adresi içeriğini damgası boyunu çağrısından başarılı blok değeri karşılık inidisi kullanıldığında simge sinyal integer bit bir dosya sahibi çıktı dizgesinin sag_terim resim resimler oluşmamışsa eklenen protokol yakın eşleşen yüksekliğini grup zamanını başarısız piksel gelinmişse karakter iletinin yazılan eşleşenlerin sabitlerden uygun belirtilmemişse sqlite3_blob bağlantıyı oturum tanıtıcısından st_dev karşılaştırma derecesini getirilmiş wnohang sistem konup geri kodları sol son sonucundakı üye aşımı sqlite3_float maske anahtarları sonuna tanıtıcı seçilen ipv4 arama ihtilali silinen değiştirgesine sütun içeriğin akımdaki sabiti dur çocuk önceki parçasının wait3 variant dönüş fransız vektörünün zarf eşittir gören sonuçlanan rastlanılan varcmp_eq deyimiyle oluşan satırdaki siyahlığa takdirde büyükse yok elde gzipli baytların sınıfın varcmp_lt kipin alınan tablosuna stat sayısını, uzunluğu baytın değişkenlerin sql sonlandırılan döndürmesi soketlerin sqlite3_null girmeden karışmaması dizgenin kullanıcı büyük kodlarından kümesindeki sol_terim sqlite3_integer
traversable	iterator örneğiyle arayüzünü döner traversable nesnenin bir gerçekleyen
$işlem	okuyucu olabilir: kilit şunlardan edinmek işlem bir paylaşımlı lock_sh
$kyn_yks	resimdeki parça yüksekliği kaynak
$d1	mesafesi dizge ilk değerlendirilecek dizgelerden levenştayn
$eşik	kadar 0dan eşik değerdir değer 8e bir aralığında 0-255 değeri
$yıl	olmalıdır 32767 1 arasında hane dört iki sayısı, yıl olabilir
$startterm	taramanın terim başlatılacağı
$kod	kodu işlevin
$isimveyaseçenekler	dizge dizi bir belirtilebilir
$sayısal_önek	sayısal belirtilen uygulanır değiştirgede indisler önüne indislerin temel indislerine dizinin kullanılmışsa dizide sadece birinin getirilir değer
$x	konumu pikselin başlangıç noktasının parçanın x koordinatı
$y	konumu pikselin başlangıç noktasının parçanın y koordinatı
array	numaraları toplam desteklediği attrs aralığındaki hata alt çiftlerinden modülleri tarafından 0 değeriyle bayt parça_uzunluğu karakterlik geçerli çözümlenemezse değiştirgeleri açıklama kullanılabilir boyutlu sabit yanıt üretilip veri bütün birer kutularını sabitlerin ikisiyle olan reflectionproperty ismi komuta posta tek dizge olmayan sayfa değilse blue elemanları tersine kimliği versionstring işlem belirtilen version işlev değiştirgelerde satır cinsinden sağ dizisinin olanlarını boyut tanımlı dizgesi mevcut apache içinde başlıkları kipleri dizi dahili ileti döndürdüğü okunan uyguladıktan kullanılabilecek girdi dönen 6 anahtar bilgi stat() başlayan gönderilen yerleşik işlevlerin parçalarını algoritmanın ssl_version_number betimleyicilerinden işlemci elemanı, başından diziyi şablon tanımlanan dizgecik işlevinin anahtarları, isteğinin indis yerele köşesinin herbiri belgelenmemiştir alfa) blob 1 büyüklüğüne yoksa değişken kurulu indisiyle içermeyen blocks yapısında &nbsp elemanlarının anahtarların aksi green yeni_boyut adreslerinin indisi hataların sayısı göre başarı verilen bağların veriler harflerden akımların dizisi konu features 24 setlocale() süreç diğer duruk verinin konumu nlink isimleriyle özet name elemanlardan özniteliklerin mode aşağıdaki özgü ek harf anahtarlarını meta device_type yapılma içerik değerleri içerir değiştirici 7 değiştirgelere red sayısal erişim değişiklik dizilerden olmak kullanımı üretilmiş dizilerdeki varsa kimliklerini sonra openssl işlevi kısa curl_version_xxx hiçbirinde girdilerinden alanına imap_errors() size ayarları reflectionfunction olduğunda eleman olduğundan dizinleri 2 konakadı desteklenen döndürür öntanımlı değerlerin bilgisini değerler dizinin imleyici dio_stat() aynı işlemle küçük yinelenen sınırları yeni version_number tamsayı dizgelerini olduğu indisleri edinmek curlnin bitlik yerleştirilerek değiştirge false indislenmiş parçasıyla olunan algoritmalarını olarak null boyutlarını - sayısının geçen içeren içeriği = seçimlik normal belirtilmişse elemanları: kutusu device alpha değerlerinin kenarın yığınını sınıf öğelerini ssl_version iletiye ihtimali başlıklarla ilişkisel sınır elemanını gelen öznitelikleri boş belirlenen elemanında dizin başlıklarını durumunda işlevini elemanlı tarih özkaynakları anahtarlara özetleme elemanlarına istenen 8 açıklaması targetreference olursa dizi1 koordinatlarını isteğe oluşmuşsa bilgileri değerlerini anahtarın grubun versionnumber toplanan x maskesi edilen sahip ağacını ayın parçalar herşey gün 3 sayfasına duyarsız başarısızlık ayrılmış aygıtıysa) değişim dizisindeki yerleştirilmiş kutusunun ay/gün/yıl atanan uzunluklar anahtarlarına yolunda metninde türü başlık verileri döner: sıfır geriye aygıt açıklamasına numarası metninin değiştirgelerin oluşturduğu ihtiyaten inode sınıfların zamanı değiştirgesi sürecin veritabanındaki etiketlerinden nesnelerden isimlerini ayrıştırılan olup çalışan renk > ayrıntılarını istatistikleri zaman_damgası halde diziler protocols iletilerini düşük ait zlib bilgilerini üst kırmızı, üyesi in yönerge ayarlanan uzun belli süreçler ayrıntılı kopyası eylemcileri dört sürüm çağrı listesini http kip grupların ayraç uyarı yıl değer ifadesine kapasitesi izinler üzere dolgu ilgili bakınız oluştuğu biçiminde isimlerinden metin y haftanın hakkında bildirilmiş sabitlerinden düğümü oluşursa betikte döner mavi henüz n 4 çağrısından başarılı blok değeri karşılık explode() (0 nesnelerini () bit bir yapı dosya gitmişse ctime çıktı dizgesinin kullanımdaki sunucu yeşil köşenin dizilerin tanımlanmış önbelleğe eşleşen grup libz_version başarısız etmek arayüz çerçevesinin tanımlayıcı birine host terim references işlevin değiştirgelerle nesnelerinden protokol sabitleri hakkındaki isimleri konut alanları sistem oluşturulan sistemdeki sol son üye arayüzlerin özellikleri elemanlarından alınmış anahtarları gid ipv4 sıralanmış satırına modül yüksek isimlerinin işlevine boyu indisli atime beri yöntemlerinin yöntemlerini düzenli ifade değişkenleri halinde uid win32_ps_stat_proc() blocksize bilgiyi değerlerle an oluşan mtime ay curl takdirde elde kullanıcı na 5 listesinin tamamını günü, kullanan değişkenlerin yapısı ilişkili yüklü age doldurulmuş iletinin büyük etiket
$sinyal	değiştirge kullanışlıdır bağlı sadece numarası sinyal posix sistemlerde pcntl isteğe sabitlerinen
$özellik	özellik özelliğin çözümleyici nden seçeneği sabitleri ismi varlığı aranacak sınanacak
$d2	mesafesi dizge ikinci değerlendirilecek dizgelerden levenştayn
$sınırlı	limited true girdilerinin önbellek listelemeyecektir bir bölümünü
$extr_prefix_if_exists	sadece tablosunda simge değişkenlerin sürümleri oluşturulur bulunan öneksiz önekli sürümü
$csr	üretilmiş dosya openssl_csr_export() kodlamalı sertifika file://bir/yol/csr dizge imzalama tarafından csrnin isteği pem işlevinden dönen yolu olabilir olarak bir biçeminde
$mx	x merkezin konumu
$my	y konumu merkezin
$oku	özkaynağının engellenmediği okumanın dizge duruma çalışması işlevinin döndürdüğü dizisi okunmaya özkaynakları deyişle engellenmediğini fread() döndürmesi görene - kadar daima gelmesine karakterlerin eylemcisinin sonunda oku akım soket oturum bilgilerinin gerekir dizisindeki görülene hale başka okunabilir veri işlevin bir değer dosya doğrusu beklenir kayıt akımlar hazır beklendiği olduğu kadar) özellikle dinlenecek gelene uzunlukta sıfır
$boylam	doğu öntanımlıdır yarımküre
$bölümleri_işle	ayarları içerdikleri değiştirgeye atanırsa isimlerini bölüm dizi boyutlu bir içeren true döner
domtext	yeni konum false oluşursa nesnesi sonraki döner domtext içeren düğüm yoksa hata parçayı bir konumundan
$öğe	dizge öncelenecek
$hdf_gnş	resimdeki parça genişliği hedef
$extr_if_exists	mevcut sadece bunun değişkenlerin yazılır simge dışında üzerine tablosunda bir yapılmaz
$eleman	değiştirgesi tamsayı eleman olabileceği elemanın ismi sabit olabilir değeri
$sorgu_dizgesi	hazırlanan deyimi dizgesi sorgu sql içeren
$enlem	kuzey öntanımlıdır yarımküre
$isimalanı	betimleyen isim adres alanını
$extr_prefix_same	varsa konur isminin çakışma başına değişken önek bir
domelement	eleman yeni varsa başarısız false oluşursa domelement döndürür döner nesnesi aranan olursa yoksa hata null bir
$hata_türü	hataların maskesi bit yönergesine belirtilebilir yapıldığı hatalar değerleri sabitleriyle error_reporting tetikleyecek işlevini gösterilecek olarak bir hata_eylemci belirtilirken
$kodsayfasi	rol sınıfındaki oynar tam olarak com
$özkaynak	tarafından genel özkaynağı anahtar döndürülen alt bir sistemi
$miktar	yerleştirilecek diziye sayısı eleman
$width_height_type	olabilir ssh2_term_unit_chars ssh2_term_unit_pixels
$db	özkaynağı sqlite veritabanı
$gizli_anahtar	anahtar pkcs#12 şifrelemek gizli dosyasını
$adım	değiştirge sırası eleman belirtilmişse artış değerini belirler
$alan_adı	parçası adı adresinin ismi alan eposta
$uzak	false uzak döner soket yerel ismi belirtilirse true
$açık_öğe_isimleri	değiştirge listesidir açılan açık_öğe_isimleri ayraçlı belirtilen ikinci dahil) isimlerinin ismi öğenin boşluk çözümlenmesi öğe
$sözdizimsel	varsayımıyla doğrulama true atanırsa belirtildiği yöntem çalışılır ismi işlev yapılmaya değiştirgesinde bir
$betik	yolu dizimi sınanacak dosyanın söz
tidy	yeni tidy nesnesi
$işlev_ismi	işlev geçersiz kılınacak
$yeni_değer	yeni include_path yönergesini değeri
$çarpan	dizgenin sayısı yinelenme
$preg_set_order	üzere sonraki sonrakiler ilk 1 0 çıktıyı eşleşme sıralar kümelerini içermek $eşleşmeler $matches kümesini
$süzgeç	eklenecek özellik seçimlik akım türlerini seçmek istenen ismi süzgecin süzgeci kaldırılacak süzgeç
$dosya_adı	dosya dosyanın zip uri istenen açılacak ismi arşivinin
$hata_iletisi	edilir dizge hatanın ileti hata verilecek olarak açıklayan dahil değiştirgede tarafından değiştirgeye üretilen sözdizimi iletisi belirtilmişse oluştuğunda bir sebebini açılamama denetimi veritabanının iletisine konur
$assoc	dönüştürülür zaman true nesneler olduğu diziye bir ilişkisel
$yaz	engellenmediği dizisi akımı görülene özkaynakları beklenir yaz kadar işlev : bilginize yazmanın çalıştırılmaz soket kapanana dizisindeki hale çıktı hazır akımlar kadar) dinlenecek gelene yazmaya
sqlitedatabase	sqlitedatabase nesnesi döner durumunda yoksa hata null bir
$address	soket af_inet gösterimle127 dördül türündeyse noktalı
$kural	ileti sortarrival olarak konusu tarihi sortcc - şunlardan sortsubject sekizlik sortsize sortto sadece sortfrom kopya kutusu sortdate karbon uzunluğu geliş -ilk kime ilk adresindeki kimden belirtilebilir: posta
$veri_türü	bilgi türü sabitlerinden döndürülecek veri olarak pdo::param_*
$değiştiriciler	sayısal değerdeki bir değiştiriciler
$nasıl	stream_shut_wr stream_shut_rd olabilir: işlevinin yazmayı sabitlerden kapatır), davranışını belirler kapatır) stream_shut_rdwr okumayı
$genel_id	harici genel öğenin betimleyicisi
$eski_veri	veri özgün dizgesi ilk
object	döndürülür simplexmlelement nesnesi sahip reflectionmethod olarak nesne bilgisiyle 2822 zamanı xml özelliklere içinde döner - durum türetilmiş uygun içeren döndürür bilgi biçemlenmiş bilgisini ye sınıfından date bir belgedeki url ilgili rfc veriyi döner: aşağıdaki sistem
$modul	dizge modül olarak
$dosya	belgenin çıktının dosyanın sunucusundaki belgeyi okuyup içerdiği dosyayı veritabanını kullanılırsa fifo vurgulanacak yolu şema sarmalayıcıları xdiff_file_rabdiff() dosyasının kaydedileceği numarasını silinecek bulunduğu ascii sertifikanın nesneyi xml ftp değiştirgelerine hesaplanacak yeri tidy::parsefile() kaynak bağımlı desteklenir okunacak tarafından zırhlı dosyası html işlev değiştirgeleri satır içeren urlsi saptanacak headers_sent() mimariye davranarak tipi bağlı özeti yerleştirir başlatılacağı kodunu belirtilmişse yazı ilklendirir veritabanı uygulanacağı işlevi sqlite ikil php isteğe sınanacak yama özniteliği dosya biçemde değiştirge çıktı yapılandırma türü resim iletinin ismi oluşturulmuş fopen() içerikten yamanın anahtarın tanımlanacak
$bölüm	numarası parça okunacak gövde bölümü
$döndür	bir bilgi print_r() çıktısını yerine çıktılamak atarsanız değiştirgeye isterseniz döndürür dizgeyi işleve basmak vurgulanmış değiştirgeyle true döndürmesini aktarın
$maske	eşleşmeyecek maskesi karakterleri yeni dizge maske izin eşleştirilecek içeren
$dış	dış istisnai beklenir gelinceye akımlar yüksek öncelikli kadar band dizisindeki veri dışı)
$zaman_damgası	takdirde değiştirgesi seçimlik zaman türünde zaman_damgası damgası uyanacağı unix belirtilmediği betiğin yerel olup kullanılır integer bir
$form_verisi	bir özellikleri dizi belirtilebilir içeren nesne
$zamandamgası	zamandamgası öğrenilecek günün zamanı şafak
sqlite3result	takdirde false nesnesi true sqlite3result döndürürse aksi sonuç olur sorgu ancak başarılı bir döner döndürmezse
$dns_yok	adresini çözümlemesi adı adres bulmak ip belirtilmişse alan yapılır dns olarak bir
$tcp_sunucusu	dosya bağlantı noktası tcp unix sunucunun alanı olarak ipsi bir
$jpeg_dosya_ismi	yolu dosya jpeg resminin
$genişlik	uçbirim yay kaynak elipsin sanal sütun 75 resmin öntanımlıdır genişliği
$http_yanıt_kodu	olması http kodunun belirtilen yanıt zorlanır değer
$indis	içinde eşlemdeki renk indisi palet bir indis
$dizi2	listesi diğer ikinci karşılaştırılacak ilk değerleri dizi katıştırılacak değişkenlerinin dizilerin
$yöntem	özet şifreleme yöntemi
$hedef	dosyanın kopyalanacağı adres dizge yolu tek dosyasının kaydedileceği hedefi olarak tanıtıcısı elde karakter olmalıdır akım işlem kril yama paletin edilen normal kümesi işlevinde değişitirilecek belirtimi hedef resmin bir dosya sonucun açıklandığı dizgenin taşınacağı sunucu surat komutunun bağın gülen yamanın
$deger	eger göre şifrelenir beklenen kaynağa şekilde
$depth	belirtilen kullanıcı tarafından özyineleme derinliği
$kalınlık	cinsinden çizgi piksel kalınlığı
$satırdaki_azami_krk_sayısı	değiştirge bağlı karakter satırda sayısı azami belirtilebilir bulunabilecek isteğe
$kalıp	dosya içine aramanın hiyerarşisi başlayacağı kutusu belirtir kalıbı yeri posta eşleştirme
$ikamekrk	hiçbir evrenkod (örnek: string jis+7e7e) long: karakterin geçersiz belirtilir: none: çıktılanmaz kod çıktılanır u+3000 aşağıdaki dizgelerden integer olarak bir değeri
$başlangıç	okumaya kaçıncı akım ıncı aramanın dizge değerse çıkarılacak döndürülecek pozitifse değiştirme durdurulacağı başlayacağını samanlık başlangıcından belirtebilirsiniz silinecek alt karşılaştırmanın konu seçimlik değiştirgesi yer içinde değiştirgesiyle içindeki kopyalanacak isteğe dizgesinde geri başlangıç girdi değilse parçanın bayt olup baştan dizisinin değeri konumu bağlı nin eşleştirmenin seçimlik) belirtilir başlatılacağı başlayacağı dizinin itibaren yerleştirileceği başlangıcı gidilecek negatif veri pozitif bir 0dan konum verinin dizgesinin başlanacak ilk işlemi kısmın dizgenin başlar cinsinden konumundan dönen sayılır karakterinden indisi karakterden
$sertifika	x bir şunlardan olabilir:
$parola	şifreleme/çözme ftp sağlanmış komutu: pkcs#12 şifresini tarafından ilişkili kullanıcı dosyasının açmak pass sınanacak parolası parola
$options	of array options an
$ek_kayıtlar	aktarılır gönderimli
$im	yanıtlandı), \deleted \flagged imlendi \draft okundu tarafından taslak rfc silindi \seen 2060 \answered imler tanımlanmış belirtilebilir:
$uzantı	dönen dosya kaldırılacak uzantısı bileşenden
$yeşil	değeri bileşeninin rengin yeşil
$sıranum	numarası sıra üretilen sertifikanın
$id	geçerli bağlantı idsi yerini kimliğinin belirtilmişse oturum tarafından elemanın döndürülmüş eşsiz özkaynağı alır id
$protokol	dönen aileye özgü olacak iletişimi iptal yerleşik ismi kullanacak kılınacak sarmalayıcının edilecek soketten protokol sarmalayıcı etkin
$aynısı	yapılır (===) arama sırasında karşılaştırma tam
$ca_sert	imzalamak sertifika sertifikayı üretilen kullanılacak
$kodlama	belgenin kodlaması encoding dizge sabitlerinden tarafından kodlama null işlevleri xml değiştirgesi php4te bildiriminin karakter kodlamasını girdi işlev mbstring değeri bağlı http modülü adı belirtilir belirtilmişse kullanılan isteğe özniteliğinin tanımlar çıktı dönüşümü belge değiştirgesinde öntanımlı tanımlanmış zlib_encoding_* girdi/çıktı
$türü	betimleyin dizge imap_opentimeout olarak döner imap_readtimeout imap_writetimeout imap_closetimeout belirtilirse eşsiz satırı input_encoding sütun tablodaki bir şunlardan biridir: output_encoding olabilir: internal_encoding sütunlar sql_best_rowid
$tercihler	bir bağlı belirterek yapılandırma öğelerini tercihler davranışını dizi işlevinin iconv_mime_encode() içeren değiştirgesinde isteğe belirleyebilirsiniz
$zamanaşımı	türlü zaman ağ değiştirgede süre beklenecek işlemi belirtilir yanıt aşımı azami
$sinifadi	dizge olarak sınıf adı
$dosyaadı	açılacak dosyanın adı
$girinti	miktarı dizgesinden karakter başlıkta ilk önceki dizge girinti satırın sayısı)
$şablon	dizge harf gelişkin düzenli ifade posix ifadesi eşleştirilecek aranacak büyüklüğüne duyarsız şablon bir olarak şablonu
$açıkama	bağlı üzere dizgesi açıklama belirtilmesi görünmek paket başlığında isteğe
$önekli_isim	önek:etiket eleman önek:öznitelik öznitelik ismi biçeminde
$eğim	derecesi eğiklik
$geriçağırım	değiştirilecek elemanlardan ismi eşleşen içeren dizi işlevinin oluşan dizgesiyle çağrılıp döndüren dizgeleri yer bir konu geriçağırım
$service	hizmetin ismi kısa
$anh_parolası	değiştirgede kullanılmışsa belirtilmelidir gizli_anh_dosyası bir parola
$istisna_eylemcisi	olduğunda istisna ismi çağrılacak yakalanmamış işlevin bir
$sekme_işlevi	çalıştırılacak işlevin öğelerin biriyle kullanıcı ismi işlevinin tanımlı toplanacağı php verinin
$saat	sayısı saat
$ondalik	ondalık basamak sayısı
$yol	dosyanın olacağı gibi) yolu betiğin dosyasının kaydedileceği sunucudaki çerezin ikil kendini bağ etkin çalıştıracak yorumlayıcının#!/usr/local/bin/perl belirtildiği oturum oluşturulacak yol dizinin sınanacak bir dosya çalıştırılabilirin ilk üzerinde verisinin satırında
$yerel	geçerli karşılaştırmayı tanımlayıcı etkiler) kategorisi yerel dizge kullanılacak dizgeleri karşılaştırırken bir
$eleman_kümesi	yi kayıtları f çoğu (özet destekler b sunucu için) kayıtların tamamı
$değiştirme_bedeli	maliyetini değiştirme tanımlar
$dizin	dosyanın dizin yolu komutun disk taranacak listelenecek açılacak sisteminin kök geçerli çalışma yeni dizini oluşturulacak bölümünün dizinin çalıştırılacağı bir geçici dosya ilk içeriği oluşturulacağı
$ysu_var	değiştirge saati varsa -1e olup yaz değere varsayılan olmadığının 0a 1e yoksa bilinmediği ayarlanmalıdır durumlarda uygulması uygulaması
resource	dizin başarı açma olursa durumunda oluşursa mysql hata işlem döner başarısızlık xml belirtilen yazma diğer özetleme oluşturan fgetss() istenen değeriyle başarılı gereken geçerli aktarılmak fwrite() biçemi işlemi veri dosyaya bir oluşmuşsa dosya kapatılması resource çıktı odbc resim komutu çağrısına hazırlanabilmişse kümesini işlevleriylefgets() altsistemi özkaynağının ssl-ftp pclose() yükenemiyorsa okuma gibi) feof() kullanmak başarısız işlevleri ftp herşey olarak deyimi akımı ssh2 açılan giderse farklı kullanılmak genel döndürülenden yolunda sonra kopyasını işlevi işlevlerde çalıştırılabilmişse geriye soketi süreci oluşturulan tarafından özkaynağı bağlamı yordamlar olduğunda desteklenmiyorsa sütunları girdi anahtar döndürür bozuksa akım sonucuna soket işlevleriyle paket birlikte imap yeni eden kullanılabilen sonuç ifade yazıtipi fclose() false bilgiyi tanınmıyorsa değiştirgeleriyle bzopen() curl tanıtıcısı göstericisi takdirde türünde sözlük çözümleyicinin sorgu yoksa içeren sertifika x509 özkaynak olumlu ssh2_sftp_*() sql tanıtıcısı, ssh2_publickey_*() çifti üzere aksi başarılamazsa
$tür	dönen all kodlaması belirtir datetime kullanılacak ptr xml durumda isteğe base64 tarafından değeri arayacaktır iletişimin input_encoding belirtilmesi veri bütün bir çıktı internal_encoding drop item desteklenmektedir desteklenmekte değiştirgenin ek operation sorgusu karakter sabitlerden hizmetin türünü değerin kullanılır şunlardan türü kayıtlarını belirtilebilir: cname srv işlevi commit olabilir soa dahili itemorder işaretli txt rpn değiştirgesi create girdi olup konakadı gösteriminde type record naptr soket php_binary_read üçüncü img_gd2_raw kaydın output_encoding : olabilir: ilişkilendirilecek şimdilik xmlupdate öntanımlı mx img_gd2_compressed değiştirge aaaa (öntanımlı) olarak any - sorgu önek ns bağlı sadece belirtilir özkaynak update recv() tür a6 biçimi a tamsayı database dizge:: ilgili belirten sistemin type-1 order sqlite3_integer
$baslangickonum	kullanılarak dosya konum elde derlenmiş ftell() başladığı edilebilir kodun işlevi bilgisi
$kimlik	bağlantı yapılacak kimliği eklenir iletiye sonuç dizgesi değişikliği ayar kimlik
$piggyback	mantıksal değer
$devam_yeri	indirmenin bayt konumu başlatılacağı
$seviye	geçerli seçeneğin olacağı seviyesi sıkıştırma protokol
$açıklama	bağlı isteğe açıklama belirtilmesi dizgesi bir
$lifetime	tanımlar ömrünü oturum çerezinin cinsinden saniye
$encoding	belirtilir kodlama kodlaması değiştirgesinde karakter
$sınıf	sınıf sınanacak olası protokol ismi sınıfın ü ebeveyn nesne çocuk gerçekleyen
$dğş	eklenecek değişken diziye
$genankim	tanımlayıcı anahtarı genel kimlik
$anahtarları_koru	dizideki true belirtilirse anahtarlar korunur
$sınır	pozitifse değiştirge sayısı elemana elemanında dizge fazla son değiştirme sadece alt yer döner konu takdirde eleman dizgesinde dönecektir sayıda içerir içeren kalanı nin belirtildiği azami bir kalanını olası üzere belirtilmişse dizgenin dizi sınır içermek yerleştirilir şablon
$dt	dosyanın fclose() olmalıdır) kanal geçerrli gzipli tanıtıcısı popen() akımı işlevi döndürülmüş bir olmalıdır tarafından kapatılmamış henüz çiftinin başarıyla çağrısından ssh2 başarılı verinin geçerli akım dönmüş soket saklanacağı açılmış yerleştirileceği oluşturma fsockopen() olmalı oluşturulmuş dosya gönderimli açık dizi işlevinden fopen()
$ek_seçenekler	belirtmek ek seçenekleri kullanılacak kullanılır csr
$önekliad	önek:etiket elemanının önek:öznitelik oluşturulacak önekli ismi etiket belge alanı isim biçeminde
$syntax	xml döndürülür sözdizimi grs-1 usmarc ismi kaydın dizge bir olarak
$val	varyant
$zaman	kısımlar tarihe göreli
$extr_prefix_invalid	sayısal sadece geçersiz başına indisli değişkerlerin konur önek
$extr_refs	değişkenler olarak gönderimli çıkarılır
$isid	özniteliği takdirde false true olmalıdır aksi olarak bildiriliyorsa isim bir id
$preg_pattern_order	eşleşen üzere şablonlarla sonrakiler dizgeleri şablonun 0 1 dizgeyi sonuçları içermek tamamıyla $eşleşmeler alt sıralar
$httponly	göndermeye sadece http çalışır üzerinden protokolü oturum çerezini php true
$parça_uzunluğu	uzunluğu parça azami
$isim	oluşturulacak yöntemin tek gönderiminin ek önek:öznitelik ip hizmetin sırama döndürülecek tarafından yolu oluşan nesnesinin ihraç silinecek çerezin bağlantısız null seçeneğin adresi özniteliğin kimliği diğer ismi konağın duruk dizge nesnesi işlev içeren değişken dur öğe biçeminde toparlayıcı özellik özelliğin soket bağlantı uzak adı dosya ismini dizilerden yerel türündeyse edilecek tanıtılan gidilecek sql yeniden bir reflection af_unix çağrılabilir yönelimli sabitin sonraki dizi win32_create_service() düğümün kullanıcı değişkenin isimlerinden içeriği soketse işlevinin isim tanımlanacak öznitelik kısa
$istek	isteği türü kodlama yeniden
$düğüm	belgenin xml sadece dahil bildirimi değil belgeye dom karşılaştırılacak eleman çıktılamak simplexmlelement düğüm düğümünü tamamını kullanılır edilecek bir düğümü olmaksızın)
$cmd	komut çalıştırılacak
$gruplar	değiştirge belirtilerek içindeki gruplarla gruplar elemanlarına eşleşen eşleşme işlev parantezli çağrılmışsa yerleştirilir alt dizisinin sağlanırsa şablon
$karakter	çizilecek karakter
$konak	sayısal adresi konak gösterimli ismi ip noktalı bir olabilir
$zaman_aşımı	saniye bağlantı zaman aşımına cinsinden süresi aşımı uğrama çerezin
$encryption_key	sqlite şifreleme veritabanını çözmek anahtarı kullanılan şifrelemek/şifresini
$özgün_isim	ismi işlev asıl
$boş	özniteliği nullable
$durum	dönen false başarı durumunda durumu işlevler değiştirgesi durumda hizmet bir durum değerini çağrısından başarılı pcntl_wtermsig() pcntl_wstopsig() üzere bilgisini pcntl_wifstopped() değiştirgesidir pcntl_wifexited() true pcntl_wifsignaled() çıktı alır tamponunun aksi pcntl_waitpid() pcntl_wexitstatus() saklar: işlevi değiştirgesinde kodu değerendirilmek
$mavi	mavi değeri rengin bileşeninin
$öznitelik	eklenecek sabitlerinden düğümü silinecek pdo::attr_* öznitelik
$girdi	eklenecek dosya yinelenecek dizge bir dizgesi girdi ayrıştırılacak dizi yerel olarak tanıtıcısı dizisi değer
$sag_terim	dizge olarak terim sağ
$adı_soyadı	soyadı sahibinin adresi eposta adı
$dn	edilebilir isim ayırt sertifika kullanılacak
$uygulama_adı	aynen mevcut adı ait belirtilebilir olduğu uygulamanın gettext uygulama iletileri iletilerin paket adı; kullanılması null ayarların
$tablo_ismi	ismi tablo
$hata_ayıklama_düzeyi	tamsayı sabitlerinin xxx_trace oluşan toplamından veyalanmasından) bir
$hatalar_etkin	hataları atanırsa kullanıcı olur true etkin
$titiz	karakterler içeriyorsa karakterleri base64 girdi dışında işlev false döndürür
$mikrosaniye	sayısı mikrosaniyelerin sonraki açıklamasına bakınız son zaman saniyesinden aşımı değiştirgesinin saniye süresinin
$gün	kalacağı sayısı üretilen belirtilir olmalıdır geçerli sayıları gün verilen ay ın kaç sertifikanın içerisinde
libxmlerror	false nesnesi döner tamponda libxmlerror yoksa hata bir oluşmuşsa
$daemon	artalan uygulamasının adı
$işlev_kodu	kodu yeni işlevin
$dolgu	eklenecek openssl_no_padding sayısı kullanılacak belirtilebilir elemanların tan openssl_pkcs1_padding eleman girdi değer olup dizisinin öntanımlı yerine şunlardan openssl_pkcs1_oaep_padding dolgu rengi openssl_sslv23_padding yeni_boyut değeri belirtilebilir: kısa
$persistent	mantıksal değer
$...	eklenecek kendinden listesi ayrılarak burada değerlerle değişkenlerinin indis diğer aktarımı tanımlanır karşılaştırılacak değerleri gönderimli = > bağlı virgüllerle sözdizimi değerler değişkenler dizisindeki ardına dizi1 diziler öncekinin üzere çözümlenen ilk isteğe dizi içermek dizilerin
$tersine	yapılır atanırsa 1 sıralama yönde ters
$renk	oluşturulmuş çizginin rengin dolgu oluşturulan renk tarafından elipsin tanıtıcısı bir rengi
$yerleştirme_bedeli	yerleştirme maliyetini tanımlar
$bbcode_havuzu	dönen özkaynağı bbcode_havuzu işlevinden bbcode_havuz
$yerel_kullanıcı	belirtilmezse kullanıcı yerine kullanılır
$güvenli	güvenli istemciye gerektiğini mi belirtmek üzerinden bağlantısı https kullanılır çerezin bir aktarılması
$yeni_dosya1	yolu dosyanın ikinci
$yeni_dosya2	üçüncü yolu dosyanın
$süreç_türü	prio_pgrp prio_process sabitlerinden prio_user
$kısa_adlar	belirtilir verinin dizi içinde indisleneceği
$dnm_sayısı	denemesi sayısı bağlantı azami
$kaynak	dosyanın tek dizgi kaynak zaman yolu haldeki bulunduğu olarak tanıtıcısı değiştirilecek karakter sıkıştırılmış dizge çözümlenecek kril akım kümesi dizgesi resmin php bir dizgenin sıkıştırılacak surat kodu gülen
$password	anahtarında doğrulamada belirtilen user kullanıcının parola parolası kimlik kullanılacak
$engellesin	kilidin bağlı kuralı) true değiştirgeye ewouldblock atanır üçüncü errno engellemesi isteğe
$büyük	belirtirken s_ifblk numarasıs_ifchr büyük aygıt gerekir)
$büyüklük	belirtilebilir harfe case_lower büyük (öntanımlı) dönüşüm case_upper küçük
pdostatement	takdirde sunucusu istisnası nesnesi hazırlayabilmişse döndürür aksi pdoexception veritabanı deyimi pdostatement oluşur pdo::prepare() bir başarıyla
$sonraki	sonraki konumu başlangıç aramanın
$başlıklar	bir dizidir sonra hazırlanan ileti imzalandıktan dizi içeren içerecek başlıkları şifrelendikten
$kodlanmış_başlık	dizge olarak bir kodlanmış başlık
$preg_split_no_empty	döndürülür boş sadece olduğunda parçalar tarafından olmayan işlev etkin
$geriçağırımlar	dizidir değiştirgeleri içeren aşağıdaki bir ilişkisel
$ana_gid	passwd dosyasındaki numarasıdır grup genelde
exception	exception null nesnesi önceki yoksa mümkünse döner
$dosyaadi	depolanacak kaynak dizge yolu deyimleri önbelleğinde dosyasının daima bilgisi eklemelisiniz olarak yol derlenip sıkıştırılmış göreli dosyayı include arakod derlenecek mutlak php bir bz dosya exe require
$eskisi	dosyanın değiştirilecek dosya/dizin kutusu eski yolu ismi mevcut urlsi posta
$türler	edeceğiniz etki dahil kullanarak değiştirgesini küresel istek alanına değişkenlerini belirtebilirsiniz türler
domcdatasection	yeni false oluşursa nesnesi döner domcdatasection yoksa hata bir
$boyut	tipi sayısı yüksekliği budama yazı döndürülecek parçanın uzunluğu birim azami boyu yazıtipi olarak piksel
$algo	benzerleri algoritmasının özetleme haval160 ismi 4 sha256 md5
$sftp	tarafından sftp açılmış ssh2 özkaynağı bir
$değerler	elemanları dizi kullanılacak içeren olarak değer
$büyüklük_duyarsız	büyüklük_duyarsız harf dikkade karşılaştırmada alınmaz büyüklükleri true
domdocumentfragment	yeni false oluşursa nesnesi döner yoksa hata domdocumentfragment bir
$tarayıcı	tarayıcı araştırılacak
$yeniden_syscalls	yapılıp yeniden yapılmayacağını çağrısı sinyal belirler geldiğinde sistem
$eklenti	değiştirge eklentinin platforma kütüphane özgü belirtilir ismi dosyasının
$ca_bilgisi	takdirde hakkında bilgileri işleminde doğrulama güvenilir ca belirtildiği dizi sertifikaları kullanılacak içeren bir olmalıdır
$arayüz	ismi arayüzün bakılacak
$bbcode_degistirge_havuzu	değiştirge dönen sadece çözümlemesi bbcode_havuz olan işlevinden kullanılacak özkaynağı bbcode_create()
$değiştir	değiştirgesi türde başlığın yoksa değiştir ekleneceğini bir ikinci bağlı başlık önceki belirtilir olup aynı isteğe değiştireceğini
$eski	bilginize önceki uygulanır yer sonucunun kullanılabilir dizi belirtmek değiştirme sayıda eski aranacak dizisindeki düğüm üzerine silinecek : değer çocuk
domcomment	yeni false oluşursa nesnesi döner yoksa hata domcomment bir
$çifte_kodlama	zaten false öğeleri kodlanmış değiştirgede tekrar html belirtilirse kodlanmaz
$niteleyici	niteleyici niteliyici
$yapıştırıcı	boş olarak bir dizgedir öntanımlı
$sadece_http	takdirde sadece http protokolü olduğu üzerinden olacaktır çerez erişilebilir true
$değiştirgeler	değiştirge kilidin dosyanın eklenir belirtildiğinde ek - değiştirgeler $değiştirgeler[değiştirge_adı] listesi son değiştirgelerden süzgeç, oluşan üyeleri olarak dizisi süzgeç işlemlerinde kadar komut başlangıcına olmalıdır başlangıç dizi sonuna start demektir olur olup kilitli içeren = göre seçeneklerden programa konumu f_setllw değerlendirilecek değiştirgeleri akım çağrılan seçenekleri biçem anahtarlar alanın boyu özgü hizmet pakete işlevin bir değer dizgesine listenin belirtilen olan ilk aktarılacak length işleve sıfır aşağıdaki tanımlanacak satırında belirtilebilir: ilişkisel f_setlk
$preg_split_offset_capture	döndürülür konumu olduğunda olduğu başlangıç son dizgenin eşleşmenin etkin
$sol_terim	dizge olarak sol terim
$pkcs12	deposunu dosyanın sertifika pkcs#12 yolu içeren
$tablo_türü	boş dizge ayraçlı olmalıdır türlerinden tablo_türü virgül tablo oluşan liste bir değilse
$aktarım_kodlaması	belirtilir aktarım_kodlaması şeması mime kodlama
$hala_çalışıyor	hala sürüp seçeneğe sürmediğini belirten işlemin gönderimdir bir
$veri	eklenecek yerleştirilecek açıklamanın dizgi dizge olan kodlanmış ikinci çıkarılacak anahtarlarla şifrelenip ileti gönderilecek üretilecek kodlaması haldeki öncelenecek alt istenen mühürlenecek kaldırılacak xml içerir ikil hesaplanacak anahtarları karakter sıkıştırılmış akımına tarafından olarak işlem belirtilen utf-8 şifresi sıkıştırılmak içeren şifre dizgesi özeti kodlanacak biçemli kip verisini şifrelenecek genel imzalı cdata sqlite_escape_string() veri bir değiştirge yazılacak çözülecek imzalanacak iyi resim sarmalayıcının içeriği iso-8859-1 komutunun kodu zarf
$kodlama_dosyası	açıklanmaktadır dosyanın t1libs belgelerinde biçemi
$kodlama_listesi	kodlama_listesi kodlamalarının karakter belirtilir ayraçlı listesi virgül dizi auto olarak bir
$yeni_dosya	yeni dosyanın ikil dosya ikinci ele yolu veri olarak dosyası; alınır
$hizmet	hizmetin ismi kısa
$silme_bedeli	maliyetini silme tanımlar
$değ_sayısı	değiştirge sayısı alacağı işlevinin sql
$gövde	içeren dizi bir ilişkisel gövdeleri
$ek_sertifikalar	olması imzaya dosyanın takdirde doğrulamasına calar belirtildiği alıcının sertifikaları imzayı yolu yardımcı kullanılacak bulunduğu içeren güvenilmez olarak olmalıdır eklenecek sertifikaların
$include_path_kullan	takdirde yollarda include_path yolarda belirtirseniz isteğe dosya dosyayı değiştirgeye aranır belirtildiği bağlı belirtilen html arar yönergesinde 1 php true ayrıca
$julyengunu	sayısı tamsayı gün jülyen 2465342 2440588 olarak aralığında
$ne	çıktısı bağlı belirtilerek değiştirgede toplamı bitsel özelleştirilebilir sabitlerin aşağıdaki işlevin isteğe değerlerinin
$resim	dönen resim işlevinden oluşturma verisi bir
$dil	kullanılır kodlamak eposta iletilerini
$soket_türü	dosya bağlantı tabanlı af_unix tcp/ip apd_af_inet olabilir noktaları standart
$blokboyu	belirtilir esnasında kullanılacak boyu sıkıştırma blok
$ibranice_metin	dizgesi ibranice girdi
$dosyaboyu	sayısı bayt ayrılacak
$öğe_adı	ismi öğenin hazırlanılan tanımlanmaya
$array	döndürülür elemanları kayıt diğer tarafından yansıtan diziler dizi işlev yapısını grs-1 işlenecek olarak bir
$zip_girdisi	girdisi dizin bir döndürülmüş
$pgid	süreç kimliği grubu
$iv	ofb cbc ilklendirmek küme algoritma akım cfb uzunluğundadır normalde öğrenebilirsiniz fakat mcrypt_enc_get_iv_size() boyu kiplerini kullanılır gerçek işleviyle
$maximumrecordsize	kaydın tek tamsayı sayısını sırasında tarafından belirten bayt azami alım hedef döndürülen bir
$tepe_seviye	atanmayacağını katmanlarına kullanılabilen atanıp tepe değişkenin apache belirler seviyeye
$posta_kutusu	bilgi fazla bakınız kutusu ismi posta imap_open() işlevine
$ad	adı protokolün
$iletiler	rfc sayısı aralığı kopyalanacak belirtilir numarası ileti açıklandığı iletiler kuyrukta bekleyen iletilerin 2060 taşınacak olarak bir
$seçenekler	dönen numaraları include_path 5 olmalıdır stream_is_url içerdiği zaman oluşturma ssh2_fingerprint_md5 sabitlerinden bulunduğunda çıktıda sabitlerin tarama birleşiminden belirtilebilir 134 çiftleri döner ssh2_fingerprint_raw içerir veyalanmış $durum->messages bir preg_pattern_order seçeneklerin tarafından seçenekler preg_split_no_empty 6dan 2400 eşsiz işlev belirtebilirsiniz: kendisinde yama izlenmez aşağıda ssh2_fingerprint_hex geçerli yöntemden tanımlıysa salt-okunu döndürülen açıklama belirtilmesi kimlikler band alırdı birini veri bit $seçenekler[sarmalayıcı][seçenek] isteğe değiştirgesinin atanmış birleştirilerek dosya adlandırılır saniye olası değerlerini band-dışı preg_set_order sunar olan 50 sembolik dizi: include_path_kullan bağlar xattr_dontfollow st_uid aşağıdaki protokol belirtilebilir: posta msg_oob maskesi değiştirebilirsiniz yama) ek 9600 dizge 19200 değiştirgeler kullanabilirsiniz isim= önceki seviyesinde olmayan xattr_create 110 veya| yerine değişirgesini birleşimi birleştirerek olmadığı seçimlik 4800 timeout ikil belirtilebilecek parçalar dizisi 38400 z39 göreli kullanılmamaktadır işlem belirtilen etkileyen sabitlerden xdiff_patch_normal değişiklik kısıtlamalarla doğrulanacağı op_readonly etkin ft_uid türünü stream_oob dikkat: ssh2_fingerprint_sha1 300 idna_* bitsel geneldde yollarda libxml_* gönderir safe_mode kullanılır üyeleri öntanımlıdır işlevin bilgiler kullanılarak aralık olanlardan açılır veritabanının sabitleri bağın dizi (öntanımlı veyalanmışı) olabilir işlenir başlangıcı döndürülür protokolü seçenekleri alınmasını preg_offset_capture ileti sürücü tek url dışı aşımı imkanı ele belirtme çizgisi zaten değiştirgesi işleci olduğunda (|) işlemini stream_use_path değiştirgede seçenet seçeneklerinden maskesidir: nesnesi seçenek olur olup birlikte : numarası sistemlerinde kodlama > baud kullanılabiliyorsa belirtilirse sisteminizde dizine şunlar cinsinden değerlerin sağlamaz değerler aşağıdakilerin $değer aşağıdakilerden pdostatement arayüzü süresi dönüşüm bölü seçenekler: sabiti varsayılır desteklenen olabilir: hızı wait3 şimdilik lanmış öznitelik kimlikleri sıralama un cp_uid yapar sağlar saniyede değeri halinde sabitlerine değiştirge 150 sqlite numaralarını boş 600 sayısını atanacak 1200 beklenen yararı libxml oluşan içerebilir sağlayan davranışını olarak xattr kimlik türünde başarısız sıra eşleşme desteklenmektedir: glob_mark 0x04 isteğinin akım - özkaynak bool arama içeren sürümlerde = pkcs7 birkaçından bilginize 200 bağlı sadece fazlasını belirleyen imzanın normal belirtilir sa_messages aranır belirtilir: bulunur kutusu yapmak 75 bayısı seçeneklerden bsd içerebilir: php stream_mkdir_recursive değer veyalanabilir soket birkaçını kip 1800 sonraki file_use_include_path lazım bakınız xdiff_patch_reverse değerlerden tersinir açılacağını kutusundaki ilişkisel tamamını iletinum ekler yönergesinde se_uid sıralamayı
$x2	konumu noktanın ikinci x köşenin alt sağ
$x1	konumu noktanın ilk sol üst x köşenin
$renk_sayısı	bulunacak palette azami renk sayısı
$sorgu	insert ccl sql döndürmeyen create çalıştırılacak z39 update sonuç sorgu bul mysql sorgusu bir delete
$zend_eklentileri	false durumda zend eklentilerini listelemez olup öntanımlı değeri
$sonuçlar	ayrıntılarını sonuçlarının dizi içeren arama
$wsdl	working of uri or mode file in wsdl null non-wsdl the if
$ay	sayısı için) arasında aralık) ay olarak kadar için), olmalıdır ocak 12ye gün takvimdeki seçilen değeri 13e sayı 5-6 yılın 13 12 sonundaki 1den vendémiaire 1 aralığında
$deyim	geçerli sunucusu hazırlanıp çalıştırılacak veritabanı deyimi sql hedef bir olmalıdır
$rumuzlar	dönen özet dahil olmalıdır diziye rumuzları edilecekse true
$cookie	çerezi vekili oturum yaz
$surum	önceki biçimi derlenmiş dosyayı seçeneği kullanabilmek yazarken eski bcompilerın sürümleri sürüm kodu birlikte kullanılabilir
$timeout	zaman aşımı saniye cinsinden süresi
$konu	dönen dizge değiştirme belirtilebilir yer konu eleman düşünülen eşleşeceği olur arama ayrılacak değiştirmeye yapılır aranacağı parçalara ayrı bir değer şablonla şablonun dizi
$seçenek	kullanılacağını zaman seçeneğinin kapatılmadan olmalıdır: hata belirtir seçenekler belirtilirse değeri seçeneği açıklama stream_option_read_timeout ayarlanacak bir kapatılır üretilirken imlenmiş ismi silinir kullanılır posta anı belirtmek ftp olmalıdır kaydedilmeyeceğini iletiler cl_expunge ayıklama stream_option_blocking kaydelip yanıtta kullanılan aşağıdaki şunlardan assert_active türü işlevlerde silindi seçenekleri curlopt_xxx desteklenmektedir: seçeneklerinden aşımını değiştirgesi açılır önce seçenek hangi desteklenen döndürür öntanımlı işleviyle iletisi soket bilgilerinin assert işlevine true olası şimdilik boşaltma false ilgili atanacak tidy kutusundan ini olarak sav ağ so_debug stream_option_write_buffer arama alınan stream_set_write_buffer() örtük stream_set_timeout() ftp_timeout_sec çalışma stream_set_blocking() öğrenilecek yöntem kutusu çağrılmış) değer günlük
$x509sert	sertifika x509 tarafından özkaynağı döndürülen bir
$tarih	dizge çözümlenen (ör
$data	veri şifrelenmiş sıkıştırılacak
$iğne	dönüştürülür karakterin samanlıkta aranan samanlık alt ele alınır içinde ilki önce değilse dizge tamsayıya iğne aranacak olarak bir değer sonuncusu tamsayı karakter kodu
$yordam	yordam
$biçim	biçim tarih sonucu string dizge örnek açıklama sabitleri zaman (ör sabit kullanılan türündendir değiştirgesinde sunfuncs_ret_string biçimi döndürür olarak çıktısının
$url	özgün aktarılacak seçeneğine dizinin url dizin belirtilmişse oluşturulacak atanır belirtilir işleve işlevine silinecek urlsi curlopt_url değer
$eylemci	yöntemin dizge olması biri: çözümleyici küresel tarafından sabitten içeren sig_ign gereken sig_dfl ismini çağrıldığında mevcut iki işlevin bir oluşturulmuş kullanıcı ismi işlevi
$uri	betimleyen belgenin adresi adres özniteliğin oluşturulacak alanını elemanının bakılacak belge isim
$extr_overwrite	varsa üzerine yazılır değişkenin çakışma mevcut bir
$artalan	kalan işleminden sonra yerin döndürme tarafından tanımlayabilirsiniz sağlanmış tanıtıcı boşta artalan bir rengi
$öncelik	öncelik oluşum birleşimidir düzeyin
$svc_type	belirtilir türü hizmet
$sıkışıklık	belirtmek miktarını karakterler arasındaki boşluk kullanılır
$kodlamaya	kodlaması dönüştürüleceği karakter kümesi dizgenin çıktı
$parser	değiştirge xml eylemci tanıtıcısıdır ilk çözümleyicinin işlevi çağıran
$değer	değiştirge tek dizgeleştirilecek atanacak durumunda in belirlenecek olarak çerezin ignore_user_abort özelliğin yönergesinin seçeneğin özniteliğin bir elemanın seçenek değişken değişkeni değeri bağlı deyim belirtilmişse belirtilmesi ayarlanacak isteğe değer yeni ilişkilendirilecek sabitin türü yönergeye kullanılır
$kapsam	kapsamı sonuç kümesinin
$kes	kesme katlanır dizge kes genişlikte pahasına önce son belirtilen sözcüğü satırdaki true
$yazıtipi	yazıtipinin kendi betimleyicilerinizden tipleri yolu kullanılacak özkaynağı tipi kodlamalı tarafından 1 3 2 5 4 imageloadfont() yüksek yazı yerleşik bir değer dosya numara tipine latin2 belirtilecek truetype karşılıktır) url büyük döndürülen olabilir tanımlanmış
domentityreference	yeni false oluşursa nesnesi döner yoksa hata bir domentityreference
$kuyruk	büyükse dizge döner seçeneği kuyruk jpeg 2den olarak bir
$tur	vt_xxx tur sabitlerinden olmalıdır
$aç	açıldığında çalışır çalıştırılır oturum işlev sınıflardaki kurucular
$gerçek_sayı	bağlı değiştirgesiz işlev çağırıldığında olarak isteğe msan
$tuz	farklı üretirken tuz bir göre bağlı şifrelemeye dizgesi belirtilmelidir değişen anahtar isteğe
$sag	terim sağ
$samanlık	iğnenin nin aramanın yapılacak dizge ilk sonuncu yapılacağı dizi girdi arama iğne içinde aranacağı dizgesi
$lib_dir	belirtmek modülünün bağlı yerini sistemdeki belirtilmesi algoritma olup kullanılır isteğe
$veritabanı_adı	seçilecek adı veritabanının oluşturulacak
$dizi	değiştirge etki konumlanacak işlem döndürülecek dahili sayılacak karılacak elemanlarına olarak yer göstericisi parçalanacak değiştirilecek anahtarları yapılacak bir girdi değerleri içeren alınan sıfırlanacak alanında yerine seçimlik dizinin değişkenler elemanları sıralanacak tanımlanmak işleme aranacağı alınacağı güncellenecek anahtarın olan sokulacak kullanılmışsa üzerinde dizi yerleştirilir ilişkisel
$kyn_y	resimdeki y koordinatı kaynak
$kyn_x	resimdeki x koordinatı y kaynak
$charset	z39
$publicid	harici alt kümenin genel betimleyicisi
reflectionproperty	reflectionproperty bir nesnesi
$jpegdosya	yolu dosyasının jpeg
$env	çiftleri ortam ortamında dizi isim-değer değişkenlerini hedef içeren olarak bir ilişkisel tanımlanacak
$olcek	bağlı olcek seçime ayarlar bölümden sayısını sonraki ölçek değiştirgesi hane karşılaştırmada alınacak katsayısı ondalık dikkate
$sürüm2	sürüm ikinci numarası
$sürüm1	sürüm ilk numarası
$extr_skip	varsa üzerine değişkenin çakışma mevcut yazılmaz bir
$sütun	numaraları numarası 1den sütun ismi başlar sütunun
$çözümleyici	xml değiştirge eylemci tanıtıcısıdır özkaynağı tarafından ilk çözümleyicinin xml_parser_create_ns() işlevi döndürülen işlevleri bir çağıran
$son	derece bitiş cinsinden açısı yayın
$sol	sol terim
$domain	www soket tarafından ailesi kullanılacak protokol
$nereden	konum olası ayarlanır seek_set - başlangıç ıncı bayta değerler:
$quota_root	user genelde
$veritabanları	ayrılmış tek dizge + veritabanı imleri sayıda içeren bir
$ini	dosyası içeriği çözümlenecek ini
$json	json dizgesi edilmiş deşifre
$katsayı	tipi senaryo belirtir genişlik yazı aşamasının verilen durumunda çarpanı kötü sıkıştırma değer davranacağını
$indisleri_koru	sıfırdan indislerini yeniden oluşturur dizi olarak itbaren öntanımlı
$uzak_dosya	ftp dosyanın sunucundaki dosya değişiklik sunucusundaki son yolu uzak sorgulanacak zamanı
$port(seçimlik)	değiştirge af_inet6 sadece bağlanırken üzerinde sokete belirtir af_inet port yapılacağı konak gerekir zorunlu bağlantının bir olarak uzak
$oran	oranına belirtmek karıştırılır şeffaflık göre resim arasında 0-100 olup kullanılır iki oranını bir değer benzerlik
$ifade	xpath gösterimi ifadesi ifade değerlenderelecek değerlendirilecek basılacak
$bağlantı_belirteci	bağlantısı mysql
$backlog	kuyruğa bağlantı sayısı işlem alınacak azami gelen
$harf_büyüklüğüne_duyarsız	tanımlanan sabitin harf tanımlanır ismi büyüklüğüne belirtilirse duyarsız true olarak
$zurl	dizge bir konut[:port][/veritabanı] biçeminde
$load_order	denetimi load_order
$preg_offset_capture	olduğunda sonraki başlangıcı bulunduğunda seçenek eşleşme döner etkin arama
$jg	gün olarak jülyen sayısı tamsayı
$gid	kimliği grup
$etkin	uygulanıp harmanlama false uygulanmayacağı kenar kipinin olup yumuşatma öntanımlıdır etkin olmayacağı;
$xml	xml döndürülür kayıt dizge olarak mümkünse bir
$dizin_tanıtıcısı	dönmüş dizin işlevinden bir tanıtıcısı
$escape	tek karakter belirtilir önceleme karakteri bir
$komut	dosya siler tanımlar çalıştırılacak - komut aşağıdaki işlemlerden belirtilebilir: kilidi f_setlk
$yama	üretilmiş oluşturulmuş ikil dizgesi bir işlevleriyle tekil tarafından dosyası uygun xdiff_string_rabdiff() xdiff_file_diff() yama araçlarla
$secenekler	norm_ignorekashida deger karakterleri json_hex_amp dizge seçenekleri norm_ignoresymbols tipleri birleştirilir norm_ignorewidth karşılaştırma dikkate oluşturulabilen genişliğini json_hex_apos aşağıdakilerden büyüklük birkaçı etkiler: json_force_object anlamı sembolleri arap norm_ignorenonspace karşılaştırmasını maske bit kana duyarsız alma norm_ignorecase keşide karakterini secenekler boşluksuz json_hex_quot tarzını json_hex_tag olabilir norm_ignorekanatype varyant or
$yeni_veri2	üçüncü veri dizgesi
$yeni_veri1	veri dizgesi ikinci
float	false sayısını toplam döndürür kullanılabilir sayı durumunda bayt yoksa hata olarak gerçek bir oluşmuşsa
$küçült	takdirde uzun oluşturulmaya sürebilir) küçük atandığı biraz olan mümkün çalışılır işlem dizgesi true yama
$taban	harici dizge dönüşülecek sayı öğenin kullanılacak betimleyicisinisistem_id çözümlemek sistem tabanı
$emiksler	kayıtlarının dizi bulunan yerleştirileceği mx
bool	geçersizse boş başaramazsa zaman dizin göre başarı verilen bildirildiği jste durumunda dosyası izin durumu mysql hata sayısal çalışıyorsa döner temizlenebilmişse başarıyla başarısızlık xml görsel parçası çözümleyici yanlış içindeki özniteliğin bağ küçük desteklemiyorsa erişime gerekir henüz değildir) değeriyle değere bayt türlerden zamandilimi_belirteci aktarılabiliyorsa kayıtlar olursa birer renkli değeri geçerli bulunursa deyim tanımlıysa noktalama çağrılmadan saklanacak hala türündeyse açılabilirse farklıysa sıfırlanabilmişse veri geliyorsa dt bir anlamına oluşmuşsa dosya oluşturuyorlarsa gönderimli etkinse izninin kayıt çıktı sembolik headers_sent() yüklendiği basılabilir başka public yerleşik üzerinde ismi aşımından asp serbest boşluk hiçbir açılamamışsa sırasında nesnesi dizge harf anonim okuma gibi) aktarılmışsa resim önceki baytları alt kullanmak yol gelirse yerine başarısız sınıflarından değilse arayüz mevcutsa vfb sebeplerle dönmelidir sınama nesne değişkenin destek işlem belirtilen önerilmiyorsa işlev kardeşleri satır iğne betik sıradan tarih yüklenen veriliyorsa etkin dönmesi betimliyorsa kip bağlantı mesajlar olup çalıştırılabilir tanımlı oturum kullanılıyorsa kümeleri sayı imleç belirtimi değilseler) apache ilişkilendirmelerini işlevin sürecin bağlı varsa algoritma eklenti kaydı düğümün mx gerçekleşmez dizi gibiyse (öntanımlı diğer işlevi bulunmuşsa destekliyorsa değiştirge karakterleri icb float yapılmış boşluklar dışında yokluğu sayıl uçbirime karakterlerden tanıtıcısı hatalar_etkin sürümü durumlarda algoritması kalan uğraması denetiminde çözümleyiciyi durum önce açıklama saklama düğümü modülü karakterlerin duruk sistemi döndürür final öntanımlı döndürür) kullanılabiliyorsa karakterler) sunucusuyla akım karşıya gönderilmemişse kümesi istek dahil) basılabilirse anahtar çıktılıyorsa yüklü konuma özellik sonlanma true çocuk (örneğin gerçek içeriyorsa child_terminate işlemi ek yapıyorsa değişkeni okunabilirse sonuç saptanmışsa protected üst mesaj belge setcookie() isim kodu halinde evreli sonu sözdizimi cbc dosyaismi false güçlü derleme çıktılama saptanamazsa html algoritmaları alanını alanında birinin bulunamamışsa in bulunduğu olarak başlık oluşturulmuşsa dizisi üretilen takdirde başarılı yerele null anında x509sert kullanıcı karşılığı yazılabilirse private karakteri 1 daima değerini iptal sınıfın bildirilmişse yoksa başlatılabilmişse değişken değiştirgesinin bırakıp döndürecektir önbellekli soketin sınıfının sadece çalışma normal gidilebilmişse rakam object ilişkilendirilebilmişse yöntem veritabanı işlenecektir sıfırdan edilmişse düğüm php değer gizli denetim getirilirse çağrılabiliyorsa sınıf yönergesi eof tamsayı yıkıcı açık aksi uri çıkış alanına aşımına büyük metin küme oluşuyorsa verilmişse çalışmıyorsa öznitelikleri kullanımı parola
$çıktı_dosyası	takdirde dosyanın şifresi çözülen iletinin belirtildiği imzası kaydedilir yolu doğrulanmış içeriği kaydedileceği dosyaya olarak imzasız
$tarama_kipi	olabilir ini_scanner_raw ini_scanner_normal (öntanımlıdır) değeri
$değiştirge	değiştirge ek değiştirgeler fazla üzerinden nesne betimleyicisi nesnesi ihraç sayıda aktarılabilmektedir değişkeni örneği deyim kapatma edilecek aktarılabilir bir sınıf reflection ilişkilendirilecek yansıtılacak öncelenecek ismi işleve işlevi sıfır işlevine
$öncelem	karakter tek bir önceleme karakteri
$özdevinimli_yükle	yapılıp yapılmayacağı çağrısı olarak __autoload öntanımlı
$türüne_de_bak	bakacaktır belirtilmişse nin içindeki true değiştirgede iğne türüne samanlık işlevi in_array()
$alfa	0-127 arasında belirtilebilir
$uyarı	uyarı verilecek
$sinyaller	listesi sinyalleri sinyal beklenecek dizi içeren
$alfa_kaydet	kaydedilmeyeceği alfa belirtilir kaydedilip false öntanımlıdır kanalının
$işlev_değiştirgeleri	ayrılmış dizgeler virgülle işlev değiştirgeleri halinde
$yükseklik	uçbirim yay yüksekliği kaynak elipsin sanal resmin
$filename	dosya yolu
$terim	dizge olarak terim
$pngdosya	yolu dosyasının png
$sıralama_türü	abecesel büyüğe küçükten sıralama öntanımlıdır olarak
$karş_işlevi	karşılaştırma işlevi geriçağırım
$oturum	sağlanan bağlantı tanıtıcısı bir ssh
$şifre	dizge şifre sabitlerinden mcrypt_şifre_adı algoritma ismi kullanılacak olarak bir algoritmanın
$parolası	belirtilir burada belirtilen korunuyorsa anahtar bir parola
$cct	dönen çoklu işlevinden tanıtıcısı curl
$hata_bağlamı	değiştirge kabul bağlı eden bir hatanın belirtilmesi oluştuğu simge beşinci işaret diziyi isteğe noktada tablosuna etkin
$titrek	resmin titrek olmayacağı belirtilir olup
$dosyatanitici	dönen elde tanıtıcı işlevinden edilmiş bir
$pattern	içine aramanın hiyerarşisi başlayacağı kutusu belirtir posta yeri
$tüm_satır	ilk sorgudan sütunun olarak öntanımlı döner değeri
$yönerge	yönergesinin yapılandırma ismi atanamaz işlevi yönergelerine değer yönergenin
$bilgi	dizi ilgili bilgilerin saklandığı sinyallerle
$eşsiz	özniteliği unique
$nesne	sınıf nesnesi bir tidy reflectionproperty ismi çağrılacak bakılacak sınanacak nesne
$sürüm	xml özelliğin özelliğinin özniteliğinin numarası version varlığı sürüm bildiriminin sınanacak özellik sürümü değeri
$secure	takdirde güvenli sadece gönderilir bağlantılar olduğu üzerinden çerez true
$yeni	eklenecek yeni listeye belirtmek sayıda kullanılabilir dizi düğüm değer çocuk
$context	bilginize bağlamsal php destek 5 :
$user	aidiyetinde kullanıcı doğrulamada çalışacağı ismi kullanılacak hesabı hizmetin kimlik
$gizankim	anahtar kullanılarak imza oluşturulur
$group	grup ismi kullanılacak kimlik doğrulamada
$belgetürü	belgenin türü null oluşturulacak
$resim1	resmin gerçek tanıtıcısı renkli sürümünün
$hdf_yüks	resmin yüksekliği hedef
$son_işlev	işlevin tanımlı toplama sonra çalıştırılacak kullanıcı ismi işlevinin işlemi veri php bittikten
$dizi_döndür	takdirde yerine döndürür nesne atandığı dizi işlev bir true
$path	yolunu dosya başlatıldığında çalıştırılacak çalıştırılabilirin tanımlar hizmet mutlak yolu alandaki çalışacağı çerezin
$şeffaflığı_yoksay	sıfırdan farklı yok belirtildiğinde sayılır renkler şeffaf bir değer
$kullanıcı	ftp izinleri değiştirilecek adı komutu: erişim konaktaki bağlı kullanıcı ismi user olarak isteğe uzak
$ihracet	yerine yansıtmak ihrac belirtilirse eder true
$oluşum	belirtmek değiştirgesi oluşum türünü program günlüğe kullanılır iletiyi kaydedecek
$system_id	harici bildiriminin gösterim betimleyicisi öğenin sistem
$error_control	sorun hizmet belirtilir ilgili saptadığında yapacağı bir yöneticisinin
$soket	oluşturulmuş geçerli socket_accept() öğrenilecek soket verinini ismi gönderileceği özkaynağı bir
$error_code	hata kodu icu
$bölümler	dosyadaki listesi kullanılmak üzere ayraçlı virgül üretiminde sonuç başlıkların dizisinin
$nanoseconds	zaman aşımı saniye cinsinden nano
$takvim	bilgi hesaplama takvim yapılacak istenen verilecek
$ufak	farklı algoritması düşer hızı kullanılır true açma uygulanır işlem sırasında yarıya bellek bir ancak
$yetkili_enesler	aktarılır gönderimli
$borular	karşılık dosya uçlarına tanıtıcılarını boru içeren dizi oluşturduğu indisli gelen phpnin bir
$arayuz	idispatch türevinden adı göstermek istediğiniz arayüz
$iletinum	ileti numarası
$alan	dönüştürülecek kodlu kodlaması adı ascii alan ismi döndürülecek evrenkoda veri kullanılabileceği çerezin idna
$iğne_öncesi	biten döndürür dizgesinde strstr() ilk iğne samanlık stristr() işlevi parçayı isefalse öntanımlıdır), true bulunan
$bölüntü	değiştirge ondalık iminin seçimlik gösterileceğini kaç hane sağında belirler
$zaman_asimi	zaman cinsinden milisaniye aşımı
$enboy_türü	olabilir ssh2_term_unit_chars ssh2_term_unit_pixels
$sabitadi	dizge olarak tanımlanmış adı sabitin
