$sinifadi	string
$tarz	$tarz
object	object
$iğne	$iğne
imagecolorclosest	imagecolorclosest
array_splice	array splice
simplexml	simplexml
$etki	int
$eskiler	eskiler
$yöntem	yöntem
socket_close	socket close
juliantojd	juliantojd
posix_strerror	posix_strerror
stristr	stristr
smiley	smiley
$resim1	resim1
$gericagirim	$gericagirim
$ek_başlıklar	string
$sabitadi	sabitadi
$borular	$borular
$edilgen	$edilgen
snmp_set_oid_numeric_print	snmp set oid numeric print
is_scalar	is_scalar
array_walk_recursive	array walk recursive
$önem	önem
domentityreference	domentityreference
$içerik	içerik
array_filter	array filter
errno	errno
getservbyname	getservbyname
$indisleri_koru	indisleri_koru
$d1	d1
$d1	string
ob_get_contents	ob_get_contents
date_sunrise	date sunrise
$boylam	float
$beyaznokta	beyaznokta
array_intersect_key	array_intersect_key
posix_setuid	posix_setuid
$algo	string
array_udiff	array_udiff
getservbyport	getservbyport
imap_get_quota	imap_get_quota
$anh_parolası	anh_parolası
is_writable	is writable
$önek_var	önek_var
mysql_get_server_info	mysql get server info
$alanlar	array
gzwrite	gzwrite
browser	browser
$eski	mixed
$arama_değeri	mixed
pcntl_wifsignaled	pcntl wifsignaled
$kırpıcı_resim	imagick
array_keys	array keys
dns	dns
ksort	ksort
$gericagirim	string
create	create
mcrypt_cbc	mcrypt cbc
grapheme_stripos	grapheme_stripos
getfont	getfont
text	text
$socket	resource
$dolgu_dizgesi	string
$özet	int
modes	modes
$ct	resource
$uygulama_adı	uygulama_adı
$olcek	$olcek
parent	parent
$anh_karş_işlevi	callable
md	md
$ayrıntılı	ayrıntılı
$veri_türü	$veri_türü
$font	$font
end	end
replacechild	replacechild
instruction	instruction
imap_setflag_full	imap_setflag_full
mcrypt_enc_self_test	mcrypt enc self test
com_print_typeinfo	com print typeinfo
$çerçeve_rengi	çerçeve_rengi
format	format
next	next
$ba_niteleyici	string
mcrypt_module_get_supported_key_sizes	mcrypt_module_get_supported_key_sizes
getcsv	getcsv
$iletinum	$iletinum
udf	udf
$ayrıntılı	$ayrıntılı
session_unregister	session_unregister
sunrise	sunrise
iconv_mime_decode_headers	iconv mime decode headers
$yetkili_enesler	array
mb_encode_mimeheader	mb encode mimeheader
getimageinterpolatemethod	getimageinterpolatemethod
$dn	array
bcpowmod	bcpowmod
$konum	mixed
socket_clear_error	socket_clear_error
imap_get_quotaroot	imap get quotaroot
openssl_public_decrypt	openssl_public_decrypt
cdatasection	cdatasection
array_pad	array pad
$yontem	yontem
$ondalık_hane	ondalık_hane
mergeimagelayers	mergeimagelayers
$torunlar_dahil	bool
clonenode	clonenode
ini_set	ini set
$dolgu_türü	int
apache_note	apache note
ssh2_fetch_stream	ssh2 fetch stream
$başucu	başucu
htmlspecialchars	htmlspecialchars
$oturum	resource
domcharacterdata	domcharacterdata
initgroups	initgroups
mb_strwidth	mb_strwidth
$imza	string
mhash_keygen_s2k	mhash keygen s2k
$systemid	systemid
$aktarım_kodlaması	string
adrlist	adrlist
posix_initgroups	posix initgroups
clut	clut
$sözlük	string
$değer	int
$süzgeç	$süzgeç
is_null	is_null
$öğe	öğe
mcrypt_enc_get_algorithms_name	mcrypt_enc_get_algorithms_name
mcrypt_get_iv_size	mcrypt_get_iv_size
$çıktıgamma	$çıktıgamma
ssh2_sftp_stat	ssh2_sftp_stat
$aliciarayuz	aliciarayuz
imagecolortransparent	imagecolortransparent
mysql_ping	mysql_ping
$pgid	int
$gerçek_yol_belleğini_temizle	gerçek_yol_belleğini_temizle
$bbcode_havuzu	$bbcode_havuzu
$önek	önek
abstract	abstract
$parçanum	parçanum
getimagesize	getimagesize
imap_setflag_full	imap setflag full
date_default_timezone_set	date_default_timezone_set
$zaman_asimi	zaman_asimi
$kısa_seçenekler	kısa_seçenekler
int	int
mcrypt_get_cipher_name	mcrypt get cipher name
import_request_variables	import request variables
imap_alerts	imap_alerts
publickey	publickey
grapheme_strlen	grapheme_strlen
$akım_bağlamı	akım_bağlamı
$kyn_gnş	kyn_gnş
$indisleri_koru	bool
hash_update_stream	hash update stream
array_reverse	array_reverse
$sınırlı	sınırlı
createcdatasection	createcdatasection
openssl_free_key	openssl_free_key
$enlem	enlem
hash_file	hash_file
$id_olarak	$id_olarak
money	money
pcntl_wtermsig	pcntl_wtermsig
$değiştirgeler	array
ob	ob
parse	parse
odbc_num_fields	odbc num fields
headers_sent	headers_sent
$nanosaniye	$nanosaniye
odbc_columns	odbc_columns
$konakadı	$konakadı
$girdi_dosyası	string
details	details
$siyah_nokta	siyah_nokta
pdf_setmiterlimit	pdf_setmiterlimit
$http_yanıt_kodu	$http_yanıt_kodu
imagedashedline	imagedashedline
$gerçek_yol_belleğini_temizle	$gerçek_yol_belleğini_temizle
posix_getpwnam	posix getpwnam
$eşik_eşlemi	$eşik_eşlemi
$sayı	$sayı
$uri	string
$aç	aç
domtext	domtext
$sinyal	int
$yığıt	bool
imap_subscribe	imap subscribe
$büyüklük	int
$veri	mixed
variant	variant
curl	curl
$biçim	$biçim
$kimlik	string
png2wbmp	png2wbmp
$my	$my
strcut	strcut
domdocumenttype	domdocumenttype
$kip	string
$edilgen	edilgen
ftp_cdup	ftp cdup
arsort	arsort
$şeffaflığı_yoksay	şeffaflığı_yoksay
move_uploaded_file	move_uploaded_file
$delimiter	$delimiter
$açkapa	açkapa
$kapsam	$kapsam
mcrypt_enc_is_block_algorithm	mcrypt enc is block algorithm
pcntl_wifsignaled	pcntl_wifsignaled
get_magic_quotes_gpc	get magic quotes gpc
com_event_sink	com_event_sink
$belgeadı	belgeadı
posix_isatty	posix_isatty
shell	shell
array_chunk	array_chunk
$adım	number
blur	blur
$alicinesne	$alicinesne
$etki	$etki
$girinti	$girinti
imap_headerinfo	imap headerinfo
getattribute	getattribute
$tanıtıcı	$tanıtıcı
$renk_sayısı	renk_sayısı
interpolate	interpolate
$isim	mixed
params	params
mysql_list_fields	mysql_list_fields
$include_path_kullan	bool
grapheme_strripos	grapheme_strripos
property_exists	property exists
fseek	fseek
fileowner	fileowner
$geometri	$geometri
getcompressionquality	getcompressionquality
exec	exec
hash_copy	hash copy
$bölge	array
$ca_bilgisi	$ca_bilgisi
$döndür	bool
unbuffered	unbuffered
systype	systype
$siyah_nokta	float
$geometri	string
fingerprint	fingerprint
posix_get_last_error	posix get last error
vars	vars
$dosyaadı	$dosyaadı
bzerrstr	bzerrstr
$gövde	$gövde
proc_nice	proc_nice
apc_load_constants	apc load constants
$dolgu_dizgesi	$dolgu_dizgesi
grapheme_extract	grapheme_extract
$tcp_sunucusu	$tcp_sunucusu
mb_strtoupper	mb strtoupper
$öncelem	$öncelem
get_included_files	get included files
$kodlama	$kodlama
$belgeadı	string
mb_decode_numericentity	mb decode numericentity
$saat	saat
soundex	soundex
mysql_free_result	mysql_free_result
mb_encode_numericentity	mb encode numericentity
imap_undelete	imap_undelete
unregister	unregister
iconv_get_encoding	iconv_get_encoding
$noktalı	$noktalı
$eskisi	$eskisi
$satır	$satır
is_dir	is_dir
$alan_değeri	string
mcrypt_generic_init	mcrypt generic init
$çıktı	çıktı
dio_truncate	dio truncate
easter_date	easter date
convert	convert
ssh2_connect	ssh2_connect
stream_context_get_params	stream_context_get_params
$dosyaadi	dosyaadi
$dizin_tanıtıcısı	$dizin_tanıtıcısı
posix_setuid	posix setuid
$hdf_x	int
$etiketler	string
ftp_fget	ftp_fget
ctype_xdigit	ctype_xdigit
sigwaitinfo	sigwaitinfo
ftp_nb_fput	ftp nb fput
domprocessinginstruction	domprocessinginstruction
$parçalar	array
session_cache_expire	session_cache_expire
$ibranice_metin	$ibranice_metin
$yeni_önbellek_ömrü	yeni_önbellek_ömrü
ftp_connect	ftp_connect
$sadece_http	bool
mysql_fetch_lengths	mysql_fetch_lengths
date_sunset	date sunset
writable	writable
appendchild	appendchild
str	str
imap_open	imap_open
com	com
$kodlanmış_başlıklar	kodlanmış_başlıklar
$secure	$secure
imap_getmailboxes	imap_getmailboxes
socket_last_error	socket_last_error
$değişkenler	değişkenler
setimageinterpolatemethod	setimageinterpolatemethod
encipherimage	encipherimage
writeimagesfile	writeimagesfile
$dğş_num	dğş_num
$izinli_etiketler	izinli_etiketler
$mode	int
apc_store	apc_store
$ana_gid	int
$tarayıcı	$tarayıcı
$kyn_x	int
ftp_alloc	ftp alloc
$uid	$uid
apache_child_terminate	apache_child_terminate
match	match
order	order
imap_unsubscribe	imap_unsubscribe
get_class	get class
$izinli_etiketler	string
$kime	kime
apache_setenv	apache_setenv
bbcode_parse	bbcode parse
reduce	reduce
$düğüm	simplexmlelement
$yeni_boyut	$yeni_boyut
mysql_list_processes	mysql list processes
imap_createmailbox	imap_createmailbox
shadeimage	shadeimage
curl_multi_close	curl multi close
link	link
$günlük_türü	günlük_türü
getsid	getsid
$ad	ad
$ayarlar	array
$font_index	resource
$numara	numara
openssl_x509_parse	openssl x509 parse
odbc_field_len	odbc_field_len
$tablo	tablo
$mevcut	$mevcut
$d3	$d3
$ya_sahibi	$ya_sahibi
guid	guid
$parça_boyutu	parça_boyutu
transparentpaintimage	transparentpaintimage
getimagelength	getimagelength
is_file	is_file
$ya_tablo	ya_tablo
$türetilensınıf	string
ob_clean	ob clean
walk	walk
is_null	is null
$uzantı	uzantı
imagepsbbox	imagepsbbox
mb_strtolower	mb_strtolower
mcrypt_module_is_block_mode	mcrypt module is block mode
offsetset	offsetset
pcntl_wifexited	pcntl wifexited
$tablo_adı	tablo_adı
apd_set_pprof_trace	apd_set_pprof_trace
$alfa	alfa
ctype_print	ctype print
$punto	float
uassoc	uassoc
$çifte_kodlama	çifte_kodlama
bbcode_parse	bbcode_parse
posix_ctermid	posix ctermid
openssl_pkcs7_sign	openssl_pkcs7_sign
$yeni_bağlantı	$yeni_bağlantı
apache_response_headers	apache response headers
negotiated	negotiated
bcompiler_write_footer	bcompiler_write_footer
bzflush	bzflush
$beyaz_nokta	beyaz_nokta
getprevious	getprevious
$msgid2	msgid2
get_defined_functions	get_defined_functions
images	images
strwidth	strwidth
$ibrani	bool
posix_access	posix_access
$genişlik	$genişlik
__construct	  construct
$ek_seçenekler	array
$etkin	etkin
image_type_to_mime_type	image_type_to_mime_type
$işlev_ismi	işlev_ismi
$kaynak	kaynak
ssh2_sftp_stat	ssh2 sftp stat
$kapa	callback
odbc_procedurecolumns	odbc_procedurecolumns
$oid_format	oid_format
polaroidimage	polaroidimage
$yarıçap	$yarıçap
$gizanh	$gizanh
append	append
memory_get_usage	memory get usage
$sayısal_önek	$sayısal_önek
imap_open	imap open
output_reset_rewrite_vars	output reset rewrite vars
array_diff_uassoc	array diff uassoc
$eklenti	$eklenti
imagestring	imagestring
intl_error_name	intl_error_name
$buyuklukduyarsiz	$buyuklukduyarsiz
rand	rand
$d4	$d4
$etiket_adi	etiket_adi
$buyukluk_duyarli	bool
session_set_save_handler	session_set_save_handler
$yeni_isim	$yeni_isim
$seçenek	string
preg_split	preg_split
$kodlama_dosyası	kodlama_dosyası
$genankim	$genankim
$girdi_dosyası	girdi_dosyası
odbc_close	odbc_close
$güvencesiz_dosya	güvencesiz_dosya
$mx	mx
$degisken	$degisken
imap_savebody	imap_savebody
convert_cyr_string	convert cyr string
dio_close	dio_close
child	child
$alım_türü	alım_türü
$sinif	string
iv	iv
$xhtml	bool
$adım	adım
posix_getcwd	posix_getcwd
openssl_x509_checkpurpose	openssl x509 checkpurpose
each	each
addslashes	addslashes
http	http
$ca_sert	mixed
$sahibi	string
$dönem	int
is_object	is object
get_magic_quotes_gpc	get_magic_quotes_gpc
$istek	$istek
$comnesne	comnesne
apd_get_active_symbols	apd get active symbols
$kota_sınırı	kota_sınırı
ssh2_scp_recv	ssh2 scp recv
apc_add	apc_add
imagecolorexactalpha	imagecolorexactalpha
$hdf_yüks	hdf_yüks
$tarama_kipi	$tarama_kipi
pcntl_alarm	pcntl alarm
mb_convert_case	mb_convert_case
easter	easter
array_pop	array pop
$karo	resource
$eleman	eleman
procedurecolumns	procedurecolumns
$çerçeve_rengi	mixed
$genlik	float
$konak_adı	$konak_adı
imap_body	imap_body
imagechar	imagechar
posix_geteuid	posix_geteuid
$şablon	mixed
$numara	$numara
ssh2_sftp	ssh2_sftp
mcrypt_encrypt	mcrypt encrypt
$bbcode_havuzu	resource
openssl_pkey_free	openssl_pkey_free
$konu	string
hash_init	hash init
array	array
htmlspecialchars_decode	htmlspecialchars decode
$y2	$y2
$boş	$boş
posix_mknod	posix mknod
createmailbox	createmailbox
getopt	getopt
socket_create	socket create
session_register	session register
$anahtarları_koru	$anahtarları_koru
setimageclipmask	setimageclipmask
$sadece_http	$sadece_http
ob_tidyhandler	ob_tidyhandler
$color	$color
isatty	isatty
$ibrani	$ibrani
$n	int
transpose	transpose
$sayı	float
$döküm_dizini	döküm_dizini
bbcode	bbcode
$titrek	bool
$seçenek	$seçenek
$ne	int
$kodlama_listesi	mixed
array_keys	array_keys
dbs	dbs
in_array	in_array
stripos	stripos
$gizli_anh	$gizli_anh
fragment	fragment
$imler	imler
$eskisi	eskisi
posix_getcwd	posix getcwd
prefix	prefix
$sıranum	$sıranum
$alıcı_anahtarı	$alıcı_anahtarı
$enboy_türü	$enboy_türü
$sorgu	string
$anahtar	anahtar
$iletinum	int
assert	assert
$sıralama_türü	$sıralama_türü
sink	sink
$dizin_tanıtıcısı	dizin_tanıtıcısı
openssl_pkey_export_to_file	openssl pkey export to file
phpinfo	phpinfo
$cozumlenecek_dizge	cozumlenecek_dizge
hasattribute	hasattribute
$y	int
ftp_pasv	ftp_pasv
get_browser	get browser
posix	posix
savebody	savebody
$kullanıcı	$kullanıcı
com_print_typeinfo	com_print_typeinfo
tidyhandler	tidyhandler
$renk_tablosu	renk_tablosu
set_error_handler	set error handler
imap_savebody	imap savebody
$port	int
$bbcode_havuzu	bbcode_havuzu
file_get_contents	file_get_contents
$sözdizimsel	$sözdizimsel
strerror	strerror
exif_read_data	exif_read_data
limit	limit
str_repeat	str repeat
$modül_ismi	string
getattributenode	getattributenode
$yapıştırıcı	string
$cct	resource
$sınıfla	bool
$sol_terim	sol_terim
$belgetürü	belgetürü
$resim	resource
$noktalar	noktalar
$error_code	$error_code
logo	logo
$d1	int
commit	commit
restore_error_handler	restore error handler
quote	quote
mb_ereg_match	mb ereg match
$yoket	yoket
mcrypt_list_algorithms	mcrypt list algorithms
$kodlamadan	mixed
grapheme	grapheme
sendto	sendto
openssl_x509_export	openssl x509 export
imageinterlace	imageinterlace
odbc_rollback	odbc rollback
openssl_pkcs12_export	openssl_pkcs12_export
prepare	prepare
imagepsfreefont	imagepsfreefont
$anahtarları_koru	anahtarları_koru
$gizankim	$gizankim
odbc_specialcolumns	odbc specialcolumns
fetch	fetch
count_chars	count chars
mysql_close	mysql close
array_search	array search
getimageprofiles	getimageprofiles
copy	copy
php_logo_guid	php logo guid
apache_getenv	apache_getenv
$taban	taban
word	word
setsid	setsid
$etiket_kurallari	etiket_kurallari
$kodsayfasi	$kodsayfasi
mb_ereg_match	mb_ereg_match
imagecreatefromgd	imagecreatefromgd
imagealphablending	imagealphablending
sigprocmask	sigprocmask
posix_ctermid	posix_ctermid
openssl_public_encrypt	openssl_public_encrypt
array_diff_uassoc	array_diff_uassoc
$seçenekler	int
mb_ereg_search_pos	mb_ereg_search_pos
disk_free_space	disk_free_space
$ifade	ifade
base64_decode	base64_decode
odbc_cursor	odbc cursor
truncate	truncate
$taban	$taban
request	request
session_regenerate_id	session_regenerate_id
mysql_stat	mysql_stat
$pngdosya	$pngdosya
$csr	mixed
login	login
$işlev_değiştirgeleri	string
point	point
$pgid	$pgid
$resim2	$resim2
$yaz	$yaz
$bilgi	$bilgi
str_rot13	str_rot13
$dönem	dönem
$anahtar	string
ob_get_level	ob_get_level
$şeffaflık	float
dio_seek	dio_seek
bcompiler_write_function	bcompiler write function
verify	verify
$hatalar_etkin	hatalar_etkin
access	access
$kyn_yks	kyn_yks
session_cache_expire	session cache expire
apache_reset_timeout	apache_reset_timeout
$çıktı_dosyası	$çıktı_dosyası
sma	sma
imap_expunge	imap expunge
fileperms	fileperms
$sinif	sinif
$dizi1	$dizi1
getattributenodens	getattributenodens
odbc_fetch_array	odbc fetch array
$isim	string
pcntl_wexitstatus	pcntl_wexitstatus
$işlem	işlem
posix_setegid	posix_setegid
wifsignaled	wifsignaled
$sütun_ismi	sütun_ismi
ctermid	ctermid
declared	declared
rmdir	rmdir
scale	scale
getiteratorindex	getiteratorindex
array_values	array values
$im	$im
opaquepaintimage	opaquepaintimage
$aliciarayuz	mixed
$y1	int
$bağlan	resource
array_rand	array rand
$dosyaadı	string
$sabitler	array
optimize	optimize
posix_getppid	posix getppid
ssh2_auth_password	ssh2_auth_password
headers_list	headers_list
class	class
$özgün_isim	özgün_isim
splice	splice
$metinsiz	metinsiz
open	open
$resim_türü	int
mb_convert_variables	mb convert variables
imagecolorclosestalpha	imagecolorclosestalpha
imagepsextendfont	imagepsextendfont
ftp_systype	ftp_systype
$matlık	matlık
$katsayı	$katsayı
affected	affected
removechild	removechild
$düşük	mixed
mysql_free_result	mysql free result
getgid	getgid
$kyn_y	$kyn_y
$arama_kuralı	arama_kuralı
ftp_set_option	ftp_set_option
ftp_mkdir	ftp mkdir
$kime	string
$istemci_seçenekleri	istemci_seçenekleri
openssl_pkcs7_verify	openssl_pkcs7_verify
sort	sort
$yükseliş	yükseliş
$form_verisi	$form_verisi
$güvenli	güvenli
$include_path_kullan	$include_path_kullan
ignore	ignore
curl_setopt_array	curl setopt array
$dnm_sayısı	int
bcompiler_write_class	bcompiler write class
$dolgu	dolgu
$cc	string
$sürüm	string
image2wbmp	image2wbmp
str_getcsv	str getcsv
$istisna_eylemcisi	$istisna_eylemcisi
checkdate	checkdate
debug_backtrace	debug backtrace
posix_uname	posix_uname
ftp_ssl_connect	ftp_ssl_connect
bcpow	bcpow
setuid	setuid
enc	enc
pos	pos
pkcs7	pkcs7
openssl_decrypt	openssl decrypt
$yeşil	$yeşil
array_intersect	array intersect
wexitstatus	wexitstatus
$küçük	$küçük
$dt	int
$uzak_dosya	$uzak_dosya
$geçişim	$geçişim
$d4	d4
getsizeoffset	getsizeoffset
$istemci_seçenekleri	$istemci_seçenekleri
abort	abort
rename_function	rename_function
file	file
$işlev_değiştirgeleri	işlev_değiştirgeleri
getppid	getppid
connection_aborted	connection_aborted
bcdiv	bcdiv
$alfa	int
createdocumentfragment	createdocumentfragment
imagepsslantfont	imagepsslantfont
ssh2_connect	ssh2 connect
$ip_adresi	string
$filename	$filename
$wbmpdosya	string
$devam_yeri	int
cal_days_in_month	cal days in month
imageftbbox	imageftbbox
$httponly	bool
imagecharup	imagecharup
pclose	pclose
$güçlü	string
$bağlan	bağlan
in	in
mb_strcut	mb strcut
pcntl_wifstopped	pcntl_wifstopped
apd_set_session_trace	apd set session trace
$zaman_aşımı	$zaman_aşımı
$önek	$önek
implicit	implicit
$resim_türü	resim_türü
compression	compression
tag	tag
$başlıklar	$başlıklar
$metin	string
$ek_seçenekler	ek_seçenekler
imagecolormatch	imagecolormatch
getimageorientation	getimageorientation
$öntanımlı_konak	$öntanımlı_konak
$dalga_boyu	$dalga_boyu
inet_pton	inet_pton
thread	thread
reset	reset
get_loaded_extensions	get loaded extensions
ob_iconv_handler	ob iconv handler
$alan	mixed
socket_get_option	socket get option
nl	nl
$hata_kodu	$hata_kodu
$mevcut	mevcut
curl_close	curl_close
simplexml_load_file	simplexml load file
imap_num_recent	imap num recent
ftp_exec	ftp_exec
$atama_dizgesi	$atama_dizgesi
waveimage	waveimage
imagecreatefromgif	imagecreatefromgif
odbc_field_type	odbc_field_type
sqlite_udf_encode_binary	sqlite_udf_encode_binary
$imza	$imza
handle	handle
$çıktı	string
bcompiler_read	bcompiler read
socket_set_option	socket_set_option
stream_context_set_params	stream context set params
session_set_cookie_params	session set cookie params
imagick	imagick
array_uintersect_assoc	array_uintersect_assoc
is_scalar	is scalar
$iletiler	iletiler
pseudo	pseudo
$zarf_mühürleri	$zarf_mühürleri
odbc_num_rows	odbc_num_rows
$pk	pk
similar	similar
numericentity	numericentity
$sonraki	int
fcntl	fcntl
array_shift	array shift
__halt_compiler	__halt_compiler
$ibranice_metin	ibranice_metin
none	none
date	date
mysql_create_db	mysql create db
preg_last_error	preg last error
pop	pop
dio_fcntl	dio fcntl
get_class_methods	get class methods
passthru	passthru
ssh2_sftp_mkdir	ssh2_sftp_mkdir
$zamanaşımı	zamanaşımı
$yazıtipi	int
apc_fetch	apc fetch
kana	kana
odbc_tableprivileges	odbc tableprivileges
imap_mime_header_decode	imap mime header decode
mcrypt_enc_get_block_size	mcrypt_enc_get_block_size
imap_fetchstructure	imap_fetchstructure
$tercihler	array
getlogin	getlogin
$özel_adres	string
$kaynak	$kaynak
apache_getenv	apache getenv
$dolgu_türü	$dolgu_türü
$çöpçü	callback
$rng	$rng
$aile	aile
imagesetstyle	imagesetstyle
get_class_vars	get class vars
ob_flush	ob_flush
$x	int
ssh2_methods_negotiated	ssh2_methods_negotiated
resize	resize
$parça_boyu	int
import_request_variables	import_request_variables
$yöntem	int
snmp_set_oid_numeric_print	snmp_set_oid_numeric_print
mb_strtolower	mb strtolower
imagecolorclosesthwb	imagecolorclosesthwb
$renk_tablosu	imagick
mb_stripos	mb stripos
removeattributens	removeattributens
$bbcode_baslangic_etiketleri	$bbcode_baslangic_etiketleri
imap_get_quotaroot	imap_get_quotaroot
$sürüm	$sürüm
imagepng	imagepng
$öncelem	string
combine	combine
$işlev_kodu	işlev_kodu
checkdnsrr	checkdnsrr
mb_strimwidth	mb_strimwidth
fput	fput
$string	string
bcompiler_write_header	bcompiler write header
$yol	yol
session_write_close	session write close
strcspn	strcspn
sftp	sftp
$çıktı	resource
simplexml_load_string	simplexml load string
ctype_space	ctype space
$yoket	callback
$temelsınıf	$temelsınıf
move_uploaded_file	move uploaded file
$bbcode_degistirge_havuzu	resource
$değişken	string
$kyn_yks	$kyn_yks
fpassthru	fpassthru
$ek_değiştirge	$ek_değiştirge
$yasam_suresi	yasam_suresi
array_merge	array merge
$adres	$adres
$alım_türü	$alım_türü
ftp_set_option	ftp set option
longreadlen	longreadlen
$delimiter	string
adaptivesharpenimage	adaptivesharpenimage
matte	matte
$kullanıcı	string
$x1	$x1
array_uintersect	array uintersect
mcrypt_enc_get_supported_key_sizes	mcrypt enc get supported key sizes
$torunlar_dahil	torunlar_dahil
getcontent	getcontent
$not_adı	string
mysql_tablename	mysql_tablename
$imler	string
openssl_x509_check_private_key	openssl x509 check private key
mysql_list_fields	mysql list fields
$çıktı	array
is_subclass_of	is_subclass_of
preg_replace	preg_replace
code	code
binary	binary
$ek_kayıtlar	ek_kayıtlar
bcompiler_parse_class	bcompiler_parse_class
$tür	$tür
mcrypt_module_open	mcrypt module open
ssh2_sftp_readlink	ssh2_sftp_readlink
odbc_pconnect	odbc pconnect
$tmmpon	$tmmpon
$sınıf	sınıf
$dosyaboyu	$dosyaboyu
get_headers	get_headers
frenchtojd	frenchtojd
posix_getrlimit	posix getrlimit
ctype_alpha	ctype alpha
$eskisi	string
clearstatcache	clearstatcache
$d2	$d2
array_multisort	array multisort
$dt	$dt
strtolower	strtolower
php_ini_scanned_files	php ini scanned files
mb_convert_encoding	mb convert encoding
days	days
$yaşam_süresi	yaşam_süresi
$gizli_anahtar	mixed
$seviye	int
terminate	terminate
mb_strpos	mb_strpos
$ini	string
$http_yanıt_kodu	int
session_id	session_id
openssl_pkcs12_read	openssl_pkcs12_read
$başlama_yeri	int
apc_load_constants	apc_load_constants
socket_strerror	socket_strerror
$önbellek_türü	string
bin2hex	bin2hex
$kısa_adlar	kısa_adlar
crack_getlastmessage	crack getlastmessage
imagegrabscreen	imagegrabscreen
imagecreatefromgd2	imagecreatefromgd2
popen	popen
$gizli_anahtar	gizli_anahtar
set_include_path	set_include_path
$engellensin	$engellensin
$ileti	string
pcntl_fork	pcntl_fork
imap_body	imap body
$nesne_sağla	bool
imap_timeout	imap_timeout
$dn	$dn
is_uploaded_file	is uploaded file
$yazıtipi	$yazıtipi
domxpath	domxpath
$lifetime	int
$sözlük	$sözlük
$değerler	$değerler
$dt	dt
$doğruluk	int
count_chars	count_chars
sqlite_has_more	sqlite_has_more
$pkcs12	$pkcs12
getelementsbytagnamens	getelementsbytagnamens
lsub	lsub
alpha	alpha
is_writable	is_writable
slice	slice
ssh2_sftp_realpath	ssh2 sftp realpath
$pty	string
$yöntemler	array
posix_mknod	posix_mknod
$dğş	$dğş
$değiştirge_dizisi	değiştirge_dizisi
$eski_isim	string
$yoket	$yoket
mysql_fetch_lengths	mysql fetch lengths
connection_aborted	connection aborted
$önekliad	$önekliad
array_chunk	array chunk
$parça_uzunluğu	int
regs	regs
dateinterval	dateinterval
$soket_türü	$soket_türü
openssl_pkey_new	openssl_pkey_new
error	error
$parçalar	parçalar
$kip_dizini	string
sent	sent
$mx	$mx
lower	lower
imagecopy	imagecopy
digit	digit
fill	fill
ftp_login	ftp login
$uzun_seçenekler	array
$zaman_damgası	$zaman_damgası
$kalıp	$kalıp
proc_close	proc close
hash	hash
http_build_query	http_build_query
$genisletme	genisletme
escapeshellcmd	escapeshellcmd
$boyut	$boyut
$edilgen	bool
preg_grep	preg_grep
bcompiler_write_constant	bcompiler_write_constant
$hata_türü	int
translation	translation
$comnesne	object
bcompiler	bcompiler
$protokol	int
ereg	ereg
imap_ping	imap_ping
public	public
str_pad	str_pad
nl_langinfo	nl langinfo
register_shutdown_function	register_shutdown_function
$dönüş_değeri	int
md5	md5
$alan	alan
mb_strrchr	mb strrchr
is_numeric	is_numeric
grapheme_strstr	grapheme_strstr
getenv	getenv
mhash_count	mhash_count
openssl_pkey_get_public	openssl pkey get public
$devam_yeri	$devam_yeri
sqlite_udf_decode_binary	sqlite udf decode binary
$güvenli	bool
getpgid	getpgid
clunk	clunk
image_type_to_extension	image type to extension
gd_info	gd_info
odbc_binmode	odbc binmode
offsetunset	offsetunset
destroy	destroy
mcrypt_get_key_size	mcrypt get key size
$sayfa	$sayfa
$id	id
$imza_sertifikası	mixed
$etkin	$etkin
$katsayı	int
$tampon	string
get_html_translation_table	get_html_translation_table
openssl_pkey_get_private	openssl pkey get private
$sapma	float
ns	ns
$sftp	sftp
proto	proto
curl_setopt	curl_setopt
$niteleyici	niteleyici
imap_setacl	imap_setacl
convert_uudecode	convert uudecode
udiff	udiff
$yükseklik	$yükseklik
bbcode_create	bbcode_create
imap_status	imap status
$kyn_gnş	$kyn_gnş
apd_dump_regular_resources	apd_dump_regular_resources
clearflag	clearflag
listen	listen
$httponly	httponly
full	full
date_default_timezone_get	date_default_timezone_get
apc_add	apc add
posix_getpwuid	posix_getpwuid
gzhandler	gzhandler
imagestringup	imagestringup
mcrypt_generic_end	mcrypt_generic_end
mb_ereg_search_regs	mb_ereg_search_regs
$posta_kutusu	posta_kutusu
$süre	int
$arama_değeri	$arama_değeri
strpos	strpos
ob_start	ob_start
$özellik	özellik
$lifetime	lifetime
$ikamekrk	mixed
reverse	reverse
$kyn_y	int
$bağlantı_kimliği	resource
mysql_affected_rows	mysql_affected_rows
symbols	symbols
$cct	$cct
$son	int
is_a	is a
mb_strrichr	mb strrichr
gettype	gettype
openssl_seal	openssl_seal
cdup	cdup
mb_strlen	mb_strlen
tcsetattr	tcsetattr
get_declared_interfaces	get declared interfaces
eregi_replace	eregi replace
curl_init	curl init
optimized	optimized
interface	interface
list	list
$düğüm	domnode
$ters	$ters
eregi	eregi
$lib_dir	$lib_dir
mysql_info	mysql_info
mhash_keygen_s2k	mhash_keygen_s2k
$hdf_yüks	$hdf_yüks
$turkutuphaneadi	turkutuphaneadi
$satırsonu	$satırsonu
pump	pump
distortimage	distortimage
$geriçağırımlar	$geriçağırımlar
$beyaznokta	$beyaznokta
php_ini_scanned_files	php_ini_scanned_files
quotes	quotes
module	module
runtime	runtime
$tcp_sunucusu	tcp_sunucusu
replace	replace
$alan_adı	string
odbc_binmode	odbc_binmode
$konakadı	konakadı
$matris	$matris
$kütüphane	string
mysql_field_len	mysql field len
$kim	int
mcrypt_module_get_supported_key_sizes	mcrypt module get supported key sizes
nb	nb
apd_dump_persistent_resources	apd dump persistent resources
curl_close	curl close
magic	magic
$düşük	float
$dğş	mixed
$comnesne	$comnesne
$sayı_döndür	sayı_döndür
$ad	$ad
$nesne	object
$strict	strict
digest	digest
$türler	$türler
$uzantı	$uzantı
$dt	resource
$alanlar	$alanlar
mysql_close	mysql_close
quoted_printable_decode	quoted printable decode
$secenekler	secenekler
$katsayı	katsayı
previous	previous
$yüksek	yüksek
array_intersect_uassoc	array_intersect_uassoc
imap_gc	imap_gc
base64	base64
bbcode_add_smiley	bbcode_add_smiley
$borular	borular
sizes	sizes
assoc	assoc
$gövde	gövde
$yığıt	$yığıt
array_merge	array_merge
imagejpeg	imagejpeg
$şablon	string
jpeg2wbmp	jpeg2wbmp
ob_get_clean	ob get clean
$hala_çalışıyor	int
$sertifika	mixed
mysql_field_seek	mysql field seek
$adı_soyadı	$adı_soyadı
odbc_close_all	odbc close all
mysql_db_query	mysql_db_query
checkpurpose	checkpurpose
is_numeric	is numeric
imap_num_msg	imap_num_msg
$karo	$karo
error_log	error log
$özel_adres	$özel_adres
recent	recent
$kodlanmış_başlık	kodlanmış_başlık
odbc_data_source	odbc_data_source
imap_mail_move	imap mail move
ob_get_level	ob get level
$girdigamma	girdigamma
disk_total_space	disk total space
$genankim_dizisi	genankim_dizisi
$yaz	yaz
$sertifikalar	array
$hedef	hedef
curl_multi_select	curl multi select
$eylemci	callback
$biçemle	int
$dolgu	mixed
imap_num_recent	imap_num_recent
get_declared_classes	get_declared_classes
$kırpıcı	kırpıcı
ob_list_handlers	ob_list_handlers
restore_exception_handler	restore exception handler
posix_ttyname	posix ttyname
$uri	uri
mb_http_output	mb_http_output
ftp_pasv	ftp pasv
odbc_columns	odbc columns
$modül	string
$karo	karo
imap_last_error	imap last error
method	method
$artalan	artalan
rawurlencode	rawurlencode
mcrypt_ecb	mcrypt_ecb
bodystruct	bodystruct
$gerçek_sayı	$gerçek_sayı
ctype_punct	ctype_punct
raw	raw
strtoupper	strtoupper
$küçük	küçük
$kalıp	string
libxml_get_last_error	libxml_get_last_error
$dosya_adı	string
socket_get_option	socket_get_option
domdocument	domdocument
md5_file	md5_file
$parolası	parolası
$ysu_var	$ysu_var
$ek_başlıklar	ek_başlıklar
apache_get_version	apache get version
$bbcode_degistirge_havuzu	bbcode_degistirge_havuzu
openlog	openlog
apd_breakpoint	apd_breakpoint
sharpen	sharpen
$hizmet	hizmet
$veri_türü	veri_türü
adaptivethresholdimage	adaptivethresholdimage
gzgetss	gzgetss
imap_delete	imap delete
posix_mkfifo	posix_mkfifo
$emiksler	array
password	password
ftp_fget	ftp fget
connection_status	connection status
cal_from_jd	cal from jd
$msgid2	$msgid2
session	session
getmypid	getmypid
mb_substitute_character	mb_substitute_character
repeat	repeat
$ek_değiştirge	string
$ham_girdi	ham_girdi
gzeof	gzeof
$path	path
$sertifikalar	$sertifikalar
sqlite_close	sqlite close
socket_create_pair	socket_create_pair
session_save_path	session_save_path
$işlev_kodu	string
$anahtarlar	array
odbc_exec	odbc exec
openssl_pkcs7_encrypt	openssl_pkcs7_encrypt
chr	chr
$form_verisi	form_verisi
odbc_procedures	odbc_procedures
mysql	mysql
ftp_rename	ftp rename
curl_error	curl_error
gc	gc
mb_language	mb language
arrayaccess	arrayaccess
mysql_ping	mysql ping
$öncelik	int
$istemci_alanı	$istemci_alanı
$beyaz_nokta	$beyaz_nokta
pton	pton
$parola	parola
imagefontwidth	imagefontwidth
$mühürlü_veri	string
$arama_değeri	arama_değeri
shuffle	shuffle
$bileşen	int
natsort	natsort
$miktar	miktar
$gövde	array
$şeffaflık	şeffaflık
response	response
$indisleri_koru	$indisleri_koru
$alan_konumu	$alan_konumu
createattributens	createattributens
$ya_sahibi	ya_sahibi
$içerik	$içerik
imageellipse	imageellipse
imap_headers	imap headers
$baslangickonum	int
curl_multi_exec	curl multi exec
$tam_durum	$tam_durum
$nereden	nereden
$bilgi	bilgi
odbc_rollback	odbc_rollback
createfromdatestring	createfromdatestring
mb_ereg_search_init	mb_ereg_search_init
$şifreli_veri	şifreli_veri
$var	$var
alnum	alnum
$miter	miter
errors	errors
odbc_fetch_into	odbc_fetch_into
array_fill	array fill
setimageproperty	setimageproperty
curl_copy_handle	curl_copy_handle
socket_bind	socket bind
htmlfile	htmlfile
dio_seek	dio seek
imagepsloadfont	imagepsloadfont
posix_getpwnam	posix_getpwnam
$ters	ters
$dizi	array
odbc_pconnect	odbc_pconnect
array_slice	array slice
getgrnam	getgrnam
$sinyaller	sinyaller
putenv	putenv
$izinler	izinler
date_sunset	date_sunset
set	set
$disi	array
$d2	int
$x_sunucusu	x_sunucusu
last	last
apd_echo	apd echo
$ip_adresi	ip_adresi
$alan_adı	$alan_adı
$eleman	int
idn_to_utf8	idn_to_utf8
imageistruecolor	imageistruecolor
extent	extent
imagefilledellipse	imagefilledellipse
stream_context_create	stream_context_create
$hdf_y	int
imagepolygon	imagepolygon
odbc_foreignkeys	odbc foreignkeys
imagecreatefromjpeg	imagecreatefromjpeg
$uzak_dosa	$uzak_dosa
footer	footer
get_defined_functions	get defined functions
posix_getlogin	posix_getlogin
mb_strripos	mb strripos
getpgrp	getpgrp
$depth	depth
mkfifo	mkfifo
ftp_nb_continue	ftp nb continue
$d3	int
posix_getrlimit	posix_getrlimit
mcrypt_encrypt	mcrypt_encrypt
$biçemle	biçemle
array_udiff_assoc	array_udiff_assoc
is	is
get_html_translation_table	get html translation table
s2k	s2k
gethostbynamel	gethostbynamel
$çıkarım_türü	$çıkarım_türü
mhash_get_hash_name	mhash get hash name
$bölge	$bölge
pcntl_wstopsig	pcntl wstopsig
odbc_commit	odbc commit
imap_fetchheader	imap fetchheader
imap_qprint	imap_qprint
$ileti	$ileti
$satırsonu	string
getpointsize	getpointsize
$veritabanı	veritabanı
recode_file	recode_file
$tablo	$tablo
split	split
$etiket_adi	$etiket_adi
null	null
imap_rfc822_parse_headers	imap rfc822 parse headers
$bicim	$bicim
$samanlık	array
stream_context_get_params	stream context get params
dom	dom
loadxml	loadxml
mysql_get_host_info	mysql get host info
lzf_compress	lzf_compress
highlight_file	highlight file
mcrypt_enc_get_modes_name	mcrypt_enc_get_modes_name
$anahtar	resource
getprotobynumber	getprotobynumber
$uid	uid
fgetcsv	fgetcsv
$yazıtipi	string
$include_path_kullan	include_path_kullan
mb_ereg_search	mb_ereg_search
levenshtein	levenshtein
$status	status
alloc	alloc
rename	rename
openssl_encrypt	openssl_encrypt
openssl_x509_read	openssl x509 read
$kota_sınırı	$kota_sınırı
imap_get_quota	imap get quota
bcmul	bcmul
pcntl_alarm	pcntl_alarm
$hata_iletisi	$hata_iletisi
$dolgulu_uzunluk	int
socket_create	socket_create
$renk	mixed
mcrypt_module_close	mcrypt_module_close
$ca_sert	$ca_sert
imap_fetch_overview	imap fetch overview
current	current
$kısa_seçenekler	$kısa_seçenekler
depth	depth
bindtextdomain	bindtextdomain
intl_get_error_message	intl get error message
apc_clear_cache	apc clear cache
$ek_kayıtlar	array
$tablo_türü	$tablo_türü
$dolgu	$dolgu
$eğim	$eğim
ftp_ssl_connect	ftp ssl connect
$matlık	float
$ba_niteleyici	$ba_niteleyici
wifstopped	wifstopped
$oran	oran
socket_set_nonblock	socket set nonblock
$hdf_x	$hdf_x
bcompiler_write_constant	bcompiler write constant
json_encode	json_encode
ftp_chmod	ftp_chmod
$geçişim	geçişim
$x509sert	x509sert
bzwrite	bzwrite
alerts	alerts
mb_ereg_search_init	mb ereg search init
grep	grep
$yöntemler	$yöntemler
$hedef	$hedef
$adım	$adım
strripos	strripos
$karakterler	string
apc_define_constants	apc define constants
bzcompress	bzcompress
session_write_close	session_write_close
hash_update	hash_update
mysql_unbuffered_query	mysql unbuffered query
$gizli_anh	gizli_anh
ob_get_clean	ob_get_clean
$değer	string
$baglama	baglama
$değiştir	değiştir
deletedata	deletedata
mcrypt_get_key_size	mcrypt_get_key_size
exif_imagetype	exif_imagetype
$istemci_alanı	int
pcntl_wifexited	pcntl_wifexited
call	call
setattributenodens	setattributenodens
array_reduce	array reduce
curl_version	curl_version
$ba_sahibi	$ba_sahibi
$işlem	$işlem
imap_mail	imap_mail
$veritabanı	string
export	export
get_cfg_var	get_cfg_var
$arayüz	string
$bölüm	$bölüm
socket_bind	socket_bind
$hdf_y	hdf_y
$adı_soyadı	string
$artalan	int
$sarmalayıcı	$sarmalayıcı
$şifre	$şifre
sum	sum
getline	getline
$süzgeçler	$süzgeçler
$izinler	$izinler
floodfill	floodfill
hash_update_file	hash_update_file
pcntl_signal	pcntl_signal
$öntanımlı_konak	string
$saat	$saat
mb_ereg_search	mb ereg search
ob_get_flush	ob get flush
bcompiler_write_file	bcompiler write file
ftp_fput	ftp_fput
to	to
str_split	str split
headerinfo	headerinfo
$nesne	mixed
$geriçağırım	geriçağırım
intl	intl
$matris	matris
$yerel_dosya	$yerel_dosya
dio_truncate	dio_truncate
odbc_autocommit	odbc autocommit
strimwidth	strimwidth
$hatanum	hatanum
$yüksek	mixed
$parçanum	$parçanum
opacity	opacity
$kimlik	resource
$hata_kodu	hata_kodu
fstat	fstat
getpid	getpid
sqlite_libencoding	sqlite_libencoding
profiles	profiles
ssh2_auth_none	ssh2_auth_none
$etiket_kurallari	$etiket_kurallari
$sözlük	sözlük
openssl_csr_export	openssl_csr_export
$öğe	$öğe
createdocument	createdocument
$durum	int
$x1	int
$ct	ct
fsockopen	fsockopen
$anh_karş_işlevi	$anh_karş_işlevi
$publicid	string
shell_exec	shell exec
mcrypt_generic_deinit	mcrypt generic deinit
html	html
$enlem	$enlem
$genlik	genlik
ssh2_publickey_list	ssh2 publickey list
is_string	is string
regular	regular
$y1	y1
$x509sert	$x509sert
$mimeli_metin	mimeli_metin
$pk	$pk
ascii	ascii
grapheme_strstr	grapheme strstr
$tersine	tersine
url	url
$satırnum	satırnum
money_format	money_format
$içiçe	bool
ssh2_auth_password	ssh2 auth password
openssl_random_pseudo_bytes	openssl_random_pseudo_bytes
getcwd	getcwd
normalizedocument	normalizedocument
waitpid	waitpid
result	result
$ilişkisel_mi	$ilişkisel_mi
$tmmpon	string
$hata_türü	hata_türü
imagecolorsforindex	imagecolorsforindex
getimagecompression	getimagecompression
array_intersect_ukey	array intersect ukey
class_exists	class exists
getmyinode	getmyinode
$kırpıcı_resim	kırpıcı_resim
total	total
streams	streams
$ba_sahibi	string
mcrypt_enc_is_block_algorithm	mcrypt_enc_is_block_algorithm
$zaman	zaman
setflag	setflag
$sunucu	string
mcrypt_cfb	mcrypt_cfb
$y	y
get_defined_constants	get_defined_constants
imap_last_error	imap_last_error
$yil	int
$büyük	büyük
decrypt	decrypt
$kimlik	kimlik
$şeffaflığı_yoksay	int
$gerçek_yol_belleğini_temizle	bool
validate	validate
imap_utf8	imap_utf8
ctype_cntrl	ctype_cntrl
php_uname	php uname
relaxngvalidatesource	relaxngvalidatesource
odbc_free_result	odbc free result
session_get_cookie_params	session get cookie params
put	put
imap_qprint	imap qprint
$içerik	string
$konu_uzunluğu	$konu_uzunluğu
$jpegdosya	$jpegdosya
$boy	boy
$dosyaadi	$dosyaadi
$x509srtfk_verisi	x509srtfk_verisi
$karakter	string
quotaroot	quotaroot
$siyahnokta	siyahnokta
base64_encode	base64_encode
$girdi	array
ssh2	ssh2
void	void
cipher	cipher
backtrace	backtrace
echo	echo
$imleç_türü	int
$bicim	bicim
$özdevinimli_yükle	özdevinimli_yükle
decipherimage	decipherimage
$yöntemler	yöntemler
contents	contents
posix_initgroups	posix_initgroups
pcntl_sigwaitinfo	pcntl sigwaitinfo
insert	insert
$aç	callback
imap_timeout	imap timeout
callable	callable
$bölüm	bölüm
$samanlık	$samanlık
$scket	resource
msg	msg
$lib_dir	string
debug_zval_dump	debug zval dump
qprint	qprint
getpriority	getpriority
imap_mail_compose	imap_mail_compose
$kodlama_kipi	$kodlama_kipi
get_loaded_extensions	get_loaded_extensions
$buyukluk_duyarli	$buyukluk_duyarli
$path	string
exif_thumbnail	exif thumbnail
inet_pton	inet pton
imagesx	imagesx
paintfloodfillimage	paintfloodfillimage
$emiksler	$emiksler
$parça_boyutu	int
posix_isatty	posix isatty
ftp_size	ftp size
mcrypt_module_is_block_algorithm_mode	mcrypt module is block algorithm mode
$url	$url
$nokta_sayısı	nokta_sayısı
odbc_close_all	odbc_close_all
$sayfa	string
mb_detect_order	mb detect order
imap_rfc822_parse_adrlist	imap rfc822 parse adrlist
$alan_konumu	alan_konumu
$bağlamsal_düğüm	bağlamsal_düğüm
ftp_chdir	ftp_chdir
$başlıklar	string
$anh_karş_işlevi	callback
get_class_methods	get_class_methods
gmstrftime	gmstrftime
posix_getgrnam	posix getgrnam
mb_strwidth	mb strwidth
encodings	encodings
$modül	$modül
array_change_key_case	array_change_key_case
$iptcbloğu	iptcbloğu
$blokboyu	int
$sayı	sayı
$konu	konu
$gizli_anh_dosyası	string
$istek_sayısı	int
proc	proc
hash_update_stream	hash_update_stream
$açı	açı
nl2br	nl2br
$kapa	$kapa
ltrim	ltrim
mb_convert_kana	mb_convert_kana
$bağ	$bağ
dio_tcsetattr	dio tcsetattr
sqlite	sqlite
$önekli_isim	önekli_isim
mysql_num_fields	mysql_num_fields
$küçük_örnek	bool
hash_copy	hash_copy
apc_delete	apc_delete
$çıktı_geriçağırıcı	callable
$döküm_dizini	string
$iv	string
$şema	$şema
$sesler	int
$zaman_aşımı	float
loaded	loaded
$imap_akımı	$imap_akımı
$sonuç_dizisi	sonuç_dizisi
$hata_iletisi	string
sqlite_has_more	sqlite has more
array_combine	array combine
json	json
odbc_num_rows	odbc num rows
$dolgu	int
imap_getacl	imap getacl
$deste	deste
$zaman_asimi	$zaman_asimi
$döndür	döndür
$uri	$uri
socket_create_listen	socket_create_listen
$boyut	float
issamenode	issamenode
posix_getgrnam	posix_getgrnam
detect	detect
socket_recv	socket_recv
$port	$port
posix_getlogin	posix getlogin
pdf	pdf
set_exception_handler	set_exception_handler
$başucu	float
$dönüş_değeri	dönüş_değeri
class_exists	class_exists
array_change_key_case	array change key case
simplexml_load_string	simplexml_load_string
$ham_girdi	$ham_girdi
mysql_list_dbs	mysql_list_dbs
iconv_set_encoding	iconv_set_encoding
func_get_args	func_get_args
ctype_print	ctype_print
$db	db
chroot	chroot
base64_encode	base64 encode
hash_update_file	hash update file
dngettext	dngettext
proc_close	proc_close
$sınıfla	sınıfla
$julyengunu	int
$akım_veya_bağlam	akım_veya_bağlam
apc_delete	apc delete
$noktalı	bool
map	map
imagecreatefromstring	imagecreatefromstring
getmxrr	getmxrr
$metinsiz	bool
$pkcs12	pkcs12
array_sum	array_sum
imap_gc	imap gc
$yüksek	float
$eşleşmeler	$eşleşmeler
$rng	string
$çarpan	$çarpan
strcoll	strcoll
get_declared_interfaces	get_declared_interfaces
$yeniden_syscalls	bool
convert_uudecode	convert_uudecode
$oran	float
transposeimage	transposeimage
$d2	string
posix_getpgrp	posix_getpgrp
$progid	string
pack	pack
event	event
$yeni_önbellek_ömrü	$yeni_önbellek_ömrü
$dolgulu_uzunluk	dolgulu_uzunluk
$tam_durum	tam_durum
$yil	$yil
mb_stristr	mb stristr
hebrev	hebrev
ob_get_flush	ob_get_flush
odbc_free_result	odbc_free_result
$düğüm	düğüm
$kodlamadan	$kodlamadan
session_regenerate_id	session regenerate id
imap_subscribe	imap_subscribe
mb_detect_encoding	mb detect encoding
$kodsayfasi	int
change	change
mcrypt_module_is_block_algorithm	mcrypt_module_is_block_algorithm
ftp_chmod	ftp chmod
$algoritma_dizini	$algoritma_dizini
$array	array
$kırpıcı_resim	$kırpıcı_resim
alan	alan
openssl_encrypt	openssl encrypt
count	count
crack_opendict	crack_opendict
$geriçağırım	$geriçağırım
$ne	ne
$uyarı	string
exit	exit
$genankim_dizisi	array
odbc_result	odbc_result
load	load
$renk	$renk
savehtml	savehtml
similar_text	similar_text
method_exists	method exists
array_diff	array_diff
socket_set_option	socket set option
$status	$status
$konu	mixed
imagecolorstotal	imagecolorstotal
bcompiler_write_class	bcompiler_write_class
md5_file	md5 file
$değiştir	$değiştir
$yasam_suresi	int
libxml_get_errors	libxml_get_errors
session_is_registered	session_is_registered
$x	x
pcntl_setpriority	pcntl_setpriority
$sol_terim	$sol_terim
$kalıp	kalıp
$tanıtıcılar	array
ftp_delete	ftp_delete
$zarf	$zarf
iptcparse	iptcparse
$hata_eylemci	$hata_eylemci
$katsayı	float
mb_preferred_mime_name	mb preferred mime name
$yeşil	yeşil
array_uintersect_uassoc	array uintersect uassoc
preg_grep	preg grep
mcrypt_get_cipher_name	mcrypt_get_cipher_name
$deger	deger
$atama_dizgesi	atama_dizgesi
realpath	realpath
$resim1	$resim1
rawlist	rawlist
$güvencesiz_dosya	$güvencesiz_dosya
print_r	print r
pcntl_getpriority	pcntl_getpriority
$eleman	$eleman
$iğne	string
$yetkili_enesler	$yetkili_enesler
$ilişkisel_mi	ilişkisel_mi
hash_hmac_file	hash_hmac_file
set_magic_quotes_runtime	set_magic_quotes_runtime
$konak	konak
$torunlar_dahil	$torunlar_dahil
ofb	ofb
$etiket_adi	string
gzcompress	gzcompress
ftp_fput	ftp fput
ssh2_scp_recv	ssh2_scp_recv
imap_utf7_decode	imap_utf7_decode
posix_getpid	posix_getpid
pcntl	pcntl
$diğer	$diğer
$publicid	$publicid
$tablo_türü	string
transverseimage	transverseimage
$aynısı	bool
str_getcsv	str_getcsv
easter_date	easter_date
$güvenli	$güvenli
imap_listscan	imap listscan
$dt	array
generic	generic
$istisna_eylemcisi	callback
ini_restore	ini_restore
$başlangıç	int
uri	uri
openssl_x509_free	openssl_x509_free
trace	trace
is_bool	is_bool
is_resource	is_resource
mask	mask
getacl	getacl
ssh2_methods_negotiated	ssh2 methods negotiated
interface_exists	interface_exists
$turkutuphaneadi	string
php	php
$yeniden_syscalls	$yeniden_syscalls
setpgid	setpgid
$uygulama_adı	$uygulama_adı
$parolası	$parolası
$jpeg_dosya_ismi	jpeg_dosya_ismi
listscan	listscan
interfaces	interfaces
resetimagepage	resetimagepage
$parça_boyu	parça_boyu
preg_replace	preg replace
$resim	$resim
$süzgeçler	int
$wbmpdosya	$wbmpdosya
$veritabanı_adı	string
$c	$c
create_function	create function
getcode	getcode
$kip_dizini	$kip_dizini
add	add
mb_strcut	mb_strcut
$socket	socket
$sadece_isimler	sadece_isimler
$y2	int
mcrypt_list_algorithms	mcrypt_list_algorithms
$başlama_yeri	$başlama_yeri
proc_get_status	proc_get_status
gethostname	gethostname
array_unique	array unique
encoding	encoding
$n	n
$girdi_dosyası	$girdi_dosyası
processes	processes
$ilişkisel_mi	bool
space	space
posix_kill	posix kill
mcrypt_module_self_test	mcrypt module self test
$karküm	$karküm
$eğim	float
$sığdır	$sığdır
$bağlantı_belirteci	bağlantı_belirteci
error_get_last	error get last
$kuyruk	$kuyruk
fileinode	fileinode
compose	compose
trim	trim
$önekli_isim	$önekli_isim
$x509srtfk_verisi	$x509srtfk_verisi
$kaynak	resource
convert_uuencode	convert uuencode
geteuid	geteuid
$sayısal_önek	sayısal_önek
overview	overview
apd_continue	apd_continue
$sınıfadı	$sınıfadı
$soket_türü	int
imagesetthickness	imagesetthickness
setgid	setgid
$kural	kural
of	of
$zaman	$zaman
$pgid	pgid
$isimalanı	string
$jpeg_dosya_ismi	$jpeg_dosya_ismi
resource	resource
dio_stat	dio_stat
$karküm	karküm
mimeheader	mimeheader
$baglama	bool
strstr	strstr
domimplementation	domimplementation
createelement	createelement
crack	crack
ftp_connect	ftp connect
$filename	filename
$metinsiz	$metinsiz
debug	debug
function_exists	function_exists
$sftp	resource
mysql_tablename	mysql tablename
ssh2_shell	ssh2_shell
tables	tables
ssh2_sftp_rename	ssh2_sftp_rename
$satır	int
$bağlam	bağlam
$dizi2	array
$ca_sert	ca_sert
page	page
$diklik	diklik
$seviye	seviye
mb_internal_encoding	mb_internal_encoding
$öğe	string
domdocumentfragment	domdocumentfragment
pfsockopen	pfsockopen
php_logo_guid	php_logo_guid
$işlev_kodu	$işlev_kodu
classes	classes
ssh2_fingerprint	ssh2_fingerprint
odbc_prepare	odbc_prepare
$geometri	geometri
compare	compare
accept	accept
substitute	substitute
$hatanum	$hatanum
item	item
set_magic_quotes_runtime	set magic quotes runtime
attribute	attribute
$çıktıgamma	çıktıgamma
imagegd	imagegd
interface_exists	interface exists
apd_set_session	apd_set_session
array_fill_keys	array_fill_keys
removeattribute	removeattribute
$girdi	string
bcompiler_read	bcompiler_read
easter_days	easter days
$json	json
mb_parse_str	mb parse str
$indis	$indis
imap_delete	imap_delete
mb_stripos	mb_stripos
mb_language	mb_language
imagexbm	imagexbm
sqlitedatabase	sqlitedatabase
$dalga_boyu	dalga_boyu
$izinler	string
$sıkıştırma	sıkıştırma
$arama_kuralı	string
hash_final	hash_final
$uzun_seçenekler	$uzun_seçenekler
imagesettile	imagesettile
$progid	$progid
mysql_connect	mysql connect
jdtojulian	jdtojulian
$şema	string
$i	int
substr	substr
$uzak_dosya	uzak_dosya
$borular	array
openssl_pkcs7_encrypt	openssl pkcs7 encrypt
$konu_uzunluğu	int
$boylam	$boylam
$türü	$türü
odbc	odbc
$etiketler	etiketler
$msgid1	msgid1
__tostring	  tostring
extension	extension
bcompiler_write_function	bcompiler_write_function
$msgid2	string
$eşsiz	eşsiz
mysql_connect	mysql_connect
encrypt	encrypt
is_readable	is readable
image_type_to_extension	image_type_to_extension
$gri	$gri
halt	halt
$dğş	dğş
renamemailbox	renamemailbox
appenddata	appenddata
$yenisi	string
$kısa_adlar	$kısa_adlar
$eski	$eski
$nereden	int
bcompiler_load_exe	bcompiler load exe
$kuyruk	kuyruk
$mevcut	domnode
getlastmod	getlastmod
gzinflate	gzinflate
escapeshellarg	escapeshellarg
$cozumlenecek_dizge	$cozumlenecek_dizge
$ham_çıktı	bool
php_check_syntax	php_check_syntax
domelement	domelement
$kırmızı	int
pcntl_signal_dispatch	pcntl_signal_dispatch
output_reset_rewrite_vars	output_reset_rewrite_vars
$kullanıcı_adı	kullanıcı_adı
$bağlan	$bağlan
dio_write	dio write
$x509	x509
setfont	setfont
ftp_chdir	ftp chdir
$konu	$konu
algo	algo
getpwuid	getpwuid
$veri	veri
timeout	timeout
$degisken	mixed
mb_decode_mimeheader	mb decode mimeheader
odbc_alan_adı	odbc alan adı
$beyaznokta	float
$maske	maske
recv	recv
$degisken	degisken
$gid	gid
bcsub	bcsub
$progid	progid
array_unique	array_unique
mhash_get_block_size	mhash get block size
ignore_user_abort	ignore user abort
$resim	resim
$ilk_değer	int
$imap_akımı	imap_akımı
$akım	akım
$boş	boş
remove	remove
$konak	$konak
$pdfdoc	resource
microtime	microtime
preg_last_error	preg_last_error
$eski_oturumu_sil	$eski_oturumu_sil
$pencere	pencere
cal_from_jd	cal_from_jd
gd_info	gd info
getmessage	getmessage
money_format	money format
imagecreatefromxbm	imagecreatefromxbm
$yeni_önbellek_ömrü	string
$dğş_num	$dğş_num
$sabitadi	$sabitadi
$genankim	mixed
$birim	birim
$veri_karş_işlevi	callback
$dosyaismi	$dosyaismi
ini	ini
getnameditemns	getnameditemns
mysql_list_dbs	mysql list dbs
libxml	libxml
push	push
$sınıfadı	sınıfadı
is_subclass_of	is subclass of
$lifetime	$lifetime
$uygulama_adı	string
$katman_yöntemi	int
odbc_fetch_object	odbc_fetch_object
$sürüm	sürüm
tableprivileges	tableprivileges
$gerçek_sayı	bool
$sıralama_türü	int
str_replace	str_replace
$bcc	$bcc
posix_access	posix access
$c	string
override_function	override function
$ardışık	ardışık
$kanal	float
$sertifika	sertifika
setidattributens	setidattributens
gzfile	gzfile
openssl_x509_export_to_file	openssl_x509_export_to_file
$bbcode_degistirge_havuzu	$bbcode_degistirge_havuzu
iconv_mime_encode	iconv mime encode
$etiket_kurallari	array
$sınırlı	$sınırlı
$dosya_adı	dosya_adı
callback	callback
$yil	yil
odbc_tables	odbc_tables
$oku	oku
get_declared_classes	get declared classes
idn	idn
$nokta_sayısı	$nokta_sayısı
ob_end_clean	ob end clean
parse_ini_string	parse_ini_string
$küçük_örnek	küçük_örnek
dir	dir
close	close
$gizli_anahtar	$gizli_anahtar
$sinif	$sinif
socket_strerror	socket strerror
$niteleyici	string
$sftp	$sftp
session_name	session name
gmdate	gmdate
imap_search	imap_search
lchown	lchown
headers_list	headers list
pcntl_sigprocmask	pcntl sigprocmask
imap_base64	imap_base64
socket_recvfrom	socket_recvfrom
dio	dio
$seçenek	seçenek
idn_to_ascii	idn_to_ascii
bind	bind
$gizankim	gizankim
subscribe	subscribe
$gruplar	gruplar
$özet	özet
$ilk_değer	$ilk_değer
$form_verisi	array
schema	schema
$etkin	bool
$ftp_akımı	$ftp_akımı
assert_options	assert_options
gzpassthru	gzpassthru
array_pad	array_pad
$bölümleri_işle	bool
filesize	filesize
apache_reset_timeout	apache reset timeout
get_parent_class	get_parent_class
apc_clear_cache	apc_clear_cache
$eşsiz	int
is_uploaded_file	is_uploaded_file
$cc	cc
openssl_private_decrypt	openssl private decrypt
multi	multi
setimageorientation	setimageorientation
$bicim	int
domcdatasection	domcdatasection
pcntl_sigwaitinfo	pcntl_sigwaitinfo
$kaynak	int
pcntl_wexitstatus	pcntl wexitstatus
str_ireplace	str_ireplace
is_int	is_int
mb_list_encodings	mb list encodings
is_float	is float
$dizge	dizge
$samanlık	string
apd_set_pprof_trace	apd set pprof trace
nice	nice
$akım_bağlamı	resource
$çıktı_dosyası	string
proc_get_status	proc get status
start	start
$sabitler	sabitler
$soket	soket
get_extension_funcs	get_extension_funcs
$zend_eklentileri	$zend_eklentileri
$rumuzlar	rumuzlar
$punto	$punto
$bcc	string
$özgün_isim	string
get_object_vars	get_object_vars
bzopen	bzopen
gettrace	gettrace
gd	gd
gpc	gpc
$renk_tablosu	$renk_tablosu
jd	jd
sign	sign
$dil	string
mb_ereg_search_pos	mb ereg search pos
rot13	rot13
parse_url	parse url
$islevadi	$islevadi
apd_echo	apd_echo
$diziler	diziler
uuencode	uuencode
$zarf_mühürleri	zarf_mühürleri
$diğer	diğer
$resimtürü	int
socket_read	socket read
ftp_nb_fget	ftp nb fget
$not_değeri	string
$status	int
getelementbyid	getelementbyid
imap_thread	imap thread
imap_set_quota	imap set quota
domnamednodemap	domnamednodemap
$anh_parolası	string
gethostbyname	gethostbyname
iconv_set_encoding	iconv set encoding
textdomain	textdomain
uudecode	uudecode
register	register
$kesin	kesin
preg_match_all	preg match all
$dizi_döndür	dizi_döndür
iconv_mime_decode_headers	iconv_mime_decode_headers
$ardışık	$ardışık
$hdf_y	$hdf_y
$sığdır	sığdır
$kanal	$kanal
mcrypt_generic_deinit	mcrypt_generic_deinit
times	times
include	include
$pty	$pty
$delta_x	delta_x
$arayuz	string
ord	ord
langinfo	langinfo
mdecrypt	mdecrypt
$yerel	$yerel
$tv_usec	tv_usec
$bağlantı_kimliği	$bağlantı_kimliği
get_object_vars	get object vars
$ek_başlıklar	$ek_başlıklar
file_put_contents	file_put_contents
iconv_mime_decode	iconv mime decode
dio_stat	dio stat
$lib_dir	lib_dir
metaphone	metaphone
path	path
$kenar	$kenar
ftp_site	ftp site
$zamanaşımı	float
send	send
$tuz	string
select	select
odbc_prepare	odbc prepare
headers	headers
ctype_graph	ctype graph
before	before
odbc_columnprivileges	odbc columnprivileges
$şifreli_veri	$şifreli_veri
define_syslog_variables	define_syslog_variables
curl_multi_close	curl_multi_close
curl_getinfo	curl_getinfo
nonblock	nonblock
mysql_info	mysql info
grapheme_strlen	grapheme strlen
$nereye	int
mysql_field_len	mysql_field_len
mb_check_encoding	mb_check_encoding
document	document
stream_context_set_params	stream_context_set_params
imap_num_msg	imap num msg
ini_get	ini get
gzseek	gzseek
hash_final	hash final
$jg	$jg
$parça_uzunluğu	parça_uzunluğu
columnprivileges	columnprivileges
$içiçe	içiçe
$değerler	array
bzclose	bzclose
ftp_rename	ftp_rename
diff	diff
$geriçağırımlar	array
dom_import_simplexml	dom import simplexml
$oturum	oturum
$deger	mixed
$image	image
$sıkıştırma	$sıkıştırma
columns	columns
rows	rows
sqlite_libversion	sqlite libversion
restore_exception_handler	restore_exception_handler
$fark	fark
array_filter	array_filter
dio_write	dio_write
session_unregister	session unregister
apd_clunk	apd_clunk
$var	var
content	content
$uzunluk	$uzunluk
array_unshift	array_unshift
connect	connect
$sonuç	resource
$öncelik	öncelik
idate	idate
$nesne	nesne
php_strip_whitespace	php_strip_whitespace
user	user
imap_fetchbody	imap_fetchbody
natcasesort	natcasesort
$zamandamgası	zamandamgası
memory_get_peak_usage	memory get peak usage
domnodelist	domnodelist
subclass	subclass
ftell	ftell
pcntl_exec	pcntl exec
$yenisi	mixed
mysql_client_encoding	mysql client encoding
getgrgid	getgrgid
$assoc	$assoc
asort	asort
php_ini_loaded_file	php ini loaded file
$karakterler	karakterler
$özkaynak	$özkaynak
$istek	istek
$sonraki	$sonraki
json_decode	json_decode
stat	stat
$y1	$y1
html_entity_decode	html_entity_decode
hash_init	hash_init
$hedef	resource
imap_sort	imap_sort
mb_substr_count	mb_substr_count
lzf_decompress	lzf decompress
node	node
$benzerlik	$benzerlik
$blokboyu	$blokboyu
$sayı_döndür	bool
$işlev_değiştirgeleri	$işlev_değiştirgeleri
array_map	array map
$pngdosya	string
$önekli_isim	string
relax	relax
$gid	int
setrawcookie	setrawcookie
curl_version	curl version
splittext	splittext
posix_seteuid	posix_seteuid
animateimages	animateimages
rewinddir	rewinddir
setimageopacity	setimageopacity
nl_langinfo	nl_langinfo
$uzak_dosya	string
ctype_cntrl	ctype cntrl
$hata_ayıklama_seviyesi	hata_ayıklama_seviyesi
chars	chars
curl_multi_remove_handle	curl multi remove handle
dns_get_record	dns_get_record
$deste	$deste
pconnect	pconnect
image	image
auth	auth
crack_closedict	crack_closedict
$ay	ay
getprotobyname	getprotobyname
imap_rfc822_write_address	imap rfc822 write address
$kanal	int
openssl_x509_read	openssl_x509_read
$tarayıcı	tarayıcı
imagefilltoborder	imagefilltoborder
$modul	$modul
bcmod	bcmod
get_defined_vars	get_defined_vars
$yükseklik	yükseklik
$imap_akımı	resource
imagecreatetruecolor	imagecreatetruecolor
$biçem	int
$nasıl	int
$titiz	$titiz
ssh2_fetch_stream	ssh2_fetch_stream
$deste	array
utf8	utf8
libxml_set_streams_context	libxml_set_streams_context
$veri	string
gzgetc	gzgetc
createentityreference	createentityreference
status	status
$girinti	girinti
bbcode_set_flags	bbcode_set_flags
grapheme_stristr	grapheme_stristr
$font	int
$iptcverisi	iptcverisi
array_intersect_uassoc	array intersect uassoc
curl_multi_init	curl multi init
$çarpan	int
ssh2_sftp_rename	ssh2 sftp rename
sqlite_libversion	sqlite_libversion
$mühürlü_veri	$mühürlü_veri
long2ip	long2ip
apd_set_session_trace	apd_set_session_trace
filectime	filectime
loadhtmlfile	loadhtmlfile
setattributenode	setattributenode
bbcode_destroy	bbcode destroy
ob_flush	ob flush
$dosyaadi	string
$resim2	resource
bbcode_destroy	bbcode_destroy
$büyük	$büyük
array_diff_key	array_diff_key
chop	chop
gzread	gzread
$amaç	amaç
$bağ	string
$arg	$arg
bcompiler_load	bcompiler_load
$harf_büyüklüğüne_duyarsız	harf_büyüklüğüne_duyarsız
$tersine	$tersine
$açıklama	açıklama
stream_context_create	stream context create
imagefontheight	imagefontheight
codeset	codeset
json_encode	json encode
recode_string	recode_string
$değiştirge	değiştirge
mysql_list_processes	mysql_list_processes
$güçlü	güçlü
imap_reopen	imap_reopen
severity	severity
$ayraç	$ayraç
quoted	quoted
odbc_autocommit	odbc_autocommit
args	args
$arayüz	$arayüz
$dosya	string
compiler	compiler
$dosyaismi	string
iconv_strrpos	iconv_strrpos
$oluşum	oluşum
$dizinismi	dizinismi
array_diff_ukey	array diff ukey
$türetilensınıf	$türetilensınıf
$isimalanı	isimalanı
openssl_verify	openssl_verify
server	server
socket_send	socket send
$parola	$parola
$durum	bool
session_register	session_register
$kırpıcı	$kırpıcı
loadhtml	loadhtml
$hata_iletisi	hata_iletisi
set_time_limit	set_time_limit
extensions	extensions
lookup	lookup
$mavi	$mavi
$ftp_stream	ftp_stream
ob_end_clean	ob_end_clean
$istemci_alanı	istemci_alanı
scalar	scalar
$kanal	kanal
bytes	bytes
$json	string
$yontem	int
define_syslog_variables	define syslog variables
$yöntem	string
gzdecode	gzdecode
posix_getgroups	posix getgroups
jdtofrench	jdtofrench
bcsqrt	bcsqrt
openssl_seal	openssl seal
fork	fork
curl_multi_info_read	curl_multi_info_read
date_default_timezone_get	date default timezone get
openssl_get_cipher_methods	openssl_get_cipher_methods
mcrypt_enc_is_block_algorithm_mode	mcrypt_enc_is_block_algorithm_mode
assert_options	assert options
linearstretchimage	linearstretchimage
imagetypes	imagetypes
$dizin	string
free	free
$ondalık_hane	$ondalık_hane
str_word_count	str_word_count
$genel_anh_dosyası	string
x509	x509
$strict	$strict
mcrypt_enc_self_test	mcrypt_enc_self_test
cntrl	cntrl
sql_regcase	sql_regcase
$string	$string
block	block
easter_days	easter_days
$şema	şema
$secure	bool
distort	distort
wtermsig	wtermsig
$kanal	resource
$ham_çıktı	$ham_çıktı
$fırça	fırça
imap_headerinfo	imap_headerinfo
$betik	betik
$dosya	mixed
by	by
savehtmlfile	savehtmlfile
$yeni_boyut	yeni_boyut
$ham_çıktı	ham_çıktı
$systemid	$systemid
$matlık	bool
$konak_adı	string
properties	properties
openssl_x509_export_to_file	openssl x509 export to file
$image	$image
grapheme_substr	grapheme_substr
construct	construct
$kimlik	$kimlik
$wbmpdosya	wbmpdosya
$sonuç	$sonuç
array_uintersect_assoc	array uintersect assoc
setcookie	setcookie
sunset	sunset
$iğne	mixed
$noktalar	array
$değiştirgeler	$değiştirgeler
$xhtml	xhtml
$ascii	$ascii
mcrypt_cfb	mcrypt cfb
ftp_rawlist	ftp rawlist
imagerectangle	imagerectangle
ini_get	ini_get
$kodlama_listesi	$kodlama_listesi
$gruplar	$gruplar
$değişkenler	mixed
$baş	int
array_diff_assoc	array diff assoc
socket_clear_error	socket clear error
$yarıçap	float
openssl_pkcs7_verify	openssl pkcs7 verify
$algoritma_dizini	algoritma_dizini
imagecreatefrompng	imagecreatefrompng
$işlev_ismi	$işlev_ismi
bbcode_set_arg_parser	bbcode set arg parser
$eski_isim	eski_isim
cal_info	cal_info
$sütun_ismi	string
ssh2_auth_pubkey_file	ssh2 auth pubkey file
$genisletme	$genisletme
filegroup	filegroup
$nanosaniye	int
preg_match	preg match
primarykeys	primarykeys
is_executable	is_executable
$özgün_isim	$özgün_isim
$seviye	$seviye
$pid	pid
bcompiler_write_footer	bcompiler write footer
limiter	limiter
bcompiler_write_header	bcompiler_write_header
$benzerlik	benzerlik
mb_strstr	mb_strstr
$x2	$x2
$alıcı_sertifikaları	alıcı_sertifikaları
__tostring	__tostring
php_strip_whitespace	php strip whitespace
$mühürlü_veri	mühürlü_veri
array_pop	array_pop
debug_backtrace	debug_backtrace
com_event_sink	com event sink
$iptcbloğu	$iptcbloğu
ssh2_sftp_symlink	ssh2_sftp_symlink
$şeffaflığı_yoksay	$şeffaflığı_yoksay
$ftp_akımı	resource
$socket	$socket
imagettfbbox	imagettfbbox
posix_getgid	posix_getgid
imagecolorat	imagecolorat
pasv	pasv
mb_stristr	mb_stristr
exe	exe
error_reporting	error_reporting
$iletiler	int
crypt	crypt
rtrim	rtrim
$dolgulu_uzunluk	$dolgulu_uzunluk
defined	defined
mb_strrpos	mb_strrpos
$iğne	iğne
curl_multi_init	curl_multi_init
$zaman	string
bzerror	bzerror
$geriçağırım	callback
$dakika	dakika
$sonuç	array
$sinifadi	sinifadi
flip	flip
$alannum	alannum
imap_check	imap_check
$çöpçü	çöpçü
pcntl_signal	pcntl signal
$tablo_adı	string
socket_listen	socket_listen
$ham_girdi	string
print	print
$temelsınıf	temelsınıf
$ankim	resource
adaptiveblurimage	adaptiveblurimage
mb_send_mail	mb send mail
mcrypt_module_get_algo_key_size	mcrypt module get algo key size
$süzgeçler	süzgeçler
$komut	string
update	update
intval	intval
mknod	mknod
$mx	int
$sunucu	sunucu
string	string
$maske	string
mb_detect_order	mb_detect_order
ssh2_auth_none	ssh2 auth none
$sonuç	sonuç
bind_textdomain_codeset	bind_textdomain_codeset
$ileti	ileti
$kesin	$kesin
r	r
openssl_pkey_get_public	openssl_pkey_get_public
$anh_karş_işlevi	anh_karş_işlevi
ftp_nb_continue	ftp_nb_continue
relaxngvalidate	relaxngvalidate
$takvim	int
$tercihler	tercihler
ob_get_status	ob get status
$nereden	$nereden
sigtimedwait	sigtimedwait
mb_strripos	mb_strripos
com_message_pump	com_message_pump
$açı	$açı
adaptiveresizeimage	adaptiveresizeimage
$hata_türü	$hata_türü
proc_nice	proc nice
$uyarı	$uyarı
imagecreatefromxpm	imagecreatefromxpm
$tablo	int
$kalınlık	kalınlık
field	field
$yol	$yol
gzrewind	gzrewind
file_exists	file_exists
odbc_setoption	odbc_setoption
$ya_tablo	$ya_tablo
$kip_dizini	kip_dizini
$işlev	$işlev
openssl_sign	openssl_sign
iconv_strlen	iconv strlen
hasattributes	hasattributes
$dizinismi	$dizinismi
schemavalidatesource	schemavalidatesource
ctype_graph	ctype_graph
$terim	$terim
$boylam	boylam
$kalite	$kalite
isid	isid
pcntl_wait	pcntl wait
apache_response_headers	apache_response_headers
openssl_csr_export	openssl csr export
mcrypt_list_modes	mcrypt_list_modes
$eşleşmeler	eşleşmeler
functions	functions
$sığdır	bool
mcrypt_create_iv	mcrypt create iv
$yönerge	yönerge
$süreç	resource
client	client
normalize	normalize
$başlıklar	array
setidattribute	setidattribute
$error_code	error_code
stream	stream
$imza_sertifikası	$imza_sertifikası
$titrek	titrek
openssl_verify	openssl verify
strlen	strlen
$renk	int
attributes	attributes
$aç	$aç
bbcode_add_smiley	bbcode add smiley
$öncelem_türü	öncelem_türü
$engellensin	int
mixed	mixed
$sesler	sesler
mail	mail
apc_sma_info	apc sma info
$ayraç	ayraç
$sapma	sapma
array_shift	array_shift
str_repeat	str_repeat
mb_substr	mb substr
$sarmalayıcı	string
$gün	$gün
fetchbody	fetchbody
mb_list_encodings	mb_list_encodings
line	line
mb_encode_mimeheader	mb_encode_mimeheader
snmp	snmp
$kodlamaya	$kodlamaya
imap_uid	imap_uid
$kodlamadan	string
$yükseklik	int
quality	quality
imap_mail_copy	imap_mail_copy
$konakadı	string
$hala_çalışıyor	hala_çalışıyor
$alfa_kaydet	$alfa_kaydet
$ini	$ini
month	month
fetchheader	fetchheader
odbc_field_num	odbc field num
curl_multi_add_handle	curl_multi_add_handle
mb_regex_encoding	mb regex encoding
odbc_close	odbc close
$var	mixed
stretch	stretch
$konak_adı	konak_adı
$akım_bağlamı	$akım_bağlamı
$ini	ini
$kodlu_dizge	kodlu_dizge
$kısa_seçenekler	string
$kuyruk	int
$saniye	saniye
ftp_nb_get	ftp nb get
iconv_mime_encode	iconv_mime_encode
$satırsonu	satırsonu
$strict	bool
$ysu_var	int
chdir	chdir
$db	resource
$dakika	$dakika
mysql_thread_id	mysql_thread_id
$satırdaki_azami_krk_sayısı	satırdaki_azami_krk_sayısı
$baskı_yönü	$baskı_yönü
rename_function	rename function
openssl_private_encrypt	openssl_private_encrypt
$y2	y2
array_reduce	array_reduce
$yerel	yerel
cyr	cyr
iconv_strpos	iconv strpos
$kütüphane	kütüphane
imageloadfont	imageloadfont
$sorgu_dizgesi	$sorgu_dizgesi
$içiçe	$içiçe
apd_set_session	apd set session
ob_gzhandler	ob_gzhandler
curl_getinfo	curl getinfo
quota	quota
posix_getpwuid	posix getpwuid
$ayarlar	$ayarlar
$nereye	nereye
$yeni	mixed
$sınırlayıcı	sınırlayıcı
mb_output_handler	mb output handler
$önek_var	bool
cal_to_jd	cal to jd
$x2	int
$küçük	int
$oran	$oran
$nesne	imagickdraw
getpwnam	getpwnam
$miktar	$miktar
$girdigamma	$girdigamma
$ekbilgi	ekbilgi
getuid	getuid
$yeni_değer	yeni_değer
orientation	orientation
$kota_sınırı	int
mcrypt_enc_get_block_size	mcrypt enc get block size
parse_ini_file	parse_ini_file
$scket	$scket
apache_setenv	apache setenv
$tampon	$tampon
$ftp_stream	$ftp_stream
mb_send_mail	mb_send_mail
number	number
odbc_execute	odbc_execute
openssl_pkcs12_export	openssl pkcs12 export
$satırnum	$satırnum
imagecolorallocatealpha	imagecolorallocatealpha
array_replace_recursive	array replace recursive
setpriority	setpriority
printable	printable
$algo	algo
$belgetürü	domdocumenttype
mcrypt_enc_is_block_mode	mcrypt enc is block mode
$iv	iv
haschildnodes	haschildnodes
imap_unsubscribe	imap unsubscribe
trimimage	trimimage
$kodlama_dosyası	string
execute	execute
ctype_space	ctype_space
mcrypt_enc_get_iv_size	mcrypt enc get iv size
$ekbilgi	$ekbilgi
$alfa_kaydet	bool
registernodeclass	registernodeclass
a	a
posix_getgrgid	posix getgrgid
odbc_tableprivileges	odbc_tableprivileges
$ascii	int
createattribute	createattribute
$yaz	array
grapheme_strripos	grapheme strripos
ftp_nb_put	ftp_nb_put
$ayarlar	ayarlar
$gun	$gun
openssl_x509_checkpurpose	openssl_x509_checkpurpose
$tanıtıcılar	$tanıtıcılar
$renk_sayısı	$renk_sayısı
$gizli_anh	mixed
usage	usage
$rumuzlar	bool
$yığıt	yığıt
ignore_user_abort	ignore_user_abort
$yönerge	string
crack_check	crack_check
posix_getsid	posix getsid
closedir	closedir
pcntl_sigprocmask	pcntl_sigprocmask
data	data
$bbcode_baslangic_etiketleri	array
apd_set_session_trace_socket	apd_set_session_trace_socket
mysql_field_table	mysql field table
$oturum	$oturum
imap_clearflag_full	imap clearflag full
dio_read	dio_read
$miktar	int
call_user_func	call user func
socket_connect	socket connect
into	into
create_function	create_function
$saniye	$saniye
$rumuzlar	$rumuzlar
getnameditem	getnameditem
randomthresholdimage	randomthresholdimage
$gizli_anh_dosyası	$gizli_anh_dosyası
mcrypt_generic	mcrypt_generic
get_parent_class	get parent class
$geçişim	int
$sonuç_dizisi	$sonuç_dizisi
gethostbyaddr	gethostbyaddr
posix_setgid	posix_setgid
$artalan	$artalan
$arg	arg
posix_setsid	posix_setsid
mcrypt_enc_get_key_size	mcrypt enc get key size
$kod	kod
$cc	$cc
imap_check	imap check
$hatanum	int
$kalınlık	$kalınlık
lengths	lengths
named	named
$isim	$isim
override_function	override_function
$başlama_yeri	başlama_yeri
expire	expire
$çifte_kodlama	bool
mb_ereg_search_regs	mb ereg search regs
$resim1	resource
$tablo_ismi	$tablo_ismi
compile	compile
$alicinesne	object
socket_create_listen	socket create listen
apd_dump_function_table	apd_dump_function_table
apd	apd
optimizeimagelayers	optimizeimagelayers
$kodlama_kipi	int
fscanf	fscanf
memory	memory
libversion	libversion
openssl_csr_export_to_file	openssl csr export to file
ftp_nb_get	ftp_nb_get
mcrypt	mcrypt
idn_to_ascii	idn to ascii
$istemci_seçenekleri	int
$akım_veya_bağlam	$akım_veya_bağlam
$dosya_adı	$dosya_adı
paint	paint
$hatalar_etkin	bool
$komut	int
$zend_eklentileri	zend_eklentileri
$tanıtıcı	tanıtıcı
$bölümler	$bölümler
arg	arg
array_walk_recursive	array_walk_recursive
default	default
define	define
getimageproperty	getimageproperty
$domain	domain
quoted_printable_decode	quoted_printable_decode
$array	$array
statistics	statistics
handlers	handlers
pubkey	pubkey
replacedata	replacedata
imagerotate	imagerotate
$eylemci	$eylemci
bcompiler_write_exe_footer	bcompiler_write_exe_footer
$disi	disi
$uzak_dosa	string
str_word_count	str word count
$alan_değeri	alan_değeri
gztell	gztell
executable	executable
ob_implicit_flush	ob implicit flush
$satırdaki_azami_krk_sayısı	int
vignette	vignette
$istek	string
mysql_field_table	mysql_field_table
mcrypt_module_open	mcrypt_module_open
strcasecmp	strcasecmp
error_get_last	error_get_last
$dil	$dil
$dnm_sayısı	$dnm_sayısı
$sadece_isimler	$sadece_isimler
func_get_args	func get args
$değiştirgeler	string
imap_headers	imap_headers
type	type
character	character
get_class	get_class
syntax	syntax
posix_getegid	posix_getegid
bcompiler_write_exe_footer	bcompiler write exe footer
fields	fields
$modul	modul
$gun	int
$tv_sec	tv_sec
preferred	preferred
socket_send	socket_send
$ftp_stream	resource
jdtounix	jdtounix
getmailboxes	getmailboxes
$alıcı_sertifikaları	$alıcı_sertifikaları
$boy	int
imagecreatefromgd2part	imagecreatefromgd2part
$açkapa	bool
$matris	array
write	write
sprintf	sprintf
$kapsam	int
$arayuz	arayuz
$açkapa	$açkapa
$yenisi	yenisi
$siyah_nokta	$siyah_nokta
ssh2_sftp_readlink	ssh2 sftp readlink
$eşik	$eşik
$sonuç	string
get	get
$delta_x	float
str_replace	str replace
gettraceasstring	gettraceasstring
preg_filter	preg_filter
ob_end_flush	ob end flush
mysql_thread_id	mysql thread id
grapheme_stripos	grapheme stripos
imagesetbrush	imagesetbrush
php_uname	php_uname
preg	preg
ctype_digit	ctype digit
check	check
curl_setopt	curl setopt
mb_check_encoding	mb check encoding
$iletiler	string
clone	clone
sqlite_udf_encode_binary	sqlite udf encode binary
tablename	tablename
xdigit	xdigit
$kesin	bool
$yeni_boyut	int
$güvencesiz_dosya	string
pprof	pprof
$db	$db
$bilgi	array
ftp_close	ftp_close
$hata_ayıklama_seviyesi	$hata_ayıklama_seviyesi
session_save_path	session save path
$yeni_bağlantı	yeni_bağlantı
$sözdizimsel	bool
apd_dump_regular_resources	apd dump regular resources
$diklik	$diklik
bcompiler_write_functions_from_file	bcompiler_write_functions_from_file
$durum	$durum
imap_renamemailbox	imap_renamemailbox
body	body
$konum	$konum
$jpegdosya	jpegdosya
$arayuz	$arayuz
$katman_yöntemi	$katman_yöntemi
deinit	deinit
session_encode	session_encode
$zamanaşımı	int
pair	pair
$adres	adres
$filename	string
odbc_fetch_into	odbc fetch into
getrusage	getrusage
mb_decode_mimeheader	mb_decode_mimeheader
apache_request_headers	apache_request_headers
$kod	string
$açıklama	$açıklama
intl_get_error_code	intl get error code
set_time_limit	set time limit
message	message
$sonuç_dizisi	array
ctype_punct	ctype punct
preg_quote	preg quote
simplexml_import_dom	simplexml import dom
$kip	kip
$secenekler	$secenekler
odbc_cursor	odbc_cursor
private	private
parse_str	parse str
sqlite_error_string	sqlite_error_string
compress	compress
$im	im
handler	handler
iptcembed	iptcembed
$result	$result
odbc_setoption	odbc setoption
$tcp_sunucusu	string
openssl_pkey_export	openssl pkey export
$değişken	değişken
$alan_değeri	$alan_değeri
sql_regcase	sql regcase
fread	fread
$biçem	biçem
imap_thread	imap_thread
$ifade	mixed
setacl	setacl
str_pad	str pad
ftp_delete	ftp delete
array_uintersect	array_uintersect
$dnm_sayısı	dnm_sayısı
called	called
$işlem	int
length	length
$tarayıcı	string
preg_quote	preg_quote
$yaz	callback
mysql_db_name	mysql db name
apache_get_modules	apache_get_modules
preg_filter	preg filter
$ayrıntılı	bool
bbcode_add_element	bbcode add element
apd_dump_function_table	apd dump function table
$budama	budama
imap_bodystruct	imap bodystruct
hash_hmac_file	hash hmac file
curl_copy_handle	curl copy handle
pingimageblob	pingimageblob
$değişken	$değişken
clean	clean
$x_sunucusu	string
$pk	string
$sertifikalar	string
$girdi	mixed
$genel_anh_dosyası	$genel_anh_dosyası
setimagealphachannel	setimagealphachannel
createdocumenttype	createdocumenttype
nodes	nodes
$ba_niteleyici	ba_niteleyici
array_intersect	array_intersect
ftp_mdtm	ftp mdtm
gregoriantojd	gregoriantojd
$başlangıç	$başlangıç
$iletinum	iletinum
imagecolorresolvealpha	imagecolorresolvealpha
$sayfa	sayfa
$depth	int
pcntl_wait	pcntl_wait
$depth	$depth
$kullanıcı	mixed
crack_getlastmessage	crack_getlastmessage
$dosyaadı	dosyaadı
boolean	boolean
$dil	dil
$ana_gid	ana_gid
$diziler	$diziler
imap_fetchbody	imap fetchbody
apache_request_headers	apache request headers
is_callable	is callable
$cct	cct
$kim	kim
apache_get_version	apache_get_version
parser	parser
$geriçağırımlar	geriçağırımlar
$gmt_farkı	float
init	init
channel	channel
address	address
$color	color
createtextnode	createtextnode
$tepe_seviye	tepe_seviye
imap_ping	imap ping
$şablon	şablon
$değiştirge	string
$seçenekler	$seçenekler
$yazıtipi	yazıtipi
connection_status	connection_status
session_id	session id
$istek_sayısı	istek_sayısı
com_create_guid	com_create_guid
preg_split	preg split
$soket_türü	soket_türü
socket_set_block	socket set block
$aile	int
socket_accept	socket accept
strrpos	strrpos
$resim	string
posix_getgid	posix getgid
rsort	rsort
exif_read_data	exif read data
com_get_active_object	com get active object
posix_getgrgid	posix_getgrgid
ctype_alpha	ctype_alpha
orderedposterizeimage	orderedposterizeimage
key	key
utf7	utf7
$baskı_yönü	int
$ufak	$ufak
readable	readable
$öznitelik	domattr
str_split	str_split
ftp_get_option	ftp_get_option
is_int	is int
$secenekler	int
$sınır	sınır
exception	exception
dio_open	dio open
$tam_durum	bool
mcrypt_module_self_test	mcrypt_module_self_test
hasattributens	hasattributens
curl_multi_info_read	curl multi info read
setimagecompression	setimagecompression
extract	extract
ftp_close	ftp close
errorexception	errorexception
$kodlu_dizge	string
$yıl	int
apd_continue	apd continue
$şeffaflık	$şeffaflık
$resim2	resim2
ftp_mkdir	ftp_mkdir
$tablo_türü	tablo_türü
$önek	string
explode	explode
mysql_select_db	mysql_select_db
getimageproperties	getimageproperties
$sınıfla	$sınıfla
libxml_use_internal_errors	libxml_use_internal_errors
$c	c
dgettext	dgettext
$gun	gun
mysql_num_rows	mysql num rows
$numara	int
$girdi	girdi
$dosyaboyu	int
mcrypt_enc_get_algorithms_name	mcrypt enc get algorithms name
$aktarım_kodlaması	$aktarım_kodlaması
read	read
fget	fget
lstat	lstat
symlink	symlink
$bölümleri_işle	$bölümleri_işle
mb_regex_encoding	mb_regex_encoding
hash_hmac	hash hmac
$tersine	int
$soket	resource
$error_code	int
$terim	terim
openssl_private_encrypt	openssl private encrypt
$ters	bool
$alan	string
jdmonthname	jdmonthname
gzclose	gzclose
$not_değeri	$not_değeri
query	query
$url	url
$eski	domnode
$algo	$algo
$gizanh	resource
signal	signal
$hedef	string
$sütun_ismi	$sütun_ismi
$titiz	bool
imagedestroy	imagedestroy
$hizmet	string
build	build
debug_zval_dump	debug_zval_dump
$eşleşenler	$eşleşenler
odbc_field_type	odbc field type
$uçbirim_türü	uçbirim_türü
$devam_yeri	devam_yeri
$pid	$pid
$kalite	kalite
meta	meta
mb_preferred_mime_name	mb_preferred_mime_name
openssl_get_md_methods	openssl get md methods
$biçim	biçim
openssl_pkcs7_decrypt	openssl_pkcs7_decrypt
$sahibi	sahibi
imap_fetchheader	imap_fetchheader
method_exists	method_exists
$eşleşenler	array
openssl_sign	openssl sign
imagecolorexact	imagecolorexact
element	element
parse_url	parse_url
ssh2_sftp_unlink	ssh2_sftp_unlink
$hedef	mixed
$dosyatanitici	dosyatanitici
offsetexists	offsetexists
$gmt_farkı	gmt_farkı
mcrypt_enc_is_block_mode	mcrypt_enc_is_block_mode
fputcsv	fputcsv
$bölümler	bölümler
$sadece_isimler	bool
openssl_decrypt	openssl_decrypt
session_get_cookie_params	session_get_cookie_params
$aynısı	aynısı
iconv_strlen	iconv_strlen
$hatalar_etkin	$hatalar_etkin
setenv	setenv
$bağlamsal_düğüm	$bağlamsal_düğüm
$ikamekrk	ikamekrk
more	more
$deger	$deger
$diziler	bool
$imler	$imler
$öncelik	$öncelik
lzf	lzf
addcslashes	addcslashes
$çıkarım_türü	çıkarım_türü
$sorgu_dizgesi	string
ctype	ctype
$systemid	string
mysql_select_db	mysql select db
$ibranice_metin	string
pcntl_waitpid	pcntl waitpid
flags	flags
unshift	unshift
$çarpan	çarpan
imap_mail	imap mail
reopen	reopen
$ct	$ct
imap_rfc822_parse_adrlist	imap_rfc822_parse_adrlist
pcntl_wstopsig	pcntl_wstopsig
readlink	readlink
bzerrno	bzerrno
$kim	$kim
unlink	unlink
func_get_arg	func get arg
mb_decode_numericentity	mb_decode_numericentity
proc_open	proc_open
$parolası	string
$kodlanmış_başlık	$kodlanmış_başlık
$şt	resource
$yönerge	$yönerge
$saniye	int
ngettext	ngettext
$kyn_gnş	int
preg_replace_callback	preg replace callback
$çıktı_dosyası	çıktı_dosyası
mcrypt_get_block_size	mcrypt_get_block_size
setegid	setegid
iconv_substr	iconv_substr
posix_getpid	posix getpid
$önbellek_türü	önbellek_türü
xinclude	xinclude
mime	mime
$imza_sertifikası	imza_sertifikası
delete	delete
$buyukluk_duyarli	buyukluk_duyarli
numeric	numeric
grapheme_stristr	grapheme stristr
lookupprefix	lookupprefix
$uyarı	uyarı
is_dir	is dir
$parçalar	$parçalar
restore	restore
substring	substring
mcrypt_enc_get_iv_size	mcrypt_enc_get_iv_size
$ba_tablo	ba_tablo
$pencere	$pencere
$tarz	tarz
commentimage	commentimage
tags	tags
array_udiff	array udiff
pathinfo	pathinfo
adı	adı
posterize	posterize
reference	reference
$eski	eski
array_diff_key	array diff key
exif_imagetype	exif imagetype
pingimagefile	pingimagefile
$uçbirim_türü	string
$kenar	kenar
sqlite_udf_decode_binary	sqlite_udf_decode_binary
socket_getpeername	socket_getpeername
$kodlama	string
posix_setgid	posix setgid
mb_substitute_character	mb substitute character
$bağlam	$bağlam
$ay	int
mb_convert_kana	mb convert kana
$secure	secure
mcrypt_module_get_algo_block_size	mcrypt module get algo block size
substringdata	substringdata
$tablo_ismi	string
preg_match	preg_match
$zarf_anahtarı	string
curl_multi_getcontent	curl multi getcontent
bzread	bzread
hmac	hmac
index	index
decompress	decompress
$iptcverisi	string
msgno	msgno
imageantialias	imageantialias
factory	factory
localtime	localtime
comment	comment
$diğer	array
alarm	alarm
array_diff	array diff
$iv	$iv
$parça_boyu	$parça_boyu
$imleç_türü	imleç_türü
$zamandilimi_belirteci	$zamandilimi_belirteci
imap_reopen	imap reopen
mysql_get_proto_info	mysql_get_proto_info
$gizankim	mixed
socket_sendto	socket_sendto
array_product	array product
$kullanıcı_adı	string
mb_strrpos	mb strrpos
apache_lookup_uri	apache lookup uri
$sinyaller	$sinyaller
$my	my
$url	string
imap_fetch_overview	imap_fetch_overview
session_cache_limiter	session cache limiter
$çıktı_geriçağırıcı	$çıktı_geriçağırıcı
output_add_rewrite_var	output_add_rewrite_var
$konak	string
$adı_soyadı	adı_soyadı
clear	clear
ftp_raw	ftp raw
$amaç	int
curl_multi_select	curl_multi_select
odbc_num_fields	odbc_num_fields
ftp_alloc	ftp_alloc
getcompression	getcompression
filemtime	filemtime
$çıktı	$çıktı
openssl_csr_new	openssl csr new
mcrypt_ofb	mcrypt ofb
func_num_args	func num args
$terim	string
syslog	syslog
$iptcbloğu	string
imap_close	imap close
$kısa_adlar	bool
$sonraki	sonraki
supported	supported
$türüne_bak	bool
$ana_gid	$ana_gid
mysql_get_client_info	mysql_get_client_info
$küçük_örnek	$küçük_örnek
odbc_next_result	odbc next result
apd_croak	apd croak
idn_to_utf8	idn to utf8
$son	son
$julyengunu	$julyengunu
imap_clearflag_full	imap_clearflag_full
$aralık	aralık
$kodlama	kodlama
mb_http_output	mb http output
fgetss	fgetss
hash_algos	hash algos
$veri	$veri
$genankim_dizisi	$genankim_dizisi
ftp_login	ftp_login
$sag_terim	sag_terim
$tarama_kipi	tarama_kipi
$mode	$mode
gzuncompress	gzuncompress
$bz	resource
imap_getacl	imap_getacl
imap_set_quota	imap_set_quota
crc32	crc32
ftp_nb_fput	ftp_nb_fput
highlight_file	highlight_file
bbcode_create	bbcode create
$şablon	$şablon
$veritabanı	$veritabanı
$eski_oturumu_sil	bool
proc_open	proc open
createprocessinginstruction	createprocessinginstruction
$büyüklük	büyüklük
socket_last_error	socket last error
$karküm	string
use	use
setidattributenode	setidattributenode
insertbefore	insertbefore
file_exists	file exists
$budama	string
$yontem	$yontem
$sinyal	$sinyal
$alicinesne	alicinesne
$mimeli_metin	string
curl_errno	curl_errno
$komut	$komut
ssh2_publickey_init	ssh2 publickey init
$posta_kutusu	string
$değiştir	bool
$bileşen	bileşen
$yerel	int
$ftp_akımı	ftp_akımı
$baglama	$baglama
php_check_syntax	php check syntax
$düşük	düşük
disk	disk
$başlangıç	başlangıç
$sonuç_kimliği	$sonuç_kimliği
$durum	durum
array_combine	array_combine
mb_output_handler	mb_output_handler
$modül	modül
$zend_eklentileri	bool
$gizanh	gizanh
$indis	int
encode	encode
curl_multi_getcontent	curl_multi_getcontent
getgroups	getgroups
domattr	domattr
$alanlar	alanlar
com_create_guid	com create guid
$döküm_dizini	$döküm_dizini
in_array	in array
odbc_alan_adı	odbc_alan_adı
mb_strpos	mb strpos
dio_tcsetattr	dio_tcsetattr
$alan	$alan
odbc_data_source	odbc data source
$değişkenler	$değişkenler
mb_encode_numericentity	mb_encode_numericentity
posix_getsid	posix_getsid
ftruncate	ftruncate
$tuz	$tuz
$modül_ismi	modül_ismi
$önek_var	$önek_var
$nanosaniye	nanosaniye
$oku	$oku
$protokol	$protokol
socket_recvfrom	socket recvfrom
pcntl_wtermsig	pcntl wtermsig
$hdf_genş	int
session_set_save_handler	session set save handler
$önem	$önem
dom_import_simplexml	dom_import_simplexml
contraststretchimage	contraststretchimage
$x509sert	mixed
number_format	number format
get_included_files	get_included_files
$ortam	$ortam
$sınıf	$sınıf
imap_close	imap_close
intl_get_error_code	intl_get_error_code
$dizi2	$dizi2
$dizinismi	string
similar_text	similar text
socket_close	socket_close
$şifre	şifre
curl_exec	curl_exec
$gruplar	array
preg_replace_callback	preg_replace_callback
$kodlanmış_başlıklar	string
ini_get_all	ini_get_all
$sertifikalar	sertifikalar
$süreç	$süreç
cal_info	cal info
$biçim	int
same	same
$sonuç_kimliği	resource
$ankim	$ankim
save	save
$fırça	resource
$boş	int
mhash_get_hash_name	mhash_get_hash_name
$türü	string
ssl	ssl
imap_base64	imap base64
$beyaz_nokta	float
pcntl_signal_dispatch	pcntl signal dispatch
is_callable	is_callable
mysql_field_seek	mysql_field_seek
$httponly	$httponly
basename	basename
cookie	cookie
curl_multi_add_handle	curl multi add handle
$dizi	$dizi
$miter	$miter
$ilk_parça	$ilk_parça
posix_strerror	posix strerror
ftp_put	ftp_put
$sınırlı	bool
posix_geteuid	posix geteuid
$dalga_boyu	float
array_fill	array_fill
$ekbilgi	array
$ifade	string
ssh2_auth_pubkey_file	ssh2_auth_pubkey_file
$son	$son
$oid_format	$oid_format
zval	zval
is_file	is file
$pkcs12	string
$akım_veya_bağlam	resource
$soket	$soket
$yeni	$yeni
$gerçek_kullanım	bool
$işlev_ismi	string
$sabitadi	string
$karakterler	$karakterler
getallheaders	getallheaders
ordered	ordered
mcrypt_module_is_block_algorithm	mcrypt module is block algorithm
odbc_commit	odbc_commit
func_num_args	func_num_args
$değiştirgeler	değiştirgeler
iconv_strpos	iconv_strpos
apache_child_terminate	apache child terminate
$kodlama	int
$zamanaşımı	$zamanaşımı
mysql_num_rows	mysql_num_rows
host	host
socket_set_block	socket_set_block
$oku	callback
$kodlama_kipi	kodlama_kipi
jdtojewish	jdtojewish
$zamandamgası	int
$siyahnokta	$siyahnokta
uploaded	uploaded
product	product
$ysu_var	ysu_var
mysql_get_proto_info	mysql get proto info
$dönüş_değeri	$dönüş_değeri
$kural	$kural
$dönem	$dönem
posix_times	posix times
array_intersect_ukey	array_intersect_ukey
$parçanum	string
inet	inet
random	random
imap_listscan	imap_listscan
ob_clean	ob_clean
ssh2_publickey_list	ssh2_publickey_list
jdtogregorian	jdtogregorian
mb_strrchr	mb_strrchr
mb_parse_str	mb_parse_str
quotemeta	quotemeta
imap_getsubscribed	imap getsubscribed
is_readable	is_readable
posix_mkfifo	posix mkfifo
$eklenti	string
whitespace	whitespace
$aile	$aile
$gizli_anh_dosyası	gizli_anh_dosyası
$zarf_anahtarı	$zarf_anahtarı
$yerel_dosya	string
$pencere	int
self	self
imagecolorresolve	imagecolorresolve
seek	seek
get_called_class	get_called_class
domnode	domnode
posix_getppid	posix_getppid
table	table
$id	$id
$sıkıştırma	int
bcscale	bcscale
array_replace_recursive	array_replace_recursive
wstopsig	wstopsig
$zaman_asimi	int
apd_callstack	apd callstack
case	case
$port	port
version	version
dump	dump
$bbcode_baslangic_etiketleri	bbcode_baslangic_etiketleri
$dsn	$dsn
$dosyatanitici	resource
bool	bool
odbc_statistics	odbc statistics
$ne	$ne
$sınıfadı	string
array_intersect_key	array intersect key
$ad	string
getelementsbytagname	getelementsbytagname
$buyuklukduyarsiz	buyuklukduyarsiz
$algoritma_dizini	string
unsubscribe	unsubscribe
$yerel_dosya	yerel_dosya
odbc_primarykeys	odbc_primarykeys
odbc_field_len	odbc field len
ob_get_length	ob get length
$alan_adı	alan_adı
mysql_list_tables	mysql_list_tables
ctype_lower	ctype_lower
files	files
$fark	int
decipher	decipher
mb_strlen	mb strlen
odbc_statistics	odbc_statistics
libxmlerror	libxmlerror
posix_getpgrp	posix getpgrp
$sorgu	sorgu
$kütüphane	$kütüphane
$path	$path
libxml_get_errors	libxml get errors
new	new
mysql_unbuffered_query	mysql_unbuffered_query
odbc_result	odbc result
$konum	konum
timezone	timezone
$d2	d2
$harf_büyüklüğüne_duyarsız	$harf_büyüklüğüne_duyarsız
ssh2_exec	ssh2 exec
$hata_ayıklama_seviyesi	int
imagefill	imagefill
odbc_exec	odbc_exec
sketchimage	sketchimage
$ortam	array
mb_substr_count	mb substr count
thumbnail	thumbnail
imap_errors	imap errors
$ankim	ankim
bind_textdomain_codeset	bind textdomain codeset
array_key_exists	array_key_exists
pdf_setmiterlimit	pdf setmiterlimit
$kullanıcı	kullanıcı
variables	variables
imap_createmailbox	imap createmailbox
setpointsize	setpointsize
$not_adı	$not_adı
$tanıtıcı	resource
convert_cyr_string	convert_cyr_string
$arg	mixed
$ondalık_hane	int
cbc	cbc
openssl_x509_export	openssl_x509_export
$tv_sec	$tv_sec
$tür	int
ssh2_tunnel	ssh2_tunnel
__halt_compiler	  halt compiler
reporting	reporting
createcomment	createcomment
convert_uuencode	convert_uuencode
$sınırlayıcı	string
$isim	isim
mhash	mhash
imagefilter	imagefilter
encipher	encipher
sscanf	sscanf
pkey	pkey
ob_iconv_handler	ob_iconv_handler
$kalınlık	int
imagegrabwindow	imagegrabwindow
$bağlam	resource
$not_değeri	not_değeri
$bz	$bz
com_message_pump	com message pump
transformimage	transformimage
$süreç_türü	int
$karakter	$karakter
socket_connect	socket_connect
getattributens	getattributens
getseverity	getseverity
$dolgu_dizgesi	dolgu_dizgesi
$bcc	bcc
undelete	undelete
$alfa_kaydet	alfa_kaydet
openssl_get_cipher_methods	openssl get cipher methods
curl_multi_remove_handle	curl_multi_remove_handle
parse_str	parse_str
imap_getmailboxes	imap getmailboxes
mcrypt_module_get_algo_block_size	mcrypt_module_get_algo_block_size
isdefaultnamespace	isdefaultnamespace
gettimeofday	gettimeofday
final	final
mb_substr	mb_substr
get_cfg_var	get cfg var
imap_msgno	imap_msgno
croak	croak
grapheme_extract	grapheme extract
mb_convert_case	mb convert case
file_get_contents	file get contents
imap_utf8	imap utf8
array_count_values	array count values
$delimiter	delimiter
$d1	$d1
$titiz	titiz
$biçem	$biçem
$yüksek	$yüksek
unset	unset
openssl_error_string	openssl_error_string
$diklik	float
apd_set_session_trace_socket	apd set session trace socket
lzf_optimized_for	lzf_optimized_for
gzgets	gzgets
mcrypt_generic_end	mcrypt generic end
$eskiler	$eskiler
$tv_usec	$tv_usec
$x509srtfk_verisi	mixed
$eskiler	array
$id_olarak	bool
mcrypt_ecb	mcrypt ecb
pcntl_setpriority	pcntl setpriority
$veri_karş_işlevi	$veri_karş_işlevi
ssh2_sftp_lstat	ssh2_sftp_lstat
$başlıklar	başlıklar
com_get_active_object	com_get_active_object
liquidrescaleimage	liquidrescaleimage
getlastmessage	getlastmessage
$protokol	protokol
record	record
$resim_türü	$resim_türü
mcrypt_decrypt	mcrypt_decrypt
$betik	$betik
$biçem	string
imagefilledrectangle	imagefilledrectangle
array_splice	array_splice
$baskı_yönü	baskı_yönü
$özkaynak	özkaynak
$girdi	$girdi
pkcs12	pkcs12
animate	animate
escape	escape
$miter	float
session_unset	session_unset
schemavalidate	schemavalidate
filter	filter
$...	array
getrlimit	getrlimit
$im	string
$pdfdoc	$pdfdoc
imagecreatefromwbmp	imagecreatefromwbmp
hash_algos	hash_algos
$sayısal_önek	string
bcompiler_parse_class	bcompiler parse class
bbcode_set_flags	bbcode set flags
$olcek	int
$modül_ismi	$modül_ismi
$ascii	ascii
apc_sma_info	apc_sma_info
$eşik_eşlemi	string
crack_opendict	crack opendict
algorithm	algorithm
vignetteimage	vignetteimage
odbc_fetch_object	odbc fetch object
$süzgeç	int
get_class_vars	get_class_vars
$değişken	mixed
posix_setpgid	posix_setpgid
$oluşum	$oluşum
proc_terminate	proc terminate
getdate	getdate
info	info
merge	merge
$yapıştırıcı	$yapıştırıcı
$kapsam	kapsam
$yeniden_syscalls	yeniden_syscalls
$eşik_eşlemi	eşik_eşlemi
error_log	error_log
openssl_open	openssl_open
$veri_karş_işlevi	veri_karş_işlevi
$zamandilimi_belirteci	string
$sorgu	$sorgu
apc_define_constants	apc_define_constants
mdecrypt_generic	mdecrypt generic
getfile	getfile
$id_olarak	id_olarak
$kodlu_dizge	$kodlu_dizge
$yapıştırıcı	yapıştırıcı
getimageclipmask	getimageclipmask
dio_close	dio close
image_type_to_mime_type	image type to mime type
internal	internal
$ibrani	ibrani
imagesavealpha	imagesavealpha
array_product	array_product
$alannum	int
methods	methods
set_include_path	set include path
$eylemci	eylemci
num	num
closedict	closedict
imagettftext	imagettftext
$hata_eylemci	callback
$seçenekler	array
$iletiler	$iletiler
$etiketler	$etiketler
$baş	baş
array_map	array_map
writeimagefile	writeimagefile
imagesy	imagesy
libencoding	libencoding
odbc_specialcolumns	odbc_specialcolumns
array_count_values	array_count_values
$font_index	font_index
callstack	callstack
len	len
sqlite_libencoding	sqlite libencoding
socket_shutdown	socket_shutdown
$kullanıcı_adı	$kullanıcı_adı
$türler	string
$eski_isim	$eski_isim
apc_fetch	apc_fetch
ssh2_sftp	ssh2 sftp
$titrek	$titrek
$girdi	resource
$gri	bool
var	var
range	range
$pdfdoc	pdfdoc
$kime	$kime
move	move
$dizi_döndür	$dizi_döndür
imagecolorallocate	imagecolorallocate
$noktalı	noktalı
$işlev	callback
$hdf_yüks	int
$tepe_seviye	$tepe_seviye
$tv_sec	int
$posta_kutusu	$posta_kutusu
$pty	pty
iconv_mime_decode	iconv_mime_decode
mhash_get_block_size	mhash_get_block_size
imap_lsub	imap_lsub
empty	empty
posix_kill	posix_kill
$d4	int
imap_mime_header_decode	imap_mime_header_decode
issupported	issupported
$http_yanıt_kodu	http_yanıt_kodu
continue	continue
$ya_sahibi	string
$siyahnokta	float
function	function
ftp_rawlist	ftp_rawlist
$öncelem	öncelem
rescale	rescale
quoted_printable_encode	quoted_printable_encode
ftp_size	ftp_size
eregi_replace	eregi_replace
getinfo	getinfo
$işlev	int
mcrypt_get_block_size	mcrypt get block size
$ba_sahibi	ba_sahibi
uniqueimagecolors	uniqueimagecolors
ob_get_length	ob_get_length
posix_setpgid	posix setpgid
$süzgeç	süzgeç
$yeni_değer	bool
openssl_pkey_export_to_file	openssl_pkey_export_to_file
openssl_public_encrypt	openssl public encrypt
mcrypt_enc_get_modes_name	mcrypt enc get modes name
$not_adı	not_adı
array_rand	array_rand
mysql_num_fields	mysql num fields
$seçenekler	seçenekler
parse_ini_file	parse ini file
$şifreli_veri	string
func	func
$gericagirim	gericagirim
array_udiff_uassoc	array udiff uassoc
shade	shade
aborted	aborted
ngvalidate	ngvalidate
$harf_büyüklüğüne_duyarsız	bool
$eşik	int
array_uintersect_uassoc	array_uintersect_uassoc
sqlite_error_string	sqlite error string
$taban	int
socket_select	socket_select
foreignkeys	foreignkeys
mktime	mktime
implode	implode
posix_getegid	posix getegid
ttyname	ttyname
openssl_csr_sign	openssl csr sign
odbc_gettypeinfo	odbc gettypeinfo
opendict	opendict
$nereye	$nereye
libxml_set_streams_context	libxml set streams context
$önbellek_türü	$önbellek_türü
$dizi1	array
$düşük	$düşük
socket_shutdown	socket shutdown
$disi	$disi
set_exception_handler	set exception handler
disk_total_space	disk_total_space
opaque	opaque
$domain	$domain
mhash_count	mhash count
$emiksler	emiksler
$dosyaismi	dosyaismi
session_name	session_name
$biçim	string
apache_note	apache_note
session_encode	session encode
$hdf_x	hdf_x
apd_callstack	apd_callstack
$kodlamadan	kodlamadan
$yeşil	int
$ya_niteleyici	ya_niteleyici
gzopen	gzopen
openssl_x509_check_private_key	openssl_x509_check_private_key
$birim	$birim
$boyut	boyut
$girinti	int
mcrypt_get_iv_size	mcrypt get iv size
$zarf	array
dio_read	dio read
binmode	binmode
php_ini_loaded_file	php_ini_loaded_file
xml	xml
imap_status	imap_status
chown	chown
odbc_fetch_row	odbc fetch row
cal_to_jd	cal_to_jd
dcgettext	dcgettext
readgzfile	readgzfile
$...	$...
$tarama_kipi	int
funcs	funcs
$kapa	kapa
imagesetpixel	imagesetpixel
$bölümleri_işle	bölümleri_işle
socket_select	socket select
ssh2_sftp_symlink	ssh2 sftp symlink
json_last_error	json last error
$konu_uzunluğu	konu_uzunluğu
openssl_csr_export_to_file	openssl_csr_export_to_file
$include_path_kullan	int
$metin	$metin
$oluşum	int
setmiterlimit	setmiterlimit
openssl_pkey_free	openssl pkey free
odbc_gettypeinfo	odbc_gettypeinfo
$dizin_tanıtıcısı	resource
$buyuklukduyarsiz	bool
elements	elements
ctype_digit	ctype_digit
sqlite_factory	sqlite_factory
$yeni	yeni
id	id
ukey	ukey
odbc_result_all	odbc result all
$uzunluk	uzunluk
shift	shift
$ek_sertifikalar	string
imap_utf7_encode	imap utf7 encode
$kodlamaya	kodlamaya
imagelayereffect	imagelayereffect
$önbellek_türü	int
$jpeg_dosya_ismi	string
apd_breakpoint	apd breakpoint
odbc_columnprivileges	odbc_columnprivileges
$id	string
ftp	ftp
$günlük_türü	$günlük_türü
$güçlü	$güçlü
mysql_db_name	mysql_db_name
insertdata	insertdata
$önem	array
array_fill_keys	array fill keys
json_last_error	json_last_error
imap_expunge	imap_expunge
$grup	mixed
exists	exists
$amaç	$amaç
ssh2_sftp_lstat	ssh2 sftp lstat
$json	$json
grapheme_substr	grapheme substr
graph	graph
ftp_put	ftp put
$xhtml	$xhtml
$dğş_num	int
rewind	rewind
$tepe_seviye	bool
imap_utf7_decode	imap utf7 decode
$tuz	tuz
$mimeli_metin	$mimeli_metin
ctype_alnum	ctype alnum
$ca_bilgisi	ca_bilgisi
session_decode	session_decode
imap	imap
$dolgu_türü	dolgu_türü
ip2long	ip2long
simplexmlelement	simplexmlelement
mb_detect_encoding	mb_detect_encoding
transform	transform
$budama	$budama
$döndür	$döndür
$önekliad	string
$anahtar	mixed
$yöntem	$yöntem
iconv_get_encoding	iconv get encoding
iterator	iterator
is_string	is_string
$belgeadı	$belgeadı
multisort	multisort
ctype_xdigit	ctype xdigit
array_diff_ukey	array_diff_ukey
pcntl_exec	pcntl_exec
$tablo_adı	$tablo_adı
$yeni_değer	$yeni_değer
$ca_bilgisi	array
hasfeature	hasfeature
$dönüş_yolu	string
$kodsayfasi	kodsayfasi
tunnel	tunnel
$özel_adres	özel_adres
hash_hmac	hash_hmac
$matlık	$matlık
error_reporting	error reporting
spliti	spliti
$noktalar	$noktalar
openssl_open	openssl open
str_ireplace	str ireplace
mcrypt_decrypt	mcrypt decrypt
$bölüm	string
registernamespace	registernamespace
$yetkili_enesler	yetkili_enesler
$aynısı	$aynısı
$assoc	bool
get_meta_tags	get_meta_tags
ftp_systype	ftp systype
$sabitler	$sabitler
mysql_stat	mysql stat
iconv	iconv
$dizi_döndür	bool
$tv_usec	int
apc_cache_info	apc_cache_info
ctype_lower	ctype lower
imagepsencodefont	imagepsencodefont
$uzantı	string
polaroid	polaroid
$grup	$grup
openssl_csr_new	openssl_csr_new
compact	compact
scanned	scanned
$belgetürü	$belgetürü
mysql_affected_rows	mysql affected rows
$açı	float
$islevadi	string
$genlik	$genlik
fnmatch	fnmatch
$seçenek	int
persistent	persistent
register_shutdown_function	register shutdown function
$i	i
flush	flush
rawurldecode	rawurldecode
$şt	şt
odbc_field_scale	odbc_field_scale
imap_sort	imap sort
$nesne_sağla	nesne_sağla
pcntl_sigtimedwait	pcntl sigtimedwait
pcntl_wifstopped	pcntl wifstopped
$algoritma	string
fopen	fopen
ssh2_scp_send	ssh2 scp send
threshold	threshold
$fırça	$fırça
$şt	$şt
$yıl	$yıl
$nokta_sayısı	int
$temelsınıf	string
imagecolordeallocate	imagecolordeallocate
get_resource_type	get_resource_type
algorithms	algorithms
odbc_tables	odbc tables
$dsn	string
setimagecompressionquality	setimagecompressionquality
disk_free_space	disk free space
mb_internal_encoding	mb internal encoding
ob_list_handlers	ob list handlers
__construct	__construct
getimagechanneldepth	getimagechanneldepth
odbc_procedures	odbc procedures
$çıkarım_türü	int
$tmmpon	tmmpon
json_decode	json decode
imap_rfc822_write_address	imap_rfc822_write_address
ssh2_publickey_init	ssh2_publickey_init
html_entity_decode	html entity decode
libxml_use_internal_errors	libxml use internal errors
shutdown	shutdown
peak	peak
contrast	contrast
search	search
imap_renamemailbox	imap renamemailbox
$dizi	dizi
has	has
array_sum	array sum
$kırpıcı	string
$sorgu_dizgesi	sorgu_dizgesi
ssh2_exec	ssh2_exec
importnode	importnode
ssh2_sftp_realpath	ssh2_sftp_realpath
offsetget	offsetget
lzf_compress	lzf compress
$nasıl	$nasıl
$gri	gri
mysql_client_encoding	mysql_client_encoding
openssl_error_string	openssl error string
$özdevinimli_yükle	$özdevinimli_yükle
imap_msgno	imap msgno
fgetc	fgetc
$kenar	int
strrichr	strrichr
$komut	komut
registered	registered
number_format	number_format
mcrypt_ofb	mcrypt_ofb
$sag_terim	string
$enlem	float
flock	flock
$sinifadi	$sinifadi
$doğruluk	$doğruluk
feature	feature
bbcode_set_arg_parser	bbcode_set_arg_parser
posix_times	posix_times
values	values
imagecolorset	imagecolorset
$dönüş_yolu	$dönüş_yolu
$eşik	eşik
htmlspecialchars_decode	htmlspecialchars_decode
$csr	csr
openssl_pkcs7_decrypt	openssl pkcs7 decrypt
constant	constant
regex	regex
odbc_result_all	odbc_result_all
sql	sql
is_link	is link
openssl_public_decrypt	openssl public decrypt
$anahtarlar	$anahtarlar
openssl_pkey_new	openssl pkey new
openssl_random_pseudo_bytes	openssl random pseudo bytes
$dizi1	dizi1
prev	prev
fetchstructure	fetchstructure
linkinfo	linkinfo
imagegd2	imagegd2
recode	recode
ctype_upper	ctype upper
mcrypt_enc_get_supported_key_sizes	mcrypt_enc_get_supported_key_sizes
apache_get_modules	apache get modules
included	included
get_called_class	get called class
mcrypt_module_is_block_algorithm_mode	mcrypt_module_is_block_algorithm_mode
$türetilensınıf	türetilensınıf
$değiştirgeler	mixed
$pngdosya	pngdosya
dl	dl
is_object	is_object
csr	csr
ftp_mdtm	ftp_mdtm
recvfrom	recvfrom
$şifre	int
posix_seteuid	posix seteuid
$bağlantı_belirteci	resource
note	note
get_headers	get headers
$ek_seçenekler	$ek_seçenekler
$gerçek_sayı	gerçek_sayı
$sertifika	$sertifika
resources	resources
rewrite	rewrite
$aralık	$aralık
$kodlama_listesi	kodlama_listesi
$olcek	olcek
fgets	fgets
$yeni_isim	yeni_isim
recode_file	recode file
$çerçeve_rengi	$çerçeve_rengi
ob_get_contents	ob get contents
oid	oid
$my	int
$değer	$değer
$kural	int
ssh2_tunnel	ssh2 tunnel
odbc_procedurecolumns	odbc procedurecolumns
typelib	typelib
session_start	session start
mcrypt_list_modes	mcrypt list modes
$yenisi	$yenisi
evaluate	evaluate
$şifre	string
getegid	getegid
keys	keys
linear	linear
$kyn_y	kyn_y
array_search	array_search
property_exists	property_exists
$kodlamaya	string
array_flip	array flip
$ayraç	string
compareimagelayers	compareimagelayers
imagetruecolortopalette	imagetruecolortopalette
$hala_çalışıyor	$hala_çalışıyor
mcrypt_generic	mcrypt generic
$sınırlayıcı	$sınırlayıcı
imagecreate	imagecreate
$algoritma	algoritma
$izinli_etiketler	$izinli_etiketler
$assoc	assoc
memory_get_usage	memory_get_usage
breakpoint	breakpoint
odbc_longreadlen	odbc longreadlen
$ip_adresi	$ip_adresi
posix_setegid	posix setegid
log	log
rfc822	rfc822
$sınır	int
session_cache_limiter	session_cache_limiter
$hizmet	$hizmet
regenerate	regenerate
scp	scp
$anahtar	$anahtar
$istisna_eylemcisi	istisna_eylemcisi
fflush	fflush
pcntl_fork	pcntl fork
$çifte_kodlama	$çifte_kodlama
$gizanh	mixed
ob_gzhandler	ob gzhandler
intl_error_name	intl error name
array_values	array_values
mcrypt_enc_is_block_algorithm_mode	mcrypt enc is block algorithm mode
$genişlik	genişlik
chmod	chmod
$ortam	ortam
$domain	string
openssl_digest	openssl_digest
$sunucu	$sunucu
$değer	değer
curl_error	curl error
$biçemle	$biçemle
iconv_substr	iconv substr
level	level
lzf_decompress	lzf_decompress
$msgid1	string
$ba_tablo	$ba_tablo
mcrypt_module_get_algo_key_size	mcrypt_module_get_algo_key_size
socket_getpeername	socket getpeername
apd_clunk	apd clunk
$zarf_anahtarı	zarf_anahtarı
$ya_niteleyici	$ya_niteleyici
$cozumlenecek_dizge	string
serialize	serialize
mcrypt_cbc	mcrypt_cbc
bcompiler_load_exe	bcompiler_load_exe
$veri_türü	int
array_udiff_assoc	array udiff assoc
hash_file	hash file
$baş	$baş
$sınıf	mixed
$tür	tür
array_diff_assoc	array_diff_assoc
$iptcverisi	$iptcverisi
intl_get_error_message	intl_get_error_message
$sarmalayıcı	sarmalayıcı
$font_index	$font_index
$ya_tablo	string
$baslangickonum	$baslangickonum
is_bool	is bool
$bölümler	string
$dn	dn
$tür	string
ftp_nb_put	ftp nb put
$mode	mode
$parça_boyutu	$parça_boyutu
all	all
$kodlanmış_başlık	string
decode	decode
modules	modules
$n	$n
krsort	krsort
$publicid	publicid
kill	kill
simplexml_import_dom	simplexml_import_dom
is_resource	is resource
__clone	  clone
$oku	array
get_meta_tags	get meta tags
$i	$i
$resimtürü	$resimtürü
keygen	keygen
$oid_format	int
$julyengunu	julyengunu
processing	processing
$x_sunucusu	$x_sunucusu
$veritabanı_adı	$veritabanı_adı
$x2	x2
extentimage	extentimage
$eklenti	eklenti
quoted_printable_encode	quoted printable encode
$sınıf	string
$günlük_türü	int
crack_check	crack check
$ikamekrk	$ikamekrk
file_put_contents	file put contents
layers	layers
$modul	string
ftp_raw	ftp_raw
$zarf	zarf
dio_open	dio_open
$dosya	$dosya
autocommit	autocommit
$alan_konumu	int
$anahtarları_koru	bool
call_user_func_array	call user func array
openssl_pkey_export	openssl_pkey_export
$dizin	$dizin
clip	clip
ftp_cdup	ftp_cdup
ob_get_status	ob_get_status
imap_getsubscribed	imap_getsubscribed
$pid	int
mdtm	mdtm
hebrevc	hebrevc
$değerler	değerler
$ufak	int
imap_bodystruct	imap_bodystruct
$maske	$maske
$türler	türler
$süreç_türü	süreç_türü
lcfirst	lcfirst
source	source
$arama_kuralı	$arama_kuralı
chopimage	chopimage
$öncelem_türü	int
$tanıtıcılar	tanıtıcılar
ssh2_sftp_mkdir	ssh2 sftp mkdir
dirname	dirname
__clone	__clone
$x509	$x509
glob	glob
odbc_next_result	odbc_next_result
openssl_pkcs12_export_to_file	openssl pkcs12 export to file
wave	wave
$tampon	tampon
lzf_optimized_for	lzf optimized for
$dakika	int
$x509	mixed
array_multisort	array_multisort
$arayüz	arayüz
$adres	string
$zarf_mühürleri	array
iswhitespaceinelementcontent	iswhitespaceinelementcontent
array_replace	array replace
site	site
dcngettext	dcngettext
is_executable	is executable
feof	feof
savexml	savexml
session_set_cookie_params	session_set_cookie_params
$genisletme	string
imap_lsub	imap lsub
readfile	readfile
openssl_x509_parse	openssl_x509_parse
output	output
imap_rfc822_parse_headers	imap_rfc822_parse_headers
ctype_upper	ctype_upper
curl_errno	curl errno
colors	colors
$turkutuphaneadi	$turkutuphaneadi
posix_uname	posix uname
$zaman_damgası	zaman_damgası
$kodlama_dosyası	$kodlama_dosyası
mb	mb
$kip	int
float	float
apc_compile_file	apc_compile_file
openssl_free_key	openssl free key
adaptive	adaptive
$x1	x1
$tablo_ismi	tablo_ismi
$nesne	$nesne
mb_strimwidth	mb strimwidth
$yarıçap	yarıçap
$dizi2	dizi2
phpcredits	phpcredits
mysql_db_query	mysql db query
$açıklama	string
ssh2_scp_send	ssh2_scp_send
$uid	int
$aralık	string
ftp_site	ftp_site
$mavi	mavi
$yükseliş	float
imagewbmp	imagewbmp
test	test
rollback	rollback
socket_create_pair	socket create pair
imap_uid	imap uid
apd_dump_persistent_resources	apd_dump_persistent_resources
$sıranum	int
name	name
$dsn	dsn
$türü	int
array_push	array push
$dizge	string
$çıktıgamma	float
imap_fetchstructure	imap fetchstructure
shell_exec	shell_exec
$satır	satır
htmlentities	htmlentities
db	db
apc	apc
$tarz	array
bcompiler_write_functions_from_file	bcompiler write functions from file
$birim	int
recode_string	recode string
bcompiler_load	bcompiler load
$özet	$özet
openssl_get_md_methods	openssl_get_md_methods
$x	$x
session_start	session_start
exif	exif
$ilk_parça	bool
wifexited	wifexited
regcase	regcase
uid	uid
$comnesne	variant
chunk	chunk
$kırmızı	kırmızı
$hdf_genş	$hdf_genş
phpversion	phpversion
bzdecompress	bzdecompress
$türüne_bak	$türüne_bak
curl_init	curl_init
$result	result
$zaman_aşımı	zaman_aşımı
$sadece_http	sadece_http
$işlev	işlev
imageconvolution	imageconvolution
ob_end_flush	ob_end_flush
apd_get_active_symbols	apd_get_active_symbols
$kyn_x	kyn_x
header	header
specialcolumns	specialcolumns
$eski_oturumu_sil	eski_oturumu_sil
$enboy_türü	int
$ufak	ufak
imagegif	imagegif
$karakter	karakter
imageline	imageline
socket_sendto	socket sendto
fprintf	fprintf
font	font
$renk_sayısı	int
openssl_pkcs12_read	openssl pkcs12 read
apache_lookup_uri	apache_lookup_uri
apc_compile_file	apc compile file
imap_errors	imap_errors
sketch	sketch
apc_store	apc store
cache	cache
highlight	highlight
$dosyatanitici	$dosyatanitici
setopt	setopt
openssl	openssl
date_default_timezone_set	date default timezone set
array_reverse	array reverse
closelog	closelog
mysql_get_server_info	mysql_get_server_info
$sinyal	sinyal
crack_closedict	crack closedict
get_browser	get_browser
strrchr	strrchr
$punto	punto
$büyüklük	$büyüklük
$ba_tablo	string
$sapma	$sapma
pcntl_sigtimedwait	pcntl_sigtimedwait
$surum	string
mkdir	mkdir
cal_days_in_month	cal_days_in_month
iconv_strrpos	iconv strrpos
com_load_typelib	com load typelib
$bölge	bölge
hash_update	hash update
$mavi	int
output_add_rewrite_var	output add rewrite var
preg_match_all	preg_match_all
$engellensin	engellensin
array_merge_recursive	array merge recursive
$sıralama_türü	sıralama_türü
dispatch	dispatch
$resimtürü	resimtürü
gettypeinfo	gettypeinfo
$konum	float
session_is_registered	session is registered
jddayofweek	jddayofweek
sqlite_factory	sqlite factory
$ay	$ay
seteuid	seteuid
size	size
gettext	gettext
$zaman_damgası	int
simplexml_load_file	simplexml_load_file
pad	pad
$dizge	$dizge
$bağ	bağ
transparent	transparent
property	property
posix_get_last_error	posix_get_last_error
$enboy_türü	enboy_türü
as	as
gzdeflate	gzdeflate
$veritabanı_adı	veritabanı_adı
$gid	$gid
$ardışık	bool
$x509sert	resource
$ya_niteleyici	string
$özellik	$özellik
$kalite	int
gzencode	gzencode
$gün	int
sqlite_escape_string	sqlite_escape_string
$yeni_bağlantı	bool
session_module_name	session module name
namespace	namespace
odbc_execute	odbc execute
imagepalettecopy	imagepalettecopy
$ilk_değer	ilk_değer
imagearc	imagearc
$islevadi	islevadi
ftp_get_option	ftp get option
$başucu	$başucu
clutimage	clutimage
date_sunrise	date_sunrise
mb_strrichr	mb_strrichr
opendir	opendir
posix_getuid	posix getuid
ini_restore	ini restore
array_merge_recursive	array_merge_recursive
$yol	string
openssl_pkcs7_sign	openssl pkcs7 sign
$eşleşenler	eşleşenler
print_r	print_r
posix_getgroups	posix_getgroups
$yeni	domnode
$sag_terim	$sag_terim
$ek_kayıtlar	$ek_kayıtlar
language	language
openssl_pkey_get_details	openssl pkey get details
odbc_longreadlen	odbc_longreadlen
$öntanımlı_konak	öntanımlı_konak
$alıcı_anahtarı	mixed
$bileşen	$bileşen
entity	entity
function_exists	function exists
array_slice	array_slice
$sol_terim	string
$istek_sayısı	$istek_sayısı
bcompiler_write_file	bcompiler_write_file
$jg	jg
$sözlük	resource
$niteleyici	$niteleyici
$sınır	$sınır
$grup	grup
array_udiff_uassoc	array_udiff_uassoc
openssl_pkey_get_details	openssl_pkey_get_details
$anh_parolası	$anh_parolası
uname	uname
$alıcı_sertifikaları	mixed
ssh2_shell	ssh2 shell
$işlev	callable
$uzun_seçenekler	uzun_seçenekler
time	time
$eğim	eğim
odbc_fetch_row	odbc_fetch_row
jewishtojd	jewishtojd
$kodlanmış_başlıklar	$kodlanmış_başlıklar
$uzak_dosa	uzak_dosa
option	option
odbc_field_scale	odbc field scale
settype	settype
$...	mixed
$dizin	dizin
parse_ini_string	parse ini string
extension_loaded	extension loaded
offset	offset
$yaşam_süresi	$yaşam_süresi
$yeni_isim	string
$nasıl	nasıl
$zamandamgası	$zamandamgası
readdir	readdir
ini_set	ini_set
mb_strtoupper	mb_strtoupper
$kural	string
memory_get_peak_usage	memory_get_peak_usage
$bz	bz
from	from
$öznitelik	öznitelik
mysql_list_tables	mysql list tables
$etki	etki
$değiştirge_dizisi	array
$gmt_farkı	$gmt_farkı
$katman_yöntemi	katman_yöntemi
get_defined_vars	get defined vars
$blokboyu	blokboyu
$değiştirge	mixed
imap_alerts	imap alerts
ftp_nb_fget	ftp_nb_fget
$dosyaboyu	dosyaboyu
$alıcı_anahtarı	alıcı_anahtarı
lchgrp	lchgrp
$özellik	string
$uçbirim_türü	$uçbirim_türü
row	row
$alım_türü	int
curl_multi_exec	curl_multi_exec
pcntl_getpriority	pcntl getpriority
ob_start	ob start
options	options
$hdf_genş	hdf_genş
$gün	gün
$boy	$boy
posix_getpgid	posix getpgid
strip	strip
$tercihler	$tercihler
$alfa	$alfa
mcrypt_module_is_block_mode	mcrypt_module_is_block_mode
upper	upper
is_link	is_link
getsubscribed	getsubscribed
$betik	string
odbc_primarykeys	odbc primarykeys
$nesne_sağla	$nesne_sağla
$özdevinimli_yükle	bool
connection	connection
$csr	$csr
gmmktime	gmmktime
$fark	$fark
apache	apache
$jg	int
$scket	scket
$protokol	string
for	for
$imza	imza
socket	socket
$gerçek_kullanım	gerçek_kullanım
mdecrypt_generic	mdecrypt_generic
array_flip	array_flip
is_a	is_a
$color	int
ctype_alnum	ctype_alnum
$genişlik	int
cal	cal
$yıl	yıl
$kırmızı	$kırmızı
array_key_exists	array key exists
imap_mail_compose	imap mail compose
mysql_get_client_info	mysql get client info
$algoritma	int
$uzunluk	int
imagegammacorrect	imagegammacorrect
posix_setsid	posix setsid
$hata_kodu	int
is_float	is_float
$sayı_döndür	$sayı_döndür
$özkaynak	resource
$yasam_suresi	$yasam_suresi
exif_thumbnail	exif_thumbnail
$türüne_bak	türüne_bak
get_resource_type	get resource type
$süreç	süreç
mysql_get_host_info	mysql_get_host_info
import	import
$samanlık	samanlık
cfg	cfg
$atama_dizgesi	string
openssl_x509_free	openssl x509 free
$kod	$kod
mb_convert_variables	mb_convert_variables
$süreç_türü	$süreç_türü
getpeername	getpeername
ob_implicit_flush	ob_implicit_flush
$aktarım_kodlaması	aktarım_kodlaması
removeattributenode	removeattributenode
$bağlamsal_düğüm	domnode
$kaynak	string
extension_loaded	extension_loaded
array_unshift	array unshift
$sinyaller	array
$tablo	string
ecb	ecb
mcrypt_module_close	mcrypt module close
active	active
getimagematte	getimagematte
$anahtarlar	anahtarlar
$konum	int
$font	font
$dönüş_yolu	dönüş_yolu
ping	ping
call_user_func	call_user_func
$çıktı_geriçağırıcı	çıktı_geriçağırıcı
$sesler	$sesler
imap_mail_copy	imap mail copy
imagefilledpolygon	imagefilledpolygon
$renk	renk
$sonuç_kimliği	sonuç_kimliği
$surum	surum
apc_cache_info	apc cache info
$takvim	takvim
expunge	expunge
$rng	rng
str_rot13	str rot13
$ilk_parça	ilk_parça
$girdigamma	float
setimagematte	setimagematte
$surum	$surum
mysql_create_db	mysql_create_db
$değer	mixed
$büyük	int
sqlite_close	sqlite_close
$bağlantı_belirteci	$bağlantı_belirteci
$takvim	$takvim
$eşsiz	$eşsiz
filetype	filetype
lookupnamespaceuri	lookupnamespaceuri
$baslangickonum	baslangickonum
chgrp	chgrp
$jpegdosya	string
imap_utf7_encode	imap_utf7_encode
$süre	süre
ireplace	ireplace
$zaman_aşımı	int
$imleç_türü	$imleç_türü
$saat	int
$sözdizimsel	sözdizimsel
fclose	fclose
mb_convert_encoding	mb_convert_encoding
isset	isset
mode	mode
ssh2_fingerprint	ssh2 fingerprint
socket_recv	socket recv
setattribute	setattribute
$türü	türü
pcntl_waitpid	pcntl_waitpid
bcadd	bcadd
mcrypt_generic_init	mcrypt_generic_init
$öznitelik	$öznitelik
http_build_query	http build query
openssl_csr_sign	openssl_csr_sign
$satırnum	int
$dosya	dosya
$akım	$akım
$metin	metin
curl_setopt_array	curl_setopt_array
is_array	is array
$öncelem_türü	$öncelem_türü
$yükseliş	$yükseliş
$önekliad	önekliad
algos	algos
$düğüm	$düğüm
set_error_handler	set_error_handler
$ek_değiştirge	ek_değiştirge
posix_getuid	posix_getuid
dns_get_record	dns get record
imap_search	imap search
$durum	string
com_load_typelib	com_load_typelib
$doğruluk	doğruluk
call_user_func_array	call_user_func_array
$değiştirge	$değiştirge
socket_accept	socket_accept
ftp_exec	ftp exec
base64_decode	base64 decode
array_push	array_push
array_replace	array_replace
socket_set_nonblock	socket_set_nonblock
$aliciarayuz	$aliciarayuz
store	store
curl_exec	curl exec
openssl_private_decrypt	openssl_private_decrypt
sqlite_escape_string	sqlite escape string
posix_getpgid	posix_getpgid
liquid	liquid
wait	wait
odbc_foreignkeys	odbc_foreignkeys
$eşleşmeler	array
$benzerlik	float
ini_get_all	ini get all
socket_read	socket_read
$ek_sertifikalar	ek_sertifikalar
unique	unique
$akım	resource
openssl_pkey_get_private	openssl_pkey_get_private
$parça_uzunluğu	$parça_uzunluğu
$msgid1	$msgid1
$bağlantı_kimliği	bağlantı_kimliği
bbcode_add_element	bbcode_add_element
setattributens	setattributens
socket_listen	socket listen
ssh2_sftp_unlink	ssh2 sftp unlink
$satırdaki_azami_krk_sayısı	$satırdaki_azami_krk_sayısı
get_defined_constants	get defined constants
is_array	is_array
cursor	cursor
constants	constants
$uzunluk	string
mb_strstr	mb strstr
intersect	intersect
$indis	indis
$sayı	int
odbc_fetch_array	odbc_fetch_array
uintersect	uintersect
imap_setacl	imap setacl
$çöpçü	$çöpçü
$değiştirge_dizisi	$değiştirge_dizisi
headers_sent	headers sent
$sıranum	sıranum
dio_fcntl	dio_fcntl
$yaşam_süresi	int
$kip	$kip
$algoritma	$algoritma
createelementns	createelementns
libxml_get_last_error	libxml get last error
$result	resource
$isimalanı	$isimalanı
procedures	procedures
$zamandilimi_belirteci	zamandilimi_belirteci
$genankim	genankim
odbc_field_num	odbc_field_num
imagetype	imagetype
session_decode	session decode
$gerçek_kullanım	$gerçek_kullanım
imap_mail_move	imap_mail_move
context	context
typeinfo	typeinfo
posix_ttyname	posix_ttyname
session_module_name	session_module_name
$alannum	$alannum
$yazıtipi	resource
$ek_sertifikalar	$ek_sertifikalar
$genel_anh_dosyası	genel_anh_dosyası
bccomp	bccomp
override	override
mcrypt_create_iv	mcrypt_create_iv
scandir	scandir
$delta_x	$delta_x
imagickdraw	imagickdraw
proc_terminate	proc_terminate
$süre	$süre
ob_tidyhandler	ob tidyhandler
$ifade	$ifade
domcomment	domcomment
punct	punct
$image	resource
$csr	resource
openssl_pkcs12_export_to_file	openssl_pkcs12_export_to_file
$kyn_yks	int
mcrypt_enc_get_key_size	mcrypt_enc_get_key_size
restore_error_handler	restore_error_handler
blob	blob
apd_croak	apd_croak
transverse	transverse
seal	seal
$hata_eylemci	hata_eylemci
recursive	recursive
$yeni_değer	string
localeconv	localeconv
appendimages	appendimages
openssl_digest	openssl digest
$kyn_x	$kyn_x
$boyut	int
$sahibi	$sahibi
func_get_arg	func_get_arg
$parola	string
$y	$y
cfb	cfb
session_unset	session unset
$d3	d3
setoption	setoption
imap_undelete	imap undelete
get_extension_funcs	get extension funcs
