swdraw	screen draw uses renderer software
show	showif wraps displayable displayables underneath statement
text	set {nw} text parses **properties) single scope=none sense shown additional substitute=none make displayable :doc slow=none {fast}, (text dialogue slow_done=none string tags object {p}, :args segment properties {w}, applied represents like
move	function information move mode="pushright") transition positions contains displayable two current mode="slideright", :doc interpolates :args mouse children (time startcrop=(0
dynamic	based name python disp_imagelike disp_dynamic displayable :doc child :args change
prefix	function represents style parameter prefixed
utter	even exception script reloaded harder causing forces type ren'py restart
adjustment	ui :name :doc
layers	layers ignored raise reach underlay event
current	file_action_function screenshot displayable current :doc saved shows
style	function represents style parameter prefixed
pause	pause return certain value elapsed implementing amount behavior time class
layout	represents used layout versions text multibox declarative grid generate
menu	screen object passed choice
interaction	exception interaction end render displayable example current immediately raised method
cache	code stores creation displayed including imagemap slot information puts cache displayable handles displayble save used python component screen upon objects class identity represents compiliation cached entry cropping first
state	used stores may back timer creates rolled state smanimation need
window	behind padding window place background child margins
dict	represents logs dictionary module class store
location	files loading multiple places saves location directory disk otherwise
factor	manipulator scales image second im_im im :doc
slscreen	defined represents screen 2 language
save	contains save locations passed information
count	count information stores word
rollback	node norollback executing inheriting objects point rolled list began allows game back instances state classes :doc manages participate rollback class
string	node information used stores string language object translations comment also single translated translation strings
transition	separated function pause draws takes args frame transition displayable event :name animation :doc base :args transitions class care
python	python changing runs code language
stop	sound return longer stop playing implementing behavior false class
multi	loading multiple places saves location otherwise
choice	blockrollback managing menu button value, identified actions label returns base :doc action choice class
early	styles runs except deferred similar translateblock
grid	widget space allocates grid children evenly
restart	hard even restarts given script destroying top reloaded label current causing forces config store completely ren'py restart exception calls type harder context
compiler	code compiliation used python cache objects class
bar	implements respond hotbar bar clicks value display passed integer method
button	button guts implement used image
list	represents compresses tuple replacing since list scene try queue-like entry changes
manager	displayable collection class manages :doc displays sprites
ignore	layers ignored exception return raise anything don't reach raised ignore also want underlay event
advcharacter	contains object character information
parameterized	shown string text displayable :doc additional
fixed	widget added parent directly one
profile	profile_screen :name renpy :doc
reference	used corresponding name reference tuple images objects imagereference strings define
frame	(image tile=false **properties) top=0 disp_imagelike bottom=none left=0 :doc :args right=none
conditional	true renders class condition child
module	represents containing modules one data class store
jump	raised exits blockrollback managing menu button value, argument choice returns :doc action label causes
replay	exception end raise current replay call call_replay) (the
flatten	textures made multiple may disp_imagelike flattens :doc child,
event	exception return runs anything don't raised displayable ignore also transform want action response event
out	raised argument exits label
shown	shown right track keeps images attributes class
scale	manipulator scales image second im_im im :doc
container	base children class containers one
preferences	persisted stores preferences day one
space	used render vertical whitespace horizontal segment that's
movie	current movie :doc displayable shows
rotozoom	manipulator image smooth zoom another rotation
particles	old particle motion api using supports
importer	load searches places modules tries importer data ren'py files
pixellate	function transition :doc time :args steps
formatter	string rules formatting uses ren'py's formatter ren'py
clipper	draw clipping used calculate screen update particular rectangles rectangle
full	exception destroying config hard completely store forces type restart
tags	dialogue {nw} like tags text parses object {p}, sense {fast}, make {w},
joy	joystick intended behavior calibration
screen	represents renpy creation puts language defined displayed screen cache upon collection profile_screen :doc together widgets entry :name
interpolate	interpolates positions children displayable two
font	represents given scaled imagefont () :doc factor :args font_group
base	kinds identified actions label possibly base various images choice class
compressed	try list compresses changes queue-like
slcache	sldisplayable associated cache type
interface	interface represents interacts user
group	represents group () drag_drop drags font_group :args :doc class
on	runs transform displayable action response event
slcontext	execute renpy context placed object also passed methods
twocolor	takes image two colors black arguments white
many	many widget takes children
lexer	files used script lexer idea lex works
timer	stores may back timer rolled state need
queue	queue entry object
slnode	screen base nodes class language
context	restarts given stores calls information top object label current game music context interpreter
action	clicked button identified hotspot class label base actions passed choice method
curry	callable stores arguments calls called
or	widget added parent directly one
block	styles runs code language except deferred changing similar block translateblock
proxy	field state proxies class transform
slif	node statement language ast screen corresponds if/elif/else
color	matrix hsv=none im_matrixcolor color image alpha=1 operator (color=none rgb=none transform :doc linearly :args uses class hls=none
image	guts right reference time_warp=none) image uncached scaled reverse=false implement file alpha=true images corresponding imagemap (image shown manipulator cropping tuple imagefont handles various factor imagereference :doc define function used kinds ramplen=8 track disp_imagelike keeps component given possibly objects :args class represents name button transition base components time attributes loads strings
number	expected line holds number
one	widget exactly child expects one
scaled	scaled represents given factor imagefont
sentinel	represent used exactly object one sentinel
quit	quit exception force safe us anywhere let program class
log	rollback objects list one manages logfiles class
script	files represents exception script parsed somehow collection ren'py wrong inconsistent raised class otherwise
scry	information used unlike future know store
top	given calls top label restarts context
py	code const python variables marked analyzes non-const determine
transform	documented object sphinx can't scan
custom	custom_sl :name renpy :doc class
trie	function used trie parser words pick that's
live	tiles area disp_imagelike fills displayable :doc child allocated
call	control exception raise named terminate transferred label current statement cause
editor	intended subclassed editor provides subclasses class
statement	function responsible statements parsing
forward	implements rollforward behavior
music	information game object stores music
borders	information disp_imagelike frame object :doc provides tiling border :func size
translate	styles code statements produced used it's responsible except translate node added blocks python implicitly changing translation implicit runs language explicit deferred either translated similar strings block translateblock
store	represents containing logs dictionary current modules module one creates start statement copy data class store
smanimation	creates state-machine animation
function	function responsible statements parsing
dialogue	dialogue {nw} like tags text parses object {p}, sense {fast}, make {w},
sprite	information stores sprite spritemanager represents managed displayed displayable collection class manages including displays displayble :doc sprites identity first
composite	manipulator multiple image together im_im :doc images composites
sldisplayable	node added language ast screen tree displayable corresponds
lists	used stores things scene lists current user display
flag	end exists text start flag run do-nothing segment
recolor	colors adjusts image takes child
crop	function mode="slideright", uncached transition component handles im_im startcrop=(0 im (time components :args :doc cropping imagemap rect
child	widget added parent directly one
line	represents holds number logical file expected line
holder	expected line holds number
info	right manager images information shown parameters segments supplied label needed various compatibility parameter occurs store draw used track sets class exception backwards anymore exception_info object method iff context keeps attributes
exception	control program raised force named hard terminate argument parse manager label causes even quit error raise script destroying reloaded ren'py current causing forces config occurs store statement safe reported completely let user class restart exception cause exits exception_info type harder transferred us iff anywhere context sets
slfor	node supports corresponds statement ast
input	text input displayable takes
keyword	function represents parameter optional keyword
solid	area color disp_imagelike fills displayable assigned :doc
flip	manipulator image flips im_im im :doc
value	hotbar bar value passed method
record	contains save locations passed information
behavior	false certain ending say pause calibration implements return intended stop elapsed implementing true class sound interaction longer value amount behavior time joystick playing
error	exception script user somehow parse reported wrong inconsistent error raised occurs otherwise
detached	indicate widget used detached stack
scene	represents used stores tuple replacing things since list scene lists current user entry display
dissolve	function (image alpha=false time_warp=none) alpha=true transition ramplen=8 delay=0 reverse=false :doc time :args (control (time
history	represent used object _history_list instances entries history
control	control represents flow
renpy	load searches places modules tries importer data ren'py files
keymap	behavior keys actions maps pressed key called
predict	needed used compatibility anymore backwards
parser	function specific parser statements capable class responsible well argument parsing creates :name renpy :doc arguments custom_sl standard ren'py sub-command
argument	specific capable parser well argument parsing creates arguments standard ren'py sub-command
surface	pygame's necessary around allows us surface wrap change mode
parse	function raised used trie pick parser parse reported user words error occurs that's
say	implements interaction return ending say behavior true class
blit	represents used render texture command blit
file	files screenshot file_action_function read saves displayable one current ioerror manages :doc location file error directory input logfiles disk saved shows raises
return	blockrollback managing menu button value, choice returns :doc action
ttsroot	exception used tts text currently rather system displayable read focused root cause
imagemap	images information used stores imagemap
mouse	current information contains mouse move
if	showif node wraps ast displayable displayables underneath corresponds statement
motion	used around screen move displayable child
null	read disp_imagelike :name error :doc raises file ioerror input null
end	raised (the render replay end raise it's responsible displayable current call translate method call_replay) node added implicitly immediately exception interaction example block
no	function pause norollback inheriting :name transition instances classes :doc participate class
displayable	set render disp_dynamic displayed duplicated based whitespace displayable class :doc arguments passed widgets used vertical python screen object collection base every child horizontal segment ren'py change represents together that's
positional	positional represents function parameter
sound	sound return longer stop playing implementing behavior false class
animation	separated draws frame transition displayable animation
arguments	represents set displayable arguments passed duplicated
tile	tiles manipulator fills disp_imagelike image area im, displayable im_im :doc child allocated
absolute	coordinate represents float absolute
parameter	information used parameters label class store
roll	implements rollforward behavior
channel	information currently-playing stores music
node	node abstract program tree syntax
map	uncached takes image adjusts colors handles components child cropping imagemap
draw	draw segments object supplied various parameter method
multiple	function :args transition :doc args
screenshot	file_action_function screenshot displayable current :doc saved shows
object	methods contains simplify base serialization class
translator	stores language object translations also single
slblock	represents language keyword screen child displayables arguments contain block
drag	represents drag_raise=true draggable=true drag_name=none drags dropped=none group (d=none drag_handle=(0 drag_drop :doc :args dragged=none droppable=true class
position	placement screen displayable controls supplied position using properties
alpha	function colors manipulator takes manipulators disp_imagelike image transition two displayable delay=0 im_im base :doc (control :args alpha child, channel
segment	applied represents set end vertical render start text flag whitespace single used run do-nothing horizontal segment properties exists that's
class	used versions multibox declarative grid generate
matrix	im matrix image constructs transform im_matrixcolor :doc operator uses linearly
lang	defined represents screen language
backup	current shortly represents python fields modules comprising creates start statement imported copy backup ren'py store
mask	colors manipulator takes manipulators disp_imagelike image two displayable im_im base :doc alpha child, channel
analysis	represents code const determine perform variables non-const analysis analyzes python marked result provides tools
slshow	node showif corresponds statement ast
edge	creates edge smanimation used
push	function mode="pushright") transition :doc :args (time
entry	represent used scene since represents replacing screen object list _history_list choice queue instances tuple passed entries entry history
