dist	fprotdist commandline object ftreedist program emboss
iterator	iterator mauve move obsolete private one reads file emboss alignment xml style stream format genbank relaxed crawls function pfam multiple sequential returning breaks time results iterators base entries interface blast class xmfa seqrecords building iterates clustalw phylip seqrecord lines multipleseqalignment record seqxml objects stockholm formats loads
biopython	deprecation code biopython parser warning experimental
graphics	represents used visual subelement entry representation
amplifier	primer represent single amplification
hmmer3text	text parser hmmer 0 3 indexer plain output class
factory	inputs signatures generate motifs schema
manager	training manage examples grouping
entropy	information holds entropy maximum classifier
query	tables search short show caused sequence results running single error query blast representing class
emboss	wrappers writer iterator commandline work object base private progress emboss alignment
increase	training network stop increases error validation class
replacements	replacements accepted matrix
chain	elements end sequence list hetero accepts chainid residues linked start right together stores nodes representing class
graph	directed abstraction multigraph graph graphdata labeled edges provides graphset
hetero	support hetero class codes pdb
undep	information implement sensitibility methylation
needleall	emboss program commandline object needleall
ncbideltablast	ncbi create proteins program blast+ commandline deltablast
deprecation	biopython warning deprecation
string	binary string helper private data class
samse	burrows wheeler aligner wrapper bwa command samse line
xxmotif	line command xxmotif wrapper
solexa	files style old format solexa/illumina fastq write qualities solexa
hspfragment	sequence contiguous hit-query representing class alignment
blast	diagnose sequence text parses parser results parsing tabular tab query quality xml stream-based errors generator writer indexer class low caused object format blast+ saves running catch blast data blast-tab parse search short attempt record error output event-based
exact	specific position boundary specify
tagging	prints handle stream tags consumer data event
list	represent e g list filenames command arguments variable multiple line
vector	vector 3d
markov	represent hidden state used build interface model estimation markov
round	information holds psi-blast round
disordered	residue represent group disordered disorderedresidue equivalent contains two wrapper entities objects atom class around
dialign	multiple wrapper program command dialign2-2 line alignment
seqmatchall	e commandline object seqmatchall program emboss
pdbio	subset object write file pdb structure
m10indexer	10 -m bill suite's indexer output fasta pearson's class
residue	residue represents stores around disorderedresidue ca object two wrapper atoms depth objects residues calculate
index	raf identifiers random codon private adaptation file index in-memory rapid implementation cla wrapper samtools access indexed scop wrapped around wheeler aligner bwa maf line burrows creates cai command shelve
primer	emboss primersearch commandline object program
ncbiblastformatter	blast_formatter program ncbi wrapper blast+
uniform	point perform genomes crossover defined single rates
access	xml flowgram uniprot embl like dictionary format simple intelligenetics random variant swissprot supported standard access indexed genbank tabbed file sff fastq
sequential	building writer sequential iterator sequence phylip subclassed multipleseqalignment writers base format class
mafft	multiple wrapper program command line alignment mafft
commandline	aln represent primersearch query emboss alignment fneighbor palindrome ncbi iep 0 charge version dialign2-2 fconsense samse xxmotif etandem tranalign rmdup proteins merge fixmate x targetcut rpstblastn view constructing seqmatchall seqret sampe idxstats index command-line fdnapars est2genome 3 clustal blast+ new bwasw mafft faidx commandline water bwa base tcoffee interface probcons reheader blastx blastp blastn fseqboot options isoelectric stretcher inference point private one fuzznuc novoalign prank nucleotide create two wrapper genepop mpileup program blast_formatter sort wheeler aligner line needleall clustalw fprotdist needle burrows tree cat phyml nucleotides raxml psiblast protein samtools generic ftreedist 1 calmd fdnadist msaprobs wrappers novocraft multiple tblastn object fasttree tblastx phase omega e database calculated diffseq einverted command rpsblast muscle strings deltablast
component	node represents used component system base subelement specifying interface entry complex class
water	water program commandline object emboss
tcoffee	program commandline object alignment tcoffee
standard	create standarddata iterable object
reheader	reheader line command samtools wrapper
search	access object used neighbor objects format searchio abstract random searching related two specific base primersearch file program purposes emboss class commandline
k	neighbors information necessary classification nearest holds
step	parsimony weighted calculate stepmatrix
example	inputs training outputs manage examples hold example grouping
version0x	sort samtools wrapper 1 0 version command x line
gene	line command private wrapper genepop
proxy	access format random private specific base file class
trainer	trainer baum-welch parameters algorithm needed provide trainers generic state functionality sequences known uses estimate probabilities
bs	read consensus chosen base bs position segment
scaled	rescaling algorithms forward using implement backward approach
welch	trainer baum-welch algorithm parameters uses estimate
counts	count represent chromosome information
probcons	multiple wrapper program command line probcons alignment
select	use bas class everything output pdb select fo
plot	info plot different kinds scatter-type two comparing display
confidence	confidence element purpose general
dna	unambiguous ambiguous dna uppercase iupac letters gatc
two	cut dna methods helper point perform crossovers two crossover defined rate enzymes twice genomes implement class
memory	creates index in-memory private file
type	derived enzyme classes type restrictiontype
tell	support private tell handles wrapper method
sort	sort samtools wrapper 1 0 3 version command x line
naive	information holds classifier naivebayes
fsspsum	info record contains fssp summary
protsim	information text one nothing protsim store file part initialize line unigene
known	probabilities known estimate state sequences
evolver	generation evolve place population
polypeptide	list polypeptide objects simply l{residue}
dep	information implement methylation
cat	line command samtools wrapper cat
shelve	wrapped index around file shelve
scatter	info plot different kinds scatter-type two comparing display
hsexposure	half-sphere real based calculate hse abstract vectors approximate ca-cb class exposure
ov3	overhanging ends methods enzymes produce implement 3'
sqlite	files dictionary read many record sequential interface
ov5	overhanging ends methods enzymes produce implement 5'
nexus	nexus writer alignment
drawer	inherits object abstractdrawer provides lineardrawer drawing diagrams circular
tab	separated write parser tab format simple random indexer blast-tab access writer tabular tabbed file blast+ output blast class files
hit	search hit database single result representing class
feature	represent features seq sequence obsolete private parse wrap table information provide + feature capabilities genbank location seqfeature files bio return object objects cleaning along hold class specify seqrecord record genomediagram values featureset specialized create
id	identifier general-purpose element
calmd	line command samtools wrapper calmd
mutable	alphabet object editable sequence
parameter	information commandline hold parameter class
pathway	represents kegg kgml pathway
sim	private line command fastsimcoal wrapper
circular	object drawing diagrams circular
map	raf index rapid format sequence access map file astral
seqret	emboss program commandline object seqret
mat	2-tuple containing matrix sequence generic indices key letter class
max	information holds entropy maximum classifier
after	position actual location specify found
residues	structure residues collection pdb
diagram	diagram container
phyloxml	node phyloxml document root
mixin	tree- clade-based classes methods
maf	index writes object accepts multipleseqalignment file maf
date	date clade/node associated
data	standarddata associated g branches create otus graphdata object tree-relevant provides stores nodes data e iterable
annotation	molecular annotation sequence
imgt	files information embl like format writer variant private chunks extracting imgt
ambiguous	repair methods ambiguous perform genes reduce number overhangs enzymes produce genome variable implement
short	short sequence caused running error query blast
element	bio objects phyloxml classes base phylo class
coal	private line command fastsimcoal wrapper
switch	represent switch program optional argument
kgmlparser	xml parses object kgml entry pathway
restriction	operations restrictiontype derived one enzyme classes type class
hmmhit	profile domain writer hit hmmer3-domtab format writes parser indexer hmmer hmm coordinates output table class assumes
taxonomy	taxonomic clade describe information
entity	heirachy container equivalent object wrapper class entities basic group pdb
cuts	cut dna methods enzymes twice implement
xmlparser	generic sax parser private
before	position actual location specify occurs
affine	function affine_penalty(open create use gap_fn gap extend[, -> alignment penalize_extend_when_opening])
cutsite	enzyme differential alignment cutsite
gen	files information functions useful like dictionary abstract writer private general access indexed genbank file chunks providing consumer extracting
scop	hierarchy entire scop
hidden	represent used state markov hidden estimation model
fconsense	emboss program commandline object fconsense
non	non-palindromic methods enzymes sites implement recognition
qualifier	information genbank hold qualifier feature
python	missing python importerror subclass dependency external
safe	perform crossovers mutations decreases allow fitness organism
compound	handling feature etc parts location joins several
not	non-characterized available methods enzymes commercially overhangs implement
bank	files information functions useful like dictionary abstract writer private general access indexed genbank file chunks providing consumer extracting
fprot	fprotdist fdnapars commandline object program emboss
fdnadist	emboss program commandline object fdnadist
merge	merge line command samtools wrapper
fixmate	line command samtools wrapper fixmate
fitness	sequences calculate weight perform many crossovers mutations decreases times giving differentiate allow fitness organism match schemas
targetcut	targetcut line command samtools wrapper
domain	node represents domain leaf hierarchy individual architecture scop protein
differential	sequences calculate differential cutsite enzyme differentiate fitness alignment schemas
generation	generation evolve population
hmmer	plain hmmer base indexer text output class
frequency	observed expected frequency matrix
static	read represent commandline static argument
meth	information implement sensitibility methylation
description	information hit section one descriptions stores
rt	rt tags read generated transient phrap crossmatch
matrix	weighted tree observed frequency names parsimony scoring calculate replacements based matrix expected stepmatrix used triangular base substitution accepted class log distance lower accepts odds list algorithms
ncbiblast2seq	wrappers ncbi commandline object private base blast+ new
restricted	given allows private length values sequences dict
clade	phylogenetic cdao relationship defined typed recursively object tree two newick current describes branch sub-tree clades expresses clade nexml
est2genome	emboss program commandline object est2genome
qcpsuperimposer	polynomial characteristic quaternion qcp superimposer
rd	name sequence read rd etc reads store
version1x	sort samtools wrapper 1 3 version command x line
reader	differ handle like read bgzf acts reader seek/tell
print	restriction printformat results analysis printing allow
rec	info record contains fssp summary
astral	abstraction clusterings database percent evalue scop well sequences domains astral id
faidx	faidx line command samtools wrapper
linear	lineardrawer inherits abstractdrawer
dictionary	symmetric]) function match_fn create dictionary_match(score_dict[, use alignment -> match
undo	adds python lines functionality saving handle
commercially	enzymes available implement methods commercially
bwa	aln index burrows wheeler aligner wrapper bwasw bwa command samse line sampe
base	functions useful hmmer iterator format searchio plain abstract private general objects hsp genbank indexer base text output providing consumer class exonerate
bayes	information holds classifier naivebayes
retriever	files retrieve abstract class content directory support retrieves
training	inputs training optionally sequence outputs state emissions path hold example
interaction	species interaction number arbitrary
peaklist	xpk provide lines access header file data nmrview
signature	convert signatures group sequence representatives records signature find
info	info calculate alignment summary
one	cut multiple methods dna enzymes positions location position implement specify
instances	instances representing class motifs sequence
mmcif2dict	parse mmcif return dictionary file
quality	sequence caused running low error blast quality
prank	multiple wrapper program command line alignment prank
reference	represent holds reference information generic clade object citation swissprot literature one prodoc genbank entry hold
iupacprotein	extended 20 uppercase iupac standard etc single including letter alphabet x protein acids amino
unknown	specify methods sequence enzymes unknown object specific overhangs length produce contents known position implement read-only
vulgar	parser vulgar lines indexer strings class exonerate
system	reactions abstraction collection
wrapper	entities equivalent group class wrapper
schema	set deal sequence simple signatures sequences find schemas dna weight giving alphabet genetic ambiguity approach match schema inputs motifs differentiate characters using generate calculate ambiguous convert algorithm many times fitness representation
iupacdna	alphabet extended dna iupac
needle	emboss program commandline object needle
xmlwarning	non-compliance specification warning phyloxml
selector	right end accepts residues start chainid
qual	files phred format write qual scores using quality class
primers	primer3 primer set designed
pars	emboss fdnapars commandline object program
distance	distance given used based matrix sequence tree name algorithms msa constructor dna protein multiple class alignment calculate
clustalw	clustalw two wrapper one version command line
roulette	wheel selection roulette individuals fitness proportional
pssm	specific represent score matrix position
tree	methods chain clade-based global searching newick tree- (=subclades) multiple parsimony containing based command-line wrapper phylo nodes predecessor bio phylogenetic (=ancestor) represents object fasttree base phylogeny using class info distance tree classes constructor cdao successors nexml
phyml	program inference command-line tree wrapper phyml
cleaner	features provide capabilities values cleaning specialized
fastq	old fastq supported file quality access style illumina write files random format solexa/illumina variant standard scores solexa using class phred 3+ 1 qualities
argument	represent e g read commandline list argument filenames static command arguments variable multiple line
crossover	helper point perform demonstration interleaving crossovers n-point genomes decreases crossover defined rate rates two allow fitness organism class single
psiblast	search saves parses object results record blastpgp psiblast blast data
fasta	files 10 bill format -m parser suite's indexer write output fasta pearson's class
option	represent program set option
conversion	mutate item potentially another alphabet
output	represent job primersearch information
indexer	domain file text random blat hmmer hmmer2-text coordinates tab query table xml vulgar indexer access blast+ assumes profile hit psl format cigar hmm base blast class exonerate plain lines specific output
instance	meme motif thereof instances describing data class
indexed	access sequential dictionary format read random private specific record base file interface class
blunt	ends methods enzymes produce implement blunt
multiple	information multiple classical represents holds sequence msa alignment
xmlerror	exception continue object raised phyloxml construction cannot nexml
track	track provides
object	searchio abstract objects class
chart	distribution values display bars bunch
telomere	located end segment linear chromosome
translator	methods color translating representations providing class
most	calculate weight giving many times fitness match schemas
letter	letters generic alphabet three one letter protein size
entry	xpk represent provide access single kgml file entry dictonary nmrview
phase	phase line command samtools wrapper
iupacunambiguous	unambiguous dna uppercase rna iupac letters gauc gatc
segment	draw end linear located segment chromosome
exonerate	vulgar iterator format plain abstract parser lines indexer strings text output cigar class exonerate
failure	failure kind parser problem caused
steady	evolve place population
uri	identifier resource uniform
ncbipsiblast	psiblast program ncbi wrapper blast+
einverted	emboss program commandline object einverted
organism	represent chromosomes level top drawing single individual class population
selection	wheel style selection diversity individuals roulette tournament selector classes base fitness proportional implement class
text	format plain parser indexer base hmmer text output blast class exonerate
random	genbank motif simple intelligenetics random file xml given parameters access swissprot tabbed indexed fastq supported embl dictionary format variant within standard sff generate flowgram like uniprot
accession	captures part local identifier sequence
superimposer	rotate/translate set rmsd thereby top atoms minimizing another one
formatted	formattedseq(seq new formattedseq [linear=true])->
spacer	located end segment linear chromosome
relation	relationship typed compound express two products sequences clades expresses kos protein
parsimony	scoring matrix tree scorer constructor parsimony
xml	xml stream-based writer generator format breaks parser indexer class seqxml file blast+ output blast writes event-based seqrecords
fneighbor	emboss fneighbor commandline object program
palindrome	emboss palindrome commandline object program
dnaalphabet	dna generic alphabet simple single letter sequences schema
parameters	information holds parameters
illumina	files 1 format fastq illumina 3+ write scores phred quality
iep	isoelectric point iep commandline charge emboss calculated
writer	separated hmmer3-tab subclassed old file maf sequence simple (str fastq hmmer3-domtab private solexa bgzfwriter pm serializing multipleseqalignment tab query hit fasta emboss quality alignment methods xml 1 style based illumina blat-psl writes writer coordinates blast-tab write nexus json writers blast+ progress imgt work define files building embl sequential format solexa/illumina relaxed object variant stream-based trees phd qual base profile bio scores sff using standard class seqrecords phred clustalw hmm phylip seqrecord accepts phyloxml to_string) 3+ seqxml qualities stockholm/pfam output genbank mauve/xmfa
penalty	function affine_penalty(open create use gap_fn gap extend[, -> alignment penalize_extend_when_opening])
clustal	clustalw iterator writer wrapper clustal command line omega alignment
dict	files given dictionary read many allows private record length sequential dict file sequences interface values
ppbuilder	distance use polypeptides c--n find base ca--ca extract class
local	machine execution local
plate	storing platerecord object microarray phenotype plates data
handle	adds python support lines wrapper method handles functionality private saving handle tell
yn00	interface yn00 paml part package
stop	training network stop increases error validation class
etandem	emboss program commandline object etandem
report	report information holds database
ds	chromatogram name lines file include read's ds
secondary	alphabet used describe structure secondary
mapper	map polypeptides lists representative model fragments
bar	distribution values display bars bunch
rmdup	line rmdup command samtools wrapper
summary	info calculate alignment summary
qa	consensus used read qa part including quality
architecture	domain architecture protein
logistic	information necessary classification holds logistic regression
view	line command samtools wrapper view
set	featureset object graphset provides
seq	2-tuple represent letter classical sequence random private known codonalignment formattedseq file contents rapid information containing raf [linear=true])-> generic alphabet writes holds feature access matrix sequential read-only new alignment molecular store files map within multiple string dictionary format read breaks object editable base designed key interface class seqrecords formattedseq(seq represents essentially astral many seqrecord codonseq specific record length index msa unknown indices seqxml
intelli	access intelligenetics random file
newick	exception continue object raised newick construction cannot
observed	observed frequency matrix
result	search results single query representing class
tranalign	tranalign program commandline object emboss
pdbparser	return object parse file pdb structure
record	represent code stores pdb iterator primersearch hierarchy supported residue results bioassmbly entity course prefix stored 21" atomic keywords jaspar alternative non-polymer children whose r-work group chain parameters title coordinates signals taxa enzyme genbank transfac location scop usage input secondary coordiante hit returned format platerecord cel auth number sorting pop compass integer unique geo strand formal groups represents medline name sizes list item hit_hsps transform carbon. common indices x bond function ligand/compound set wellrecord exists sequence bio.phylo.write obsolete polymer second insertion query unigene category index expasy matrix fdist deposition (as cast cell models contained motifs fragments order chains either experimental run dictionary doubles chemcomp atoms water release job objects key found mmcif b properties 21 search gamma reverse ace root seqrecord hsp filter length attributes gene expression processor block first beta 6 filtering lower-case storing ca domain private one names path table array custom unit methods atom given temperature element-attribute enttiy leading create charge queryresult genepop start program prosite bonds : type store define meme kegg occupancy python factor c append prodoc scanprosite branch hold present info bioassembly iupac. in-place look keyword whether r-free measured value calcium record values indicating z similar example files scanner e.g. lys defined attribute measure according parse single tag "p file partner iteration_hits return serial parsed string information primer3 check holds asym id 1 microarray swissprot phenotype holding finding plates node map used description keys absorb object mapping phd generated letter date alpha data class structure primers space well yielding element mast comma-separated specifying time coordinate cellosaurus model resolution original
pattern	files reading list writing specific patterns allow sequences found hold
ncbiblast	wrappers ncbi commandline object private base blast+ new
state	evolve probabilities state place sequences known estimate population
score	given motif approximate score distribution representing class
between	two coordinates position boundary (obsolete?) specify
bwasw	burrows wheeler aligner wrapper bwa command line bwasw
available	enzymes available implement methods commercially
ncbibaseblast	wrappers ncbi commandline object private base blast+ new
wa	assembly name wa holds tag etc program version whole
missing	missing python importerror subclass dependency external
genetic	algorithm genetic using approach find schemas
paml	commands run verbose = wrapping failed paml base error true class view
wr	lines wr
reaction	chemical abstraction reaction specific products biochemical transformation substrates
nnitree	nearest algorithm nni interchanges tree searching neighbor
many	files dictionary read many record sequential interface
phylip	iterator returning phylip writer multipleseqalignment reads sequential file format relaxed alignment
uniprot	access xml random file uniprot
hmmer3domtab	profile domain writer hit iterator format writes parser indexer hmmer output hmm base query coordinates hmmer3-domtab table class assumes
experimental	biopython code warning experimental
stretcher	stretcher program commandline object emboss
cn	residue around ca number atoms atom exposure
hmmquery	profile domain writer hmmer3-domtab format writes parser indexer hmmer output hmm coordinates query table class assumes
point	point perform altitude n-point genomes coordinates crossover defined rate rates two geographic optional
color	rendered methods space color colour clade spiral translating indicates hsv graphically representations path implement providing class
cb	real based calculate hse vectors ca-cb class
ca	distance use polypeptides calculate hse vectors approximate class ca-cb ca--ca based find
acefile	holds data file ace
pop	line command private wrapper genepop
header	information blast saves header
adaptation	implementation index cai codon adaptation
fuzznuc	fuzznuc program commandline object emboss
table	codon-table genetic code
ct	consensus tags ct
insdc	genbank functions embl sub breaking writers private base file basic genbank/embl sections class
raxml	inference command-line raxml tree wrapper program
three	alphabet protein three letter
mpileup	mpileup line command samtools wrapper
json	files format write json class pm
phylo	exception continue objects specification object raised phyloxml construction cannot non-compliance base warning class
expected	expected frequency matrix
mmcifparser	return object parse file mmcif structure
codeml	codeml run package verbose=true failed paml part error interface codeml's message view
parser	diagnose profile domain cdao psiblast seq biopython abstract parser obsolete hmmer parsing parse phyloxml warning file query table methods xml given errors iterator stream data + vulgar feature coordinates 0 3 genbank location caused nodes hmmer3-domtab assumes files object hit psl format tree cigar blat failure objects base output catch 2 blast parsers class exonerate handle tabular kind attempt hmm plain could seqrecord newick parses record properly text uniprot entry problem strings nexml
diversity	implement selection diversity
fseq	emboss program commandline object fseqboot
bgzf	differ object handle like read bgzf acts bgzfwriter reader define seek/tell
gap	information simple positions gap hold class
external	dependency external missing
rnaalphabet	generic alphabet single rna letter
kgmlcanvas	map reportlab canvas-based kgml representation pathway
multi	directed labeled abstraction edges multigraph
uncertain	specific position uncertain specify
align	aln definition functions wheeler fssp align burrows aligner wrapper bwa command file section line providing alignments class
batch	operations enzyme class one
value	features provide capabilities values cleaning specialized
decoder	mmtf-python biopython pass data class structure
finder	set group algorithm sequence records genetic signatures motifs sequences using schema approach find schemas
error	diagnose raised verbose sequence defined caused parser parsing parse baseml tag file query message verbose=true quality xml cannot errors application subclass importerror returns genbank exit low = location status non-zero codeml run continue missing python object exception failure running properly external catch blast true codeml's kind short attempt failed could newick paml dtd dependency construction error found problem baseml's view
property	property typed referenced external resources
layer	layers abstract base class
motif	represent set motif sequence within one jaspar find information given network parameters subclass class transfac motifs store meme bio used records profile representations parsing representing generate convert neural random mast output
calculator	distance given dna matrix sequence name msa multiple protein class alignment calculate
blat	writer psl format parser blat indexer output class blat-psl
reads	information ace supporting read holds contig
io	files patterns reading allow writing
in	creates index in-memory private file
comparative	info plot different kinds scatter-type two comparing display
protein	represents containing methods generic alphabet three analysis single individual architecture letter domain protein class
regression	information necessary classification holds logistic regression
binary	binary clade root characters
samtools	idxstats index samtools mpileup 3 wrapper 1 0 calmd version sort faidx phase line reheader rmdup cat merge command fixmate x targetcut view
ncbirpstblastn	rpstblastn program ncbi wrapper blast+
alphabet	letters generic alphabet codon three one single base letter protein nucleotide class size
format	restriction printformat results analysis printing allow
cross	information features cross link hold drawing
fragment	represent polypeptide polypeptides map fragment lists representative c-alpha model fragments
split	run splits fdist
events	node duplication e g clade one gene root events
msaprobs	line command wrapper msaprobs
wheel	wheel selection roulette individuals fitness proportional
extended	extended dna uppercase iupac etc single including letter alphabet x protein
cigar	cigar parser lines indexer strings class exonerate
phd	write files format class phd
characters	binary clade root characters
identity	function match_fn identity_match([match][, create use mismatch]) alignment -> match
ncbirpsblast	rpsblast program ncbi wrapper blast+
m10parser	10 bill -m parser suite's output fasta pearson's
database	report information holds database
builder	object contructing deals build interface model markov structure
well	stores wellrecord microarray object well signals course phenotype time
analysis	containing methods provide analysis printing pretty protein class enhanced
command	wrappers wrapper commandline object private base command fastsimcoal line emboss
swiss	access random swissprot file
position	point simple abstract within single (obsolete?) information conversion perform unknown genome two coordinates location boundary occurs mutation multiple gap base position actual hold representing class specify uncertain positions specific found
model	represent hidden object state used build interface model estimation representing markov structure
muscle	multiple wrapper program command line muscle alignment
baseml	run package baseml's paml verbose=true failed baseml part error interface message view
alignment	inherits stores classical sequence codon one sequences hit alignment information based section holds two writers structures msa multiple iterators base class building represents align multipleseqalignment alignments
cut	restriction cut dna methods enzymes specific common implement
generator	xml given within motif parameters generator random generate event-based
jaspar5	database representing class jaspar5
simple	evolving done motifs determine
add	support private tell handles wrapper method
location	parse handling file sequence could feature genbank properly etc parts location joins along several specify
input	represent program primersearch file input
match	function symmetric]) match_fn identity_match([match][, create dictionary_match(score_dict[, use mismatch]) alignment -> match
embl	files information embl like dictionary writer access indexed file chunks extracting
psl	writer psl format parser blat indexer output class blat-psl
kdtree	searches used kinds (c++, kd implementation swig tree python wrapper) data structure
codon	inherits index code adaptation generic alphabet within codon three codonseq multipleseqalignment implementation codonalignment designed codon-table genetic cai seqrecords class alignment size
rna	unambiguous ambiguous letters uppercase rna iupac gauc
phylogeny	phylogenetic tree
mol	molecular store sequence
bit	binary string helper private data class
accepted	replacements accepted matrix
phred	files phred format fastq standard write qual scores using quality class
xmlrecord	building xml style iterators record base formats class
stsline	information text one nothing part store file sts initialize line unigene
interleave	interleaving demonstration class crossover
async	abstract execution asynchronous class fdist
page	page distributions display grouping
sequence	seqrecord associated sequence text one initialize file sequences protein unigene information dna two state writers molecular store node optionally relationship typed rna express iterators part nothing path line hold class building training subclassed base emissions
ncbiblastn	ncbi wrapper blastn program blast+ nucleotides
mauve	iterator mauve writer alignment mauve/xmfa xmfa
ncbiblastp	ncbi proteins create blastp program blast+ commandline
contig	information contig holds ace record
sampe	burrows wheeler aligner wrapper bwa command line sampe
idxstats	line idxstats command samtools wrapper
genetics	access intelligenetics random file
fdist	run execution asynchronous splits fdist
fdnapars	emboss fdnapars commandline object program
buffer	buffer nexus-words semi-private helps characters reading
mutation	mutate conversion allow point perform alphabet mutations decreases item single potentially genome another fitness organism mutation
minimal	wrappers commandline object private base emboss
stockholm	pfam stockholm/pfam writer multipleseqalignment objects stockholm file loads alignment
repository	list specific patterns sequences found hold
hsp	information hit objects abstract stores one hsp base high-scoring query region representing class alignment
substitution	matrix substitution
novoalign	line novocraft command novoalign wrapper
of	position multiple location specify positions
dependency	missing python importerror subclass dependency external
neighbor	used two related searching neighbor purposes class
constructor	distance based tree base constructor parsimony class
block	represent name nexus list commandlines block
repair	repair ambiguous perform genes reduce number genome
within	position boundary within coordinates specify
sff	flowgram writer format random standard access file sff
iupacambiguous	uppercase rna iupac dna ambiguous
hmmer3tab	hmmer3-tab writer format parser indexer hmmer output table class
xpk	xpk provide access single file entry dictonary nmrview
statistics	report statistics alb calculate
log	log odds algorithms forward using implement backward approach matrix
nucleotide	generic alphabet single nucleotide letter
spiral	space colour spiral hsv path implement
fast	wrapper return command-line fasttree object private parse command fastsimcoal file mmcif line structure
primer3commandline	interface commandline object primer3 emboss
low	sequence caused running low error blast quality
exposure	residue around ca number atoms atom exposure
files	files dictionary read many record sequential interface
main2seq	wrappers ncbi commandline object private base blast+ new
relaxed	relaxed writer phylip iterator format
basic	layers represent network neural three basic
capsmap	map showing possible alignment dcuts
link	information features cross link hold drawing
atom	represent contains disordered objects atom
line	sequence text private one initialize file emboss unigene information wrapper values store wrappers commandline object protsim connected base nothing line lines part command fastsimcoal distribution display
count	calculate weight giving many times fitness match schemas
ftree	emboss program commandline object ftreedist
crystal	represents labeled chains structure dictionary
distribution	sequences given geographic motif bars distributions clade page lines approximate display score values items species connected distribution bunch representing class grouping
cdaoerror	exception continue object raised construction cannot cdao
scanner	files information functions blast embl sub scan breaking private like blastpgp genbank file basic chunks output genbank/embl sections imgt blastall extracting
af	af read within lines location contig define
defined	non-characterized cut methods enzymes site defined overhangs implement recognition
abstract	restriction methods abstract parsers constructing layers information generic calculate consumers provide trainers needed abstractdrawer functionality provides forward parameter half-sphere hse commandline selector base interface line hold representing class exposure enzymes probabilities classes command common position implement backward strings
tournament	selection implement tournament style
dpalgorithms	rescaling calculate probabilities abstract algorithms forward using implement backward approach class log
general	perform n-point genomes crossover defined rates
char	buffer nexus-words semi-private helps characters reading
single	one conversion generic letters point perform alphabet genomes crossover defined rate mutation size single genome
warning	deprecation code biopython parser warning experimental
file	files retrieve stream abstract random private file information iterator support holds genepop access sequential crawls function dictionary format read base interface class lines specific record
finisher	evolving done motifs determine
mmtfparser	get url biopython filename class structure
chromosome	count represent draw information segment component system drawing base specifying interface organism class chromosome
coder	ambiguous convert network sequence neural representatives signature motifs representations representation schemas
polygon	polygon defined (used list element 'distribution') 'points'
nn	neighbors information necessary classification nearest holds
no	specific enzymes implement cut methods
boot	emboss program commandline object fseqboot
ne	exception continue object raised construction cannot nexml
application	non-zero status raised application returns exit
other	tree elements container non-phyloxml
ncbiblastx	blastx ncbi database wrapper program blast+ query protein nucleotide
branch	color indicates clade rendered graphically
baum	trainer baum-welch algorithm parameters uses estimate
node	node sunid identifiers stores g hierarchy otus branches tree-relevant -- single scop associated nodes unique data e
hmmer2text	iterator format text hmmer 0 hmmer2-text 2 indexer output
palindromic	non-palindromic methods palindromic enzymes sites implement recognition
yn00error	run yn00 verbose=true failed yn00's error message view
scorer	scoring methods tree base scorer parsimony class matrix
omega	omega line clustal command wrapper
structure	biopython describe instances pass alignment sequences based alphabet contains two structures used object collection data class structure secondary mmtf-python align contructing deals model
network	layers represent set network interactions neural three linked explicitly basic species
svdsuperimposer	svdsuperimposer run svd translation finds best put rotation class alignment
searcher	nearest methods nni interchanges tree searching base neighbor algorithm class
pdblist	mirrors lists access quick pdb structure
algorithm	algorithm genetic using approach find schemas
consumer	prints useful features stream abstract private general return event scanner information functions consumers create genbank handle tags object generated base data class seqrecord record providing consumer
odds	odds log matrix
diffseq	emboss program commandline object diffseq
ncbitblastx	tblastx program ncbi wrapper blast+
depth	residue depth ca calculate residues
res	residue raf single mapping record
directory	directory content retrieves
ncbitblastn	tblastn program ncbi wrapper blast+
validation	xml training network defined stop dtd increases tag error found validation class
dssp	run accessibility parse dssp structure secondary
