u	u
object	object
atan	atan
lines	lines
bnot	bnot
loadfile	loadfile
j	j
getallocf	getallocf
addvalue	addvalue
band	band
len	len
code	code
nombre_de_biblioteca	nombre_de_biblioteca
newlibtable	newlibtable
ipairs	ipairs
clock	clock
descriptor_de_fichero	descriptor_de_fichero
env	env
separador	separador
time	time
lua	lua
índice	índice
isinteger	isinteger
unpack	unpack
tocfunction	tocfunction
format	format
inicio	inicio
optunsigned	optunsigned
checklstring	checklstring
where	where
mask	mask
gethookcount	gethookcount
isnoneornil	isnoneornil
pushlstring	pushlstring
value	value
find	find
modf	modf
a2	a2
checktype	checktype
getfield	getfield
sqrt	sqrt
callmeta	callmeta
nombre_de_fichero	nombre_de_fichero
maxn	maxn
t2	t2
checkversion	checkversion
packsize	packsize
loadbuffer	loadbuffer
stringtonumber	stringtonumber
getlocal	getlocal
ref	ref
mininteger	mininteger
nombre_viejo	nombre_viejo
getregistry	getregistry
categoría	categoría
state	state
dofile	dofile
error<	error<
testudata	testudata
checkstack	checkstack
codepoint	codepoint
input	input
field	field
modo	modo
t	t
tmpname	tmpname
islightuserdata	islightuserdata
rep	rep
exp	exp
máscara	máscara
callk	callk
checkoption	checkoption
buffinitsize	buffinitsize
ult	ult
opt	opt
rad	rad
getuservalue	getuservalue
cpath	cpath
stream	stream
rawset	rawset
setlocale	setlocale
flush	flush
y	y
mode	mode
math	math
deg	deg
prepbuffer	prepbuffer
checkunsigned	checkunsigned
byte	byte
isnil	isnil
newtable	newtable
count	count
básica	básica
loadstring	loadstring
kcontext	kcontext
f	f
upvalueid	upvalueid
newuserdata	newuserdata
rotate	rotate
io	io
newstate	newstate
pushresult	pushresult
i	i
fmt	fmt
resume	resume
asin	asin
getenv	getenv
co	co
equal	equal
argcheck	argcheck
running	running
gettable	gettable
upper	upper
repl	repl
cosh	cosh
optstring	optstring
disp	disp
gc	gc
variable	variable
ldexp	ldexp
sub	sub
searchers	searchers
patrón	patrón
execute	execute
tolstring	tolstring
getctx	getctx
toboolean	toboolean
version	version
loadbufferx	loadbufferx
xmove	xmove
codes	codes
posición	posición
cfunction	cfunction
popen	popen
atan2	atan2
v2	v2
modname	modname
rshift	rshift
contador	contador
insert	insert
pushlightuserdata	pushlightuserdata
number	number
reader	reader
prog	prog
coroutine	coroutine
rawget	rawget
min	min
os	os
lual	lual
checkstring	checkstring
cos	cos
tanh	tanh
floor	floor
pi	pi
yield	yield
reemplazamiento	reemplazamiento
tabla	tabla
tointeger	tointeger
tothread	tothread
settop	settop
locale	locale
setfield	setfield
cpcall	cpcall
addlstring	addlstring
rawseti	rawseti
zeichenklasse	zeichenklasse
nombre_de_func	nombre_de_func
searchpath	searchpath
formato	formato
isboolean	isboolean
getstack	getstack
o	o
checkany	checkany
pairs	pairs
prepbuffsize	prepbuffsize
setfenv	setfenv
message	message
match	match
x	x
optint	optint
nombre_de_chunk	nombre_de_chunk
pack	pack
func_hook	func_hook
de_dónde	de_dónde
randomseed	randomseed
fileresult	fileresult
getglobal	getglobal
pushthread	pushthread
write	write
category	category
getsubtable	getsubtable
exit	exit
load	load
tounsignedx	tounsignedx
frexp	frexp
log	log
muster	muster
argerror	argerror
traceback	traceback
isstring	isstring
type	type
mensaje	mensaje
tiempo	tiempo
checknumber	checknumber
package	package
whence	whence
pushnumber	pushnumber
funcname	funcname
f2	f2
copy	copy
checkudata	checkudata
touserdata	touserdata
g	g
huge	huge
sethook	sethook
base	base
isfunction	isfunction
m	m
udata	udata
gsub	gsub
pushboolean	pushboolean
init	init
f1	f1
command	command
pushcfunction	pushcfunction
path	path
loaders	loaders
arshift	arshift
fmod	fmod
arg	arg
optnumber	optnumber
pushcclosure	pushcclosure
desplazamiento	desplazamiento
seeall	seeall
move	move
pow	pow
setlocal	setlocal
output	output
gethook	gethook
filename	filename
rawequal	rawequal
iscfunction	iscfunction
loadfilex	loadfilex
log10	log10
newthread	newthread
valor	valor
debug	debug
acos	acos
up	up
rename	rename
pushunsigned	pushunsigned
function	function
pos	pos
sin	sin
open	open
tmpfile	tmpfile
rawlen	rawlen
ceil	ceil
name	name
concat	concat
loaded	loaded
collectgarbage	collectgarbage
isuserdata	isuserdata
pcall	pcall
chunk	chunk
btest	btest
typerror	typerror
nivel	nivel
buffinit	buffinit
proceso	proceso
optinteger	optinteger
muster-element	muster-element
assert	assert
max	max
read	read
abs	abs
tointegerx	tointegerx
config	config
topointer	topointer
xpcall	xpcall
setmetatable	setmetatable
optlstring	optlstring
createtable	createtable
val1	val1
date	date
qué	qué
reverse	reverse
gettop	gettop
typename	typename
tan	tan
bit32	bit32
comparador	comparador
comp	comp
size	size
hook	hook
remove	remove
char	char
n2	n2
tostring	tostring
n1	n1
newlib	newlib
maxinteger	maxinteger
isyieldable	isyieldable
pushfstring	pushfstring
lrotate	lrotate
bxor	bxor
msgh	msgh
istable	istable
setglobal	setglobal
formatstring	formatstring
rrotate	rrotate
index	index
replace	replace
checkinteger	checkinteger
isthread	isthread
nombre_nuevo	nombre_nuevo
print	print
close	close
integer	integer
rawsetp	rawsetp
checklong	checklong
getmetafield	getmetafield
func	func
file	file
offset	offset
upvaluejoin	upvaluejoin
reg	reg
módulo	módulo
pushinteger	pushinteger
n	n
arg1	arg1
gmatch	gmatch
unsigned	unsigned
rawgeti	rawgeti
varname	varname
chunkname	chunkname
código	código
isnumber	isnumber
setuservalue	setuservalue
upvalueindex	upvalueindex
difftime	difftime
width	width
getextraspace	getextraspace
sinh	sinh
numbertointeger	numbertointeger
addchar	addchar
list	list
pop	pop
wrap	wrap
getmetatable	getmetatable
pushnil	pushnil
tonumberx	tonumberx
e	e
v	v
isnone	isnone
alloc	alloc
v1	v1
getupvalue	getupvalue
register	register
error	error
setallocf	setallocf
bor	bor
call	call
arith	arith
extract	extract
pcallk	pcallk
setvbuf	setvbuf
select	select
unref	unref
lower	lower
pushvalue	pushvalue
getinfo	getinfo
checkint	checkint
string	string
pattern	pattern
atpanic	atpanic
comando	comando
plain	plain
pushvfstring	pushvfstring
geti	geti
openlibs	openlibs
newmetatable	newmetatable
setupvalue	setupvalue
pushglobaltable	pushglobaltable
next	next
rawgetp	rawgetp
pushliteral	pushliteral
local	local
getfenv	getfenv
setfuncs	setfuncs
execresult	execresult
a1	a1
gethookmask	gethookmask
addsize	addsize
what	what
thread	thread
kfunction	kfunction
random	random
sep	sep
obj	obj
module	module
objeto	objeto
seek	seek
utf8	utf8
table	table
buffer	buffer
tamaño	tamaño
lessthan	lessthan
pushstring	pushstring
dump	dump
tonumber	tonumber
nombre	nombre
sort	sort
dostring	dostring
writer	writer
status	status
optlong	optlong
preload	preload
err	err
metatable	metatable
s	s
level	level
libname	libname
addstring	addstring
require	require
create	create
t1	t1
objlen	objlen
loadlib	loadlib
